-6;0;0;1;VERDADERO;VERDADERO;-6;Max tiempo kalman;1;
-6;0;0;2;VERDADERO;VERDADERO;-6;Desfasajes;5796;416
-6;0;0;3;VERDADERO;VERDADERO;-6;;;
-6;0;0;4;VERDADERO;VERDADERO;-6;;;
-6;0;1;5;VERDADERO;VERDADERO;-6;;;
-13;0;0;6;VERDADERO;VERDADERO;-13;;;
-13;0;0;7;VERDADERO;VERDADERO;-13;;;
-13;0;0;8;VERDADERO;VERDADERO;-13;;;
-13;0;0;9;VERDADERO;VERDADERO;-13;;;
-13;0;0;10;VERDADERO;VERDADERO;-13;;;
3;0;0;11;VERDADERO;VERDADERO;3;;;
3;0;0;12;VERDADERO;VERDADERO;3;;;
3;0;0;13;VERDADERO;VERDADERO;3;;;
3;0;0;14;VERDADERO;VERDADERO;3;;;
3;0;0;15;VERDADERO;VERDADERO;3;;;
-11;0;0;16;VERDADERO;VERDADERO;-11;;;
-11;0;0;17;VERDADERO;VERDADERO;-11;;;
-11;0;1;18;VERDADERO;VERDADERO;-11;;;
-11;0;0;19;VERDADERO;VERDADERO;-11;;;
-11;20;0;20;VERDADERO;VERDADERO;-31;;;
6;20;0;21;VERDADERO;VERDADERO;-14;;;
6;20;0;22;VERDADERO;VERDADERO;-14;;;
6;40;0;23;VERDADERO;VERDADERO;-34;;;
6;40;0;24;VERDADERO;VERDADERO;-34;;;
6;40;0;25;VERDADERO;VERDADERO;-34;;;
6;40;0;26;VERDADERO;VERDADERO;-34;;;
41;60;1;27;VERDADERO;VERDADERO;-19;;;
41;60;0;28;VERDADERO;VERDADERO;-19;;;
41;60;0;29;VERDADERO;VERDADERO;-19;;;
41;80;0;30;VERDADERO;VERDADERO;-39;;;
41;80;0;31;VERDADERO;VERDADERO;-39;;;
73;100;0;32;VERDADERO;VERDADERO;-27;;;
73;100;0;33;VERDADERO;VERDADERO;-27;;;
73;100;0;34;VERDADERO;VERDADERO;-27;;;
73;100;0;35;VERDADERO;VERDADERO;-27;;;
73;100;0;36;VERDADERO;VERDADERO;-27;;;
105;100;0;37;VERDADERO;VERDADERO;5;;;
105;100;0;38;VERDADERO;VERDADERO;5;;;
105;100;0;39;VERDADERO;VERDADERO;5;;;
105;100;0;40;VERDADERO;VERDADERO;5;;;
105;120;0;41;VERDADERO;VERDADERO;-15;;;
137;120;0;42;VERDADERO;VERDADERO;17;;;
137;120;0;43;VERDADERO;VERDADERO;17;;;
137;140;0;44;VERDADERO;VERDADERO;-3;;;
137;140;0;45;VERDADERO;VERDADERO;-3;;;
137;140;0;46;VERDADERO;VERDADERO;-3;;;
137;140;0;47;VERDADERO;VERDADERO;-3;;;
171;140;0;48;VERDADERO;VERDADERO;31;;;
171;140;0;49;VERDADERO;VERDADERO;31;;;
171;160;1;50;VERDADERO;VERDADERO;11;;;
171;160;0;51;VERDADERO;VERDADERO;11;;;
171;180;0;52;VERDADERO;VERDADERO;-9;;;
206;180;0;53;VERDADERO;VERDADERO;26;;;
206;200;0;54;VERDADERO;VERDADERO;6;;;
206;200;0;55;VERDADERO;VERDADERO;6;;;
206;200;0;56;VERDADERO;VERDADERO;6;;;
206;220;0;57;VERDADERO;VERDADERO;-14;;;
237;220;0;58;VERDADERO;VERDADERO;17;;;
237;240;0;59;VERDADERO;VERDADERO;-3;;;
237;240;0;60;VERDADERO;VERDADERO;-3;;;
237;240;0;61;VERDADERO;VERDADERO;-3;;;
237;260;0;62;VERDADERO;VERDADERO;-23;;;
273;260;0;63;VERDADERO;VERDADERO;13;;;
273;280;0;64;VERDADERO;VERDADERO;-7;;;
273;280;0;65;VERDADERO;VERDADERO;-7;;;
273;280;0;66;VERDADERO;VERDADERO;-7;;;
273;300;0;67;VERDADERO;VERDADERO;-27;;;
273;300;0;68;VERDADERO;VERDADERO;-27;;;
305;320;0;69;VERDADERO;VERDADERO;-15;;;
305;320;0;70;VERDADERO;VERDADERO;-15;;;
305;320;0;71;VERDADERO;VERDADERO;-15;;;
305;340;0;72;VERDADERO;VERDADERO;-35;;;
305;340;0;73;VERDADERO;VERDADERO;-35;;;
341;340;0;74;VERDADERO;VERDADERO;1;;;
341;340;0;75;VERDADERO;VERDADERO;1;;;
341;360;0;76;VERDADERO;VERDADERO;-19;;;
341;360;0;77;VERDADERO;VERDADERO;-19;;;
341;380;0;78;VERDADERO;VERDADERO;-39;;;
373;380;0;79;VERDADERO;VERDADERO;-7;;;
373;380;0;80;VERDADERO;VERDADERO;-7;;;
373;380;0;81;VERDADERO;VERDADERO;-7;;;
373;380;0;82;VERDADERO;VERDADERO;-7;;;
373;380;0;83;VERDADERO;VERDADERO;-7;;;
373;380;0;84;VERDADERO;VERDADERO;-7;;;
405;400;1;85;VERDADERO;VERDADERO;5;;;
405;400;0;86;VERDADERO;VERDADERO;5;;;
405;400;0;87;VERDADERO;VERDADERO;5;;;
405;420;0;88;VERDADERO;VERDADERO;-15;;;
405;420;0;89;VERDADERO;VERDADERO;-15;;;
441;440;1;90;VERDADERO;VERDADERO;1;;;
441;440;0;91;VERDADERO;VERDADERO;1;;;
441;440;0;92;VERDADERO;VERDADERO;1;;;
441;460;1;93;VERDADERO;VERDADERO;-19;;;
441;460;0;94;VERDADERO;VERDADERO;-19;;;
473;480;0;95;VERDADERO;VERDADERO;-7;;;
473;480;0;96;VERDADERO;VERDADERO;-7;;;
473;480;0;97;VERDADERO;VERDADERO;-7;;;
473;500;0;98;VERDADERO;VERDADERO;-27;;;
473;500;0;99;VERDADERO;VERDADERO;-27;;;
505;520;0;100;VERDADERO;VERDADERO;-15;;;
505;520;0;101;VERDADERO;VERDADERO;-15;;;
505;520;0;102;VERDADERO;VERDADERO;-15;;;
505;540;0;103;VERDADERO;VERDADERO;-35;;;
505;540;0;104;VERDADERO;VERDADERO;-35;;;
537;540;0;105;VERDADERO;VERDADERO;-3;;;
537;540;0;106;VERDADERO;VERDADERO;-3;;;
537;540;0;107;VERDADERO;VERDADERO;-3;;;
537;560;0;108;VERDADERO;VERDADERO;-23;;;
537;560;0;109;VERDADERO;VERDADERO;-23;;;
569;560;0;110;VERDADERO;VERDADERO;9;;;
569;581;0;111;VERDADERO;VERDADERO;-12;;;
569;581;0;112;VERDADERO;VERDADERO;-12;;;
569;601;0;113;VERDADERO;VERDADERO;-32;;;
569;601;0;114;VERDADERO;VERDADERO;-32;;;
569;601;0;115;VERDADERO;VERDADERO;-32;;;
606;601;0;116;VERDADERO;VERDADERO;5;;;
606;601;0;117;VERDADERO;VERDADERO;5;;;
606;621;0;118;VERDADERO;VERDADERO;-15;;;
606;621;0;119;VERDADERO;VERDADERO;-15;;;
606;641;0;120;VERDADERO;VERDADERO;-35;;;
637;641;0;121;VERDADERO;VERDADERO;-4;;;
637;641;0;122;VERDADERO;VERDADERO;-4;;;
637;661;0;123;VERDADERO;VERDADERO;-24;;;
637;661;0;124;VERDADERO;VERDADERO;-24;;;
637;661;0;125;VERDADERO;VERDADERO;-24;;;
669;681;0;126;VERDADERO;VERDADERO;-12;;;
669;681;0;127;VERDADERO;VERDADERO;-12;;;
669;701;0;128;VERDADERO;VERDADERO;-32;;;
669;701;0;129;VERDADERO;VERDADERO;-32;;;
669;701;0;130;VERDADERO;VERDADERO;-32;;;
669;721;0;131;VERDADERO;FALSO;-52;;;
705;721;0;132;VERDADERO;VERDADERO;-16;;;
705;741;0;133;VERDADERO;VERDADERO;-36;;;
705;741;0;134;VERDADERO;VERDADERO;-36;;;
705;741;0;135;VERDADERO;VERDADERO;-36;;;
705;761;0;136;VERDADERO;FALSO;-56;;;
737;761;0;137;VERDADERO;VERDADERO;-24;;;
737;761;0;138;VERDADERO;VERDADERO;-24;;;
737;761;0;139;VERDADERO;VERDADERO;-24;;;
737;761;0;140;VERDADERO;VERDADERO;-24;;;
737;761;0;141;VERDADERO;VERDADERO;-24;;;
770;781;0;142;VERDADERO;VERDADERO;-11;;;
770;781;0;143;VERDADERO;VERDADERO;-11;;;
770;801;0;144;VERDADERO;VERDADERO;-31;;;
770;801;0;145;VERDADERO;VERDADERO;-31;;;
770;801;0;146;VERDADERO;VERDADERO;-31;;;
770;821;0;147;VERDADERO;FALSO;-51;;;
805;821;0;148;VERDADERO;VERDADERO;-16;;;
805;821;0;149;VERDADERO;VERDADERO;-16;;;
805;841;0;150;VERDADERO;VERDADERO;-36;;;
805;841;0;151;VERDADERO;VERDADERO;-36;;;
805;841;0;152;VERDADERO;VERDADERO;-36;;;
837;861;0;153;VERDADERO;VERDADERO;-24;;;
837;861;0;154;VERDADERO;VERDADERO;-24;;;
837;861;0;155;VERDADERO;VERDADERO;-24;;;
837;861;0;156;VERDADERO;VERDADERO;-24;;;
837;881;0;157;VERDADERO;VERDADERO;-44;;;
869;881;0;158;VERDADERO;VERDADERO;-12;;;
869;881;0;159;VERDADERO;VERDADERO;-12;;;
869;901;0;160;VERDADERO;VERDADERO;-32;;;
869;901;0;161;VERDADERO;VERDADERO;-32;;;
869;921;1;162;VERDADERO;FALSO;-52;;;
905;921;0;163;VERDADERO;VERDADERO;-16;;;
905;941;0;164;VERDADERO;VERDADERO;-36;;;
905;941;0;165;VERDADERO;VERDADERO;-36;;;
905;941;0;166;VERDADERO;VERDADERO;-36;;;
905;961;0;167;VERDADERO;FALSO;-56;;;
937;961;0;168;VERDADERO;VERDADERO;-24;;;
937;961;0;169;VERDADERO;VERDADERO;-24;;;
937;961;0;170;VERDADERO;VERDADERO;-24;;;
937;981;0;171;VERDADERO;VERDADERO;-44;;;
937;981;0;172;VERDADERO;VERDADERO;-44;;;
937;1001;0;173;VERDADERO;FALSO;-64;;;
973;1001;0;174;VERDADERO;VERDADERO;-28;;;
973;1001;0;175;VERDADERO;VERDADERO;-28;;;
973;1001;0;176;VERDADERO;VERDADERO;-28;;;
973;1001;0;177;VERDADERO;VERDADERO;-28;;;
973;1021;1;178;VERDADERO;VERDADERO;-48;;;
1005;1021;0;179;VERDADERO;VERDADERO;-16;;;
1005;1021;0;180;VERDADERO;VERDADERO;-16;;;
1005;1041;0;181;VERDADERO;VERDADERO;-36;;;
1005;1041;0;182;VERDADERO;VERDADERO;-36;;;
1005;1041;0;183;VERDADERO;VERDADERO;-36;;;
1038;1041;0;184;VERDADERO;VERDADERO;-3;;;
1038;1061;0;185;VERDADERO;VERDADERO;-23;;;
1038;1061;0;186;VERDADERO;VERDADERO;-23;;;
1038;1061;0;187;VERDADERO;VERDADERO;-23;;;
1038;1081;0;188;VERDADERO;VERDADERO;-43;;;
1069;1081;0;189;VERDADERO;VERDADERO;-12;;;
1069;1081;0;190;VERDADERO;VERDADERO;-12;;;
1069;1081;0;191;VERDADERO;VERDADERO;-12;;;
1069;1081;0;192;VERDADERO;VERDADERO;-12;;;
1069;1081;0;193;VERDADERO;VERDADERO;-12;;;
1069;1101;1;194;VERDADERO;VERDADERO;-32;;;
1101;1101;0;195;VERDADERO;VERDADERO;0;;;
1101;1101;0;196;VERDADERO;VERDADERO;0;;;
1101;1122;0;197;VERDADERO;VERDADERO;-21;;;
1101;1122;0;198;VERDADERO;VERDADERO;-21;;;
1101;1142;0;199;VERDADERO;VERDADERO;-41;;;
1137;1142;0;200;VERDADERO;VERDADERO;-5;;;
1137;1142;0;201;VERDADERO;VERDADERO;-5;;;
1137;1162;0;202;VERDADERO;VERDADERO;-25;;;
1137;1162;0;203;VERDADERO;VERDADERO;-25;;;
1137;1182;0;204;VERDADERO;VERDADERO;-45;;;
1170;1182;0;205;VERDADERO;VERDADERO;-12;;;
1170;1182;0;206;VERDADERO;VERDADERO;-12;;;
1170;1202;0;207;VERDADERO;VERDADERO;-32;;;
1170;1202;0;208;VERDADERO;VERDADERO;-32;;;
1170;1202;0;209;VERDADERO;VERDADERO;-32;;;
1202;1222;0;210;VERDADERO;VERDADERO;-20;;;
1202;1222;0;211;VERDADERO;VERDADERO;-20;;;
1202;1222;0;212;VERDADERO;VERDADERO;-20;;;
1202;1242;0;213;VERDADERO;VERDADERO;-40;;;
1202;1242;0;214;VERDADERO;VERDADERO;-40;;;
1202;1242;0;215;VERDADERO;VERDADERO;-40;;;
1237;1242;0;216;VERDADERO;VERDADERO;-5;;;
1237;1242;0;217;VERDADERO;VERDADERO;-5;;;
1237;1262;0;218;VERDADERO;VERDADERO;-25;;;
1237;1262;0;219;VERDADERO;VERDADERO;-25;;;
1237;1282;0;220;VERDADERO;VERDADERO;-45;;;
1269;1282;0;221;VERDADERO;VERDADERO;-13;;;
1269;1282;0;222;VERDADERO;VERDADERO;-13;;;
1269;1302;0;223;VERDADERO;VERDADERO;-33;;;
1269;1302;0;224;VERDADERO;VERDADERO;-33;;;
1269;1302;0;225;VERDADERO;VERDADERO;-33;;;
1269;1322;1;226;VERDADERO;FALSO;-53;;;
1305;1322;0;227;VERDADERO;VERDADERO;-17;;;
1305;1342;0;228;VERDADERO;VERDADERO;-37;;;
1305;1342;0;229;VERDADERO;VERDADERO;-37;;;
1305;1342;0;230;VERDADERO;VERDADERO;-37;;;
1305;1342;0;231;VERDADERO;VERDADERO;-37;;;
1338;1342;0;232;VERDADERO;VERDADERO;-4;;;
1338;1342;0;233;VERDADERO;VERDADERO;-4;;;
1338;1362;0;234;VERDADERO;VERDADERO;-24;;;
1338;1362;0;235;VERDADERO;VERDADERO;-24;;;
1338;1382;0;236;VERDADERO;VERDADERO;-44;;;
1373;1382;0;237;VERDADERO;VERDADERO;-9;;;
1373;1382;0;238;VERDADERO;VERDADERO;-9;;;
1373;1402;0;239;VERDADERO;VERDADERO;-29;;;
1373;1402;0;240;VERDADERO;VERDADERO;-29;;;
1373;1402;0;241;VERDADERO;VERDADERO;-29;;;
1373;1422;0;242;VERDADERO;VERDADERO;-49;;;
1405;1422;0;243;VERDADERO;VERDADERO;-17;;;
1405;1422;0;244;VERDADERO;VERDADERO;-17;;;
1405;1442;0;245;VERDADERO;VERDADERO;-37;;;
1405;1442;0;246;VERDADERO;VERDADERO;-37;;;
1405;1442;0;247;VERDADERO;VERDADERO;-37;;;
1441;1442;0;248;VERDADERO;VERDADERO;-1;;;
1441;1442;0;249;VERDADERO;VERDADERO;-1;;;
1441;1462;0;250;VERDADERO;VERDADERO;-21;;;
1441;1462;0;251;VERDADERO;VERDADERO;-21;;;
1441;1462;0;252;VERDADERO;VERDADERO;-21;;;
1441;1482;0;253;VERDADERO;VERDADERO;-41;;;
1474;1482;0;254;VERDADERO;VERDADERO;-8;;;
1474;1502;0;255;VERDADERO;VERDADERO;-28;;;
1474;1502;0;256;VERDADERO;VERDADERO;-28;;;
1474;1502;0;257;VERDADERO;VERDADERO;-28;;;
1474;1522;0;258;VERDADERO;VERDADERO;-48;;;
1510;1522;0;259;VERDADERO;VERDADERO;-12;;;
1510;1542;0;260;VERDADERO;VERDADERO;-32;;;
1510;1542;0;261;VERDADERO;VERDADERO;-32;;;
1510;1542;0;262;VERDADERO;VERDADERO;-32;;;
1510;1542;0;263;VERDADERO;VERDADERO;-32;;;
1541;1542;0;264;VERDADERO;VERDADERO;-1;;;
1541;1562;0;265;VERDADERO;VERDADERO;-21;;;
1541;1562;0;266;VERDADERO;VERDADERO;-21;;;
1541;1562;0;267;VERDADERO;VERDADERO;-21;;;
1541;1582;0;268;VERDADERO;VERDADERO;-41;;;
1541;1582;0;269;VERDADERO;VERDADERO;-41;;;
1573;1582;0;270;VERDADERO;VERDADERO;-9;;;
1573;1602;0;271;VERDADERO;VERDADERO;-29;;;
1573;1602;0;272;VERDADERO;VERDADERO;-29;;;
1573;1622;0;273;VERDADERO;VERDADERO;-49;;;
1573;1622;0;274;VERDADERO;VERDADERO;-49;;;
1609;1642;0,00E+00;275;VERDADERO;VERDADERO;-33;;;
1609;1642;0;276;VERDADERO;VERDADERO;-33;;;
1609;1642;0;277;VERDADERO;VERDADERO;-33;;;
1609;1642;0;278;VERDADERO;VERDADERO;-33;;;
1609;1642;0;279;VERDADERO;VERDADERO;-33;;;
1637;1642;0;280;VERDADERO;VERDADERO;-5;;;
1637;1662;0;281;VERDADERO;VERDADERO;-25;;;
1637;1662;0;282;VERDADERO;VERDADERO;-25;;;
1637;1682;1;283;VERDADERO;VERDADERO;-45;;;
1637;1682;0;284;VERDADERO;VERDADERO;-45;;;
1673;1682;0;285;VERDADERO;VERDADERO;-9;;;
1673;1682;0;286;VERDADERO;VERDADERO;-9;;;
1673;1682;0;287;VERDADERO;VERDADERO;-9;;;
1673;1702;1;288;VERDADERO;VERDADERO;-29;;;
1673;1702;0;289;VERDADERO;VERDADERO;-29;;;
1673;1722;0;290;VERDADERO;VERDADERO;-49;;;
1705;1722;0;291;VERDADERO;VERDADERO;-17;;;
1705;1722;0;292;VERDADERO;VERDADERO;-17;;;
1705;1742;0;293;VERDADERO;VERDADERO;-37;;;
1705;1742;0;294;VERDADERO;VERDADERO;-37;;;
1705;1762;0;295;VERDADERO;FALSO;-57;;;
1742;1762;0;296;VERDADERO;VERDADERO;-20;;;
1742;1762;0;297;VERDADERO;VERDADERO;-20;;;
1742;1782;0;298;VERDADERO;VERDADERO;-40;;;
1742;1782;0;299;VERDADERO;VERDADERO;-40;;;
1742;1782;0;300;VERDADERO;VERDADERO;-40;;;
1770;1782;0;301;VERDADERO;VERDADERO;-12;;;
1770;1782;0;302;VERDADERO;VERDADERO;-12;;;
1770;1802;0;303;VERDADERO;VERDADERO;-32;;;
1770;1802;0;304;VERDADERO;VERDADERO;-32;;;
1800;1822;1;305;VERDADERO;VERDADERO;-22;;;
1800;1822;0;306;VERDADERO;VERDADERO;-22;;;
1800;1822;0;307;VERDADERO;VERDADERO;-22;;;
1800;1842;0;308;VERDADERO;VERDADERO;-42;;;
1800;1842;0;309;VERDADERO;VERDADERO;-42;;;
1800;1862;0;310;VERDADERO;FALSO;-62;;;
1832;1862;0;311;VERDADERO;VERDADERO;-30;;;
1832;1862;0;312;VERDADERO;VERDADERO;-30;;;
1832;1882;0;313;VERDADERO;FALSO;-50;;;
1832;1882;0;314;VERDADERO;FALSO;-50;;;
1865;1882;0;315;VERDADERO;VERDADERO;-17;;;
1865;1882;0;316;VERDADERO;VERDADERO;-17;;;
1865;1902;0;317;VERDADERO;VERDADERO;-37;;;
1865;1902;0;318;VERDADERO;VERDADERO;-37;;;
1865;1922;0;319;VERDADERO;FALSO;-57;;;
1865;1922;0;320;VERDADERO;FALSO;-57;;;
1901;1922;0;321;VERDADERO;VERDADERO;-21;;;
1901;1922;0;322;VERDADERO;VERDADERO;-21;;;
1901;1922;0;323;VERDADERO;VERDADERO;-21;;;
1901;1922;0;324;VERDADERO;VERDADERO;-21;;;
1901;1942;0;325;VERDADERO;VERDADERO;-41;;;
1933;1942;0;326;VERDADERO;VERDADERO;-9;;;
1933;1962;0;327;VERDADERO;VERDADERO;-29;;;
1933;1962;0;328;VERDADERO;VERDADERO;-29;;;
1933;1962;0;329;VERDADERO;VERDADERO;-29;;;
1933;1962;0;330;VERDADERO;VERDADERO;-29;;;
1966;1962;0;331;VERDADERO;VERDADERO;4;;;
1966;1982;0;332;VERDADERO;VERDADERO;-16;;;
1966;1982;0;333;VERDADERO;VERDADERO;-16;;;
1966;1982;0;334;VERDADERO;VERDADERO;-16;;;
1966;2002;0;335;VERDADERO;VERDADERO;-36;;;
1966;2002;0;336;VERDADERO;VERDADERO;-36;;;
2000;2022;1;337;VERDADERO;VERDADERO;-22;;;
2000;2022;0;338;VERDADERO;VERDADERO;-22;;;
2000;2042;0;339;VERDADERO;VERDADERO;-42;;;
2000;2042;0;340;VERDADERO;VERDADERO;-42;;;
2000;2042;0;341;VERDADERO;VERDADERO;-42;;;
2033;2062;0;342;VERDADERO;VERDADERO;-29;;;
2033;2062;0;343;VERDADERO;VERDADERO;-29;;;
2033;2062;0;344;VERDADERO;VERDADERO;-29;;;
2033;2062;0;345;VERDADERO;VERDADERO;-29;;;
2033;2062;0;346;VERDADERO;VERDADERO;-29;;;
2033;2062;0;347;VERDADERO;VERDADERO;-29;;;
2069;2082;0;348;VERDADERO;VERDADERO;-13;;;
2069;2082;0;349;VERDADERO;VERDADERO;-13;;;
2069;2102;0;350;VERDADERO;VERDADERO;-33;;;
2069;2102;0;351;VERDADERO;VERDADERO;-33;;;
2069;2102;0;352;VERDADERO;VERDADERO;-33;;;
2101;2122;1;353;VERDADERO;VERDADERO;-21;;;
2101;2122;0;354;VERDADERO;VERDADERO;-21;;;
2101;2122;0;355;VERDADERO;VERDADERO;-21;;;
2101;2142;0;356;VERDADERO;VERDADERO;-41;;;
2101;2142;0;357;VERDADERO;VERDADERO;-41;;;
2137;2162;0;358;VERDADERO;VERDADERO;-25;;;
2137;2162;0;359;VERDADERO;VERDADERO;-25;;;
2137;2162;0;360;VERDADERO;VERDADERO;-25;;;
2137;2162;0;361;VERDADERO;VERDADERO;-25;;;
2137;2162;0;362;VERDADERO;VERDADERO;-25;;;
2137;2162;0;363;VERDADERO;VERDADERO;-25;;;
2169;2182;0;364;VERDADERO;VERDADERO;-13;;;
2169;2182;0;365;VERDADERO;VERDADERO;-13;;;
2169;2202;0;366;VERDADERO;VERDADERO;-33;;;
2169;2202;0;367;VERDADERO;VERDADERO;-33;;;
2169;2202;0;368;VERDADERO;VERDADERO;-33;;;
2201;2222;1;369;VERDADERO;VERDADERO;-21;;;
2201;2222;0;370;VERDADERO;VERDADERO;-21;;;
2201;2242;0;371;VERDADERO;VERDADERO;-41;;;
2201;2242;0;372;VERDADERO;VERDADERO;-41;;;
2201;2242;0;373;VERDADERO;VERDADERO;-41;;;
2237;2262;0;374;VERDADERO;VERDADERO;-25;;;
2237;2262;0;375;VERDADERO;VERDADERO;-25;;;
2237;2262;0;376;VERDADERO;VERDADERO;-25;;;
2237;2282;0;377;VERDADERO;VERDADERO;-45;;;
2237;2282;0;378;VERDADERO;VERDADERO;-45;;;
2237;2282;0;379;VERDADERO;VERDADERO;-45;;;
2273;2302;0;380;VERDADERO;VERDADERO;-29;;;
2273;2302;0;381;VERDADERO;VERDADERO;-29;;;
2273;2302;0;382;VERDADERO;VERDADERO;-29;;;
2273;2302;0;383;VERDADERO;VERDADERO;-29;;;
2273;2302;0;384;VERDADERO;VERDADERO;-29;;;
2305;2322;0;385;VERDADERO;VERDADERO;-17;;;
2305;2322;0;386;VERDADERO;VERDADERO;-17;;;
2305;2322;0;387;VERDADERO;VERDADERO;-17;;;
2305;2342;0;388;VERDADERO;VERDADERO;-37;;;
2305;2342;0;389;VERDADERO;VERDADERO;-37;;;
2337;2362;0;390;VERDADERO;VERDADERO;-25;;;
2337;2362;0;391;VERDADERO;VERDADERO;-25;;;
2337;2362;0;392;VERDADERO;VERDADERO;-25;;;
2337;2362;0;393;VERDADERO;VERDADERO;-25;;;
2337;2362;0;394;VERDADERO;VERDADERO;-25;;;
2337;2382;0;395;VERDADERO;VERDADERO;-45;;;
2373;2382;0;396;VERDADERO;VERDADERO;-9;;;
2373;2382;0;397;VERDADERO;VERDADERO;-9;;;
2373;2402;1;398;VERDADERO;VERDADERO;-29;;;
2373;2402;0;399;VERDADERO;VERDADERO;-29;;;
2373;2402;0;400;VERDADERO;VERDADERO;-29;;;
2406;2402;0;401;VERDADERO;VERDADERO;4;;;
2406;2422;1;402;VERDADERO;VERDADERO;-16;;;
2406;2422;0;403;VERDADERO;VERDADERO;-16;;;
2406;2422;0;404;VERDADERO;VERDADERO;-16;;;
2406;2442;0;405;VERDADERO;VERDADERO;-36;;;
2437;2442;0;406;VERDADERO;VERDADERO;-5;;;
2437;2462;0;407;VERDADERO;VERDADERO;-25;;;
2437;2462;0;408;VERDADERO;VERDADERO;-25;;;
2437;2482;1;409;VERDADERO;VERDADERO;-45;;;
2437;2482;0;410;VERDADERO;VERDADERO;-45;;;
2469;2482;0;411;VERDADERO;VERDADERO;-13;;;
2469;2502;0;412;VERDADERO;VERDADERO;-33;;;
2469;2502;0;413;VERDADERO;VERDADERO;-33;;;
2469;2502;0;414;VERDADERO;VERDADERO;-33;;;
2469;2502;0;415;VERDADERO;VERDADERO;-33;;;
2501;2502;0;416;VERDADERO;VERDADERO;-1;;;
2501;2522;0;417;VERDADERO;VERDADERO;-21;;;
2501;2522;0;418;VERDADERO;VERDADERO;-21;;;
2501;2542;0;419;VERDADERO;VERDADERO;-41;;;
2501;2542;0;420;VERDADERO;VERDADERO;-41;;;
2533;2542;0;421;VERDADERO;VERDADERO;-9;;;
2533;2562;0;422;VERDADERO;VERDADERO;-29;;;
2533;2562;0;423;VERDADERO;VERDADERO;-29;;;
2533;2582;0;424;VERDADERO;VERDADERO;-49;;;
2533;2582;0;425;VERDADERO;VERDADERO;-49;;;
2565;2582;0;426;VERDADERO;VERDADERO;-17;;;
2565;2602;0;427;VERDADERO;VERDADERO;-37;;;
2565;2602;0;428;VERDADERO;VERDADERO;-37;;;
2565;2602;0;429;VERDADERO;VERDADERO;-37;;;
2565;2602;0;430;VERDADERO;VERDADERO;-37;;;
2565;2622;0;431;VERDADERO;FALSO;-57;;;
2601;2622;0;432;VERDADERO;VERDADERO;-21;;;
2601;2622;0;433;VERDADERO;VERDADERO;-21;;;
2601;2642;0;434;VERDADERO;VERDADERO;-41;;;
2601;2642;0;435;VERDADERO;VERDADERO;-41;;;
2601;2642;0;436;VERDADERO;VERDADERO;-41;;;
2633;2642;0;437;VERDADERO;VERDADERO;-9;;;
2633;2642;0;438;VERDADERO;VERDADERO;-9;;;
2633;2662;0;439;VERDADERO;VERDADERO;-29;;;
2633;2662;0;440;VERDADERO;VERDADERO;-29;;;
2633;2682;0;441;VERDADERO;VERDADERO;-49;;;
2665;2682;0;442;VERDADERO;VERDADERO;-17;;;
2665;2682;0;443;VERDADERO;VERDADERO;-17;;;
2665;2682;0;444;VERDADERO;VERDADERO;-17;;;
2665;2682;0;445;VERDADERO;VERDADERO;-17;;;
2665;2702;0;446;VERDADERO;VERDADERO;-37;;;
2665;2702;0;447;VERDADERO;VERDADERO;-37;;;
2703;2702;0;448;VERDADERO;VERDADERO;1;;;
2703;2722;0;449;VERDADERO;VERDADERO;-19;;;
2703;2722;0;450;VERDADERO;VERDADERO;-19;;;
2703;2742;0;451;VERDADERO;VERDADERO;-39;;;
2703;2742;0;452;VERDADERO;VERDADERO;-39;;;
2733;2742;0;453;VERDADERO;VERDADERO;-9;;;
2733;2762;0;454;VERDADERO;VERDADERO;-29;;;
2733;2762;0;455;VERDADERO;VERDADERO;-29;;;
2733;2782;0;456;VERDADERO;VERDADERO;-49;;;
2733;2782;0;457;VERDADERO;VERDADERO;-49;;;
2765;2782;0;458;VERDADERO;VERDADERO;-17;;;
2765;2782;0;459;VERDADERO;VERDADERO;-17;;;
2765;2782;0;460;VERDADERO;VERDADERO;-17;;;
2765;2802;0;461;VERDADERO;VERDADERO;-37;;;
2765;2802;0;462;VERDADERO;VERDADERO;-37;;;
2765;2802;0;463;VERDADERO;VERDADERO;-37;;;
2801;2822;0;464;VERDADERO;VERDADERO;-21;;;
2801;2822;0;465;VERDADERO;VERDADERO;-21;;;
2801;2842;0;466;VERDADERO;VERDADERO;-41;;;
2801;2842;0;467;VERDADERO;VERDADERO;-41;;;
2801;2842;0;468;VERDADERO;VERDADERO;-41;;;
2837;2862;1;469;VERDADERO;VERDADERO;-25;;;
2837;2862;0;470;VERDADERO;VERDADERO;-25;;;
2837;2882;0;471;VERDADERO;VERDADERO;-45;;;
2837;2882;0;472;VERDADERO;VERDADERO;-45;;;
2837;2882;0;473;VERDADERO;VERDADERO;-45;;;
2837;2882;0;474;VERDADERO;VERDADERO;-45;;;
2869;2882;0;475;VERDADERO;VERDADERO;-13;;;
2869;2882;0;476;VERDADERO;VERDADERO;-13;;;
2869;2902;0;477;VERDADERO;VERDADERO;-33;;;
2869;2902;0;478;VERDADERO;VERDADERO;-33;;;
2869;2902;0;479;VERDADERO;VERDADERO;-33;;;
2905;2922;0;480;VERDADERO;VERDADERO;-17;;;
2905;2922;0;481;VERDADERO;VERDADERO;-17;;;
2905;2922;0;482;VERDADERO;VERDADERO;-17;;;
2905;2922;0;483;VERDADERO;VERDADERO;-17;;;
2905;2922;0;484;VERDADERO;VERDADERO;-17;;;
2937;2922;0;485;VERDADERO;VERDADERO;15;;;
2937;2942;0;486;VERDADERO;VERDADERO;-5;;;
2937;2942;0;487;VERDADERO;VERDADERO;-5;;;
2937;2962;0;488;VERDADERO;VERDADERO;-25;;;
2937;2962;0;489;VERDADERO;VERDADERO;-25;;;
2937;2962;0;490;VERDADERO;VERDADERO;-25;;;
2973;2982;0;491;VERDADERO;VERDADERO;-9;;;
2973;2982;0;492;VERDADERO;VERDADERO;-9;;;
2973;3002;0;493;VERDADERO;VERDADERO;-29;;;
2973;3002;0;494;VERDADERO;VERDADERO;-29;;;
2973;3002;0;495;VERDADERO;VERDADERO;-29;;;
3005;3022;1;496;VERDADERO;VERDADERO;-17;;;
3005;3022;0;497;VERDADERO;VERDADERO;-17;;;
3005;3042;0;498;VERDADERO;VERDADERO;-37;;;
3005;3042;0;499;VERDADERO;VERDADERO;-37;;;
3005;3042;0;500;VERDADERO;VERDADERO;-37;;;
3005;3062;0;501;VERDADERO;FALSO;-57;;;
3041;3062;0;502;VERDADERO;VERDADERO;-21;;;
3041;3062;0;503;VERDADERO;VERDADERO;-21;;;
3041;3082;0;504;VERDADERO;VERDADERO;-41;;;
3041;3082;0;505;VERDADERO;VERDADERO;-41;;;
3073;3082;0;506;VERDADERO;VERDADERO;-9;;;
3073;3082;0;507;VERDADERO;VERDADERO;-9;;;
3073;3102;0;508;VERDADERO;VERDADERO;-29;;;
3073;3102;0;509;VERDADERO;VERDADERO;-29;;;
3073;3102;0;510;VERDADERO;VERDADERO;-29;;;
3073;3122;0;511;VERDADERO;VERDADERO;-49;;;
3105;3122;0;512;VERDADERO;VERDADERO;-17;;;
3105;3142;0;513;VERDADERO;VERDADERO;-37;;;
3105;3142;0;514;VERDADERO;VERDADERO;-37;;;
3105;3142;0;515;VERDADERO;VERDADERO;-37;;;
3137;3162;0;516;VERDADERO;VERDADERO;-25;;;
3137;3162;0;517;VERDADERO;VERDADERO;-25;;;
3137;3182;0;518;VERDADERO;VERDADERO;-45;;;
3137;3182;0;519;VERDADERO;VERDADERO;-45;;;
3137;3182;0;520;VERDADERO;VERDADERO;-45;;;
3169;3182;0;521;VERDADERO;VERDADERO;-13;;;
3169;3182;0;522;VERDADERO;VERDADERO;-13;;;
3169;3202;0;523;VERDADERO;VERDADERO;-33;;;
3169;3202;0;524;VERDADERO;VERDADERO;-33;;;
3169;3222;1;525;VERDADERO;FALSO;-53;;;
3169;3222;0;526;VERDADERO;FALSO;-53;;;
3205;3222;0;527;VERDADERO;VERDADERO;-17;;;
3205;3222;0;528;VERDADERO;VERDADERO;-17;;;
3205;3222;0;529;VERDADERO;VERDADERO;-17;;;
3205;3222;0;530;VERDADERO;VERDADERO;-17;;;
3205;3242;1;531;VERDADERO;VERDADERO;-37;;;
3237;3242;0;532;VERDADERO;VERDADERO;-5;;;
3237;3262;0;533;VERDADERO;VERDADERO;-25;;;
3237;3262;0;534;VERDADERO;VERDADERO;-25;;;
3237;3262;0;535;VERDADERO;VERDADERO;-25;;;
3237;3262;0;536;VERDADERO;VERDADERO;-25;;;
3237;3262;0;537;VERDADERO;VERDADERO;-25;;;
3269;3262;0;538;VERDADERO;VERDADERO;7;;;
3269;3262;0;539;VERDADERO;VERDADERO;7;;;
3269;3282;1;540;VERDADERO;VERDADERO;-13;;;
3269;3282;0;541;VERDADERO;VERDADERO;-13;;;
3269;3302;0;542;VERDADERO;VERDADERO;-33;;;
3301;3302;0;543;VERDADERO;VERDADERO;-1;;;
3301;3322;0;544;VERDADERO;VERDADERO;-21;;;
3301;3322;0;545;VERDADERO;VERDADERO;-21;;;
3301;3322;0;546;VERDADERO;VERDADERO;-21;;;
3301;3342;0;547;VERDADERO;VERDADERO;-41;;;
3333;3342;0;548;VERDADERO;VERDADERO;-9;;;
3333;3362;0;549;VERDADERO;VERDADERO;-29;;;
3333;3362;0;550;VERDADERO;VERDADERO;-29;;;
3333;3362;0;551;VERDADERO;VERDADERO;-29;;;
3333;3382;0;552;VERDADERO;VERDADERO;-49;;;
3369;3382;0;553;VERDADERO;VERDADERO;-13;;;
3369;3382;0;554;VERDADERO;VERDADERO;-13;;;
3369;3402;0;555;VERDADERO;VERDADERO;-33;;;
3369;3402;0;556;VERDADERO;VERDADERO;-33;;;
3369;3422;0;557;VERDADERO;FALSO;-53;;;
3401;3422;0;558;VERDADERO;VERDADERO;-21;;;
3401;3422;0;559;VERDADERO;VERDADERO;-21;;;
3401;3422;0;560;VERDADERO;VERDADERO;-21;;;
3401;3422;0;561;VERDADERO;VERDADERO;-21;;;
3401;3442;0;562;VERDADERO;VERDADERO;-41;;;
3433;3442;0;563;VERDADERO;VERDADERO;-9;;;
3433;3442;0;564;VERDADERO;VERDADERO;-9;;;
3433;3462;0;565;VERDADERO;VERDADERO;-29;;;
3433;3462;0;566;VERDADERO;VERDADERO;-29;;;
3433;3482;0;567;VERDADERO;VERDADERO;-49;;;
3433;3482;0;568;VERDADERO;VERDADERO;-49;;;
3472;3482;0;569;VERDADERO;VERDADERO;-10;;;
3472;3482;0;570;VERDADERO;VERDADERO;-10;;;
3472;3502;0;571;VERDADERO;VERDADERO;-30;;;
3472;3502;0;572;VERDADERO;VERDADERO;-30;;;
3472;3502;0;573;VERDADERO;VERDADERO;-30;;;
3501;3522;0;574;VERDADERO;VERDADERO;-21;;;
3501;3522;0;575;VERDADERO;VERDADERO;-21;;;
3501;3522;0;576;VERDADERO;VERDADERO;-21;;;
3501;3522;0;577;VERDADERO;VERDADERO;-21;;;
3501;3542;0;578;VERDADERO;VERDADERO;-41;;;
3534;3542;0;579;VERDADERO;VERDADERO;-8;;;
3534;3562;0;580;VERDADERO;VERDADERO;-28;;;
3534;3562;0;581;VERDADERO;VERDADERO;-28;;;
3534;3562;0;582;VERDADERO;VERDADERO;-28;;;
3534;3582;0;583;VERDADERO;VERDADERO;-48;;;
3569;3582;0;584;VERDADERO;VERDADERO;-13;;;
3569;3602;0;585;VERDADERO;VERDADERO;-33;;;
3569;3602;0;586;VERDADERO;VERDADERO;-33;;;
3569;3602;0;587;VERDADERO;VERDADERO;-33;;;
3569;3622;1;588;VERDADERO;FALSO;-53;;;
3569;3622;0;589;VERDADERO;FALSO;-53;;;
3605;3622;0;590;VERDADERO;VERDADERO;-17;;;
3605;3642;0;591;VERDADERO;VERDADERO;-37;;;
3605;3642;0;592;VERDADERO;VERDADERO;-37;;;
3605;3642;0;593;VERDADERO;VERDADERO;-37;;;
3605;3662;0;594;VERDADERO;FALSO;-57;;;
3637;3662;0;595;VERDADERO;VERDADERO;-25;;;
3637;3662;0;596;VERDADERO;VERDADERO;-25;;;
3637;3662;0;597;VERDADERO;VERDADERO;-25;;;
3637;3662;0;598;VERDADERO;VERDADERO;-25;;;
3637;3682;0;599;VERDADERO;VERDADERO;-45;;;
3669;3682;0;600;VERDADERO;VERDADERO;-13;;;
3669;3702;0;601;VERDADERO;VERDADERO;-33;;;
3669;3702;0;602;VERDADERO;VERDADERO;-33;;;
3669;3702;0;603;VERDADERO;VERDADERO;-33;;;
3669;3702;0;604;VERDADERO;VERDADERO;-33;;;
3669;3702;0;605;VERDADERO;VERDADERO;-33;;;
3705;3722;0;606;VERDADERO;VERDADERO;-17;;;
3705;3722;0;607;VERDADERO;VERDADERO;-17;;;
3705;3722;0;608;VERDADERO;VERDADERO;-17;;;
3705;3742;1;609;VERDADERO;VERDADERO;-37;;;
3705;3742;0;610;VERDADERO;VERDADERO;-37;;;
3705;3762;0;611;VERDADERO;FALSO;-57;;;
3741;3762;0;612;VERDADERO;VERDADERO;-21;;;
3741;3782;0;613;VERDADERO;VERDADERO;-41;;;
3741;3782;0;614;VERDADERO;VERDADERO;-41;;;
3741;3782;0;615;VERDADERO;VERDADERO;-41;;;
3741;3802;0;616;VERDADERO;FALSO;-61;;;
3773;3802;0;617;VERDADERO;VERDADERO;-29;;;
3773;3802;0;618;VERDADERO;VERDADERO;-29;;;
3773;3802;0;619;VERDADERO;VERDADERO;-29;;;
3773;3822;0;620;VERDADERO;VERDADERO;-49;;;
3805;3822;0;621;VERDADERO;VERDADERO;-17;;;
3805;3842;0;622;VERDADERO;VERDADERO;-37;;;
3805;3842;0;623;VERDADERO;VERDADERO;-37;;;
3805;3842;0;624;VERDADERO;VERDADERO;-37;;;
3805;3842;0;625;VERDADERO;VERDADERO;-37;;;
3805;3842;0;626;VERDADERO;VERDADERO;-37;;;
3841;3862;1;627;VERDADERO;VERDADERO;-21;;;
3841;3862;0;628;VERDADERO;VERDADERO;-21;;;
3841;3862;0;629;VERDADERO;VERDADERO;-21;;;
3841;3882;0;630;VERDADERO;VERDADERO;-41;;;
3841;3882;0;631;VERDADERO;VERDADERO;-41;;;
3873;3882;0;632;VERDADERO;VERDADERO;-9;;;
3873;3882;0;633;VERDADERO;VERDADERO;-9;;;
3873;3902;0;634;VERDADERO;VERDADERO;-29;;;
3873;3902;0;635;VERDADERO;VERDADERO;-29;;;
3873;3902;0;636;VERDADERO;VERDADERO;-29;;;
3905;3922;0;637;VERDADERO;VERDADERO;-17;;;
3905;3922;0;638;VERDADERO;VERDADERO;-17;;;
3905;3942;1;639;VERDADERO;VERDADERO;-37;;;
3905;3942;0;640;VERDADERO;VERDADERO;-37;;;
3905;3942;0;641;VERDADERO;VERDADERO;-37;;;
3905;3962;0;642;VERDADERO;FALSO;-57;;;
3941;3962;0;643;VERDADERO;VERDADERO;-21;;;
3941;3982;0;644;VERDADERO;VERDADERO;-41;;;
3941;3982;0;645;VERDADERO;VERDADERO;-41;;;
3941;3982;0;646;VERDADERO;VERDADERO;-41;;;
3941;3982;0;647;VERDADERO;VERDADERO;-41;;;
3973;3982;0;648;VERDADERO;VERDADERO;-9;;;
3973;4002;0;649;VERDADERO;VERDADERO;-29;;;
3973;4002;0;650;VERDADERO;VERDADERO;-29;;;
3973;4002;0;651;VERDADERO;VERDADERO;-29;;;
3973;4022;0;652;VERDADERO;VERDADERO;-49;;;
4005;4022;0;653;VERDADERO;VERDADERO;-17;;;
4005;4022;0;654;VERDADERO;VERDADERO;-17;;;
4005;4022;0;655;VERDADERO;VERDADERO;-17;;;
4005;4042;0;656;VERDADERO;VERDADERO;-37;;;
4005;4042;0;657;VERDADERO;VERDADERO;-37;;;
4005;4042;0;658;VERDADERO;VERDADERO;-37;;;
4041;4062;1;659;VERDADERO;VERDADERO;-21;;;
4041;4062;0;660;VERDADERO;VERDADERO;-21;;;
4041;4082;0;661;VERDADERO;VERDADERO;-41;;;
4041;4082;0;662;VERDADERO;VERDADERO;-41;;;
4041;4082;0;663;VERDADERO;VERDADERO;-41;;;
4073;4102;1;664;VERDADERO;VERDADERO;-29;;;
4073;4102;0;665;VERDADERO;VERDADERO;-29;;;
4073;4122;0;666;VERDADERO;VERDADERO;-49;;;
4073;4122;0;667;VERDADERO;VERDADERO;-49;;;
4073;4122;0;668;VERDADERO;VERDADERO;-49;;;
4105;4122;0;669;VERDADERO;VERDADERO;-17;;;
4105;4122;0;670;VERDADERO;VERDADERO;-17;;;
4105;4142;0;671;VERDADERO;VERDADERO;-37;;;
4105;4142;0;672;VERDADERO;VERDADERO;-37;;;
4105;4162;1;673;VERDADERO;FALSO;-57;;;
4137;4162;0;674;VERDADERO;VERDADERO;-25;;;
4137;4162;0;675;VERDADERO;VERDADERO;-25;;;
4137;4162;0;676;VERDADERO;VERDADERO;-25;;;
4137;4162;0;677;VERDADERO;VERDADERO;-25;;;
4137;4162;0;678;VERDADERO;VERDADERO;-25;;;
4169;4182;0;679;VERDADERO;VERDADERO;-13;;;
4169;4182;0;680;VERDADERO;VERDADERO;-13;;;
4169;4202;0;681;VERDADERO;VERDADERO;-33;;;
4169;4202;0;682;VERDADERO;VERDADERO;-33;;;
4169;4202;0;683;VERDADERO;VERDADERO;-33;;;
4169;4222;0;684;VERDADERO;FALSO;-53;;;
4205;4222;0;685;VERDADERO;VERDADERO;-17;;;
4205;4242;0;686;VERDADERO;VERDADERO;-37;;;
4205;4242;0;687;VERDADERO;VERDADERO;-37;;;
4205;4242;0;688;VERDADERO;VERDADERO;-37;;;
4205;4262;0;689;VERDADERO;FALSO;-57;;;
4237;4262;0;690;VERDADERO;VERDADERO;-25;;;
4237;4262;0;691;VERDADERO;VERDADERO;-25;;;
4237;4262;0;692;VERDADERO;VERDADERO;-25;;;
4237;4262;0;693;VERDADERO;VERDADERO;-25;;;
4237;4262;0;694;VERDADERO;VERDADERO;-25;;;
4269;4282;1;695;VERDADERO;VERDADERO;-13;;;
4269;4282;0;696;VERDADERO;VERDADERO;-13;;;
4269;4302;1;697;VERDADERO;VERDADERO;-33;;;
4269;4302;0;698;VERDADERO;VERDADERO;-33;;;
4269;4302;0;699;VERDADERO;VERDADERO;-33;;;
4301;4302;0;700;VERDADERO;VERDADERO;-1;;;
4301;4302;0;701;VERDADERO;VERDADERO;-1;;;
4301;4322;1;702;VERDADERO;VERDADERO;-21;;;
4301;4322;0;703;VERDADERO;VERDADERO;-21;;;
4301;4343;0;704;VERDADERO;VERDADERO;-42;;;
4333;4343;0;705;VERDADERO;VERDADERO;-10;;;
4333;4343;0;706;VERDADERO;VERDADERO;-10;;;
4333;4363;0;707;VERDADERO;VERDADERO;-30;;;
4333;4363;0;708;VERDADERO;VERDADERO;-30;;;
4333;4383;0;709;VERDADERO;FALSO;-50;;;
4369;4383;0;710;VERDADERO;VERDADERO;-14;;;
4369;4403;0;711;VERDADERO;VERDADERO;-34;;;
4369;4403;0;712;VERDADERO;VERDADERO;-34;;;
4369;4403;0;713;VERDADERO;VERDADERO;-34;;;
4369;4403;0;714;VERDADERO;VERDADERO;-34;;;
4369;4403;0;715;VERDADERO;VERDADERO;-34;;;
4401;4423;0;716;VERDADERO;VERDADERO;-22;;;
4401;4423;0;717;VERDADERO;VERDADERO;-22;;;
4401;4423;0;718;VERDADERO;VERDADERO;-22;;;
4401;4443;0;719;VERDADERO;VERDADERO;-42;;;
4401;4443;0;720;VERDADERO;VERDADERO;-42;;;
4433;4443;0;721;VERDADERO;VERDADERO;-10;;;
4433;4443;0;722;VERDADERO;VERDADERO;-10;;;
4433;4463;0;723;VERDADERO;VERDADERO;-30;;;
4433;4463;0;724;VERDADERO;VERDADERO;-30;;;
4433;4463;0;725;VERDADERO;VERDADERO;-30;;;
4469;4483;0;726;VERDADERO;VERDADERO;-14;;;
4469;4483;0;727;VERDADERO;VERDADERO;-14;;;
4469;4503;0;728;VERDADERO;VERDADERO;-34;;;
4469;4503;0;729;VERDADERO;VERDADERO;-34;;;
4469;4503;0;730;VERDADERO;VERDADERO;-34;;;
4501;4523;1;731;VERDADERO;VERDADERO;-22;;;
4501;4523;0;732;VERDADERO;VERDADERO;-22;;;
4501;4543;0;733;VERDADERO;VERDADERO;-42;;;
4501;4543;0;734;VERDADERO;VERDADERO;-42;;;
4501;4543;0;735;VERDADERO;VERDADERO;-42;;;
4534;4543;0;736;VERDADERO;VERDADERO;-9;;;
4534;4563;0;737;VERDADERO;VERDADERO;-29;;;
4534;4563;0;738;VERDADERO;VERDADERO;-29;;;
4534;4583;1;739;VERDADERO;VERDADERO;-49;;;
4534;4583;0;740;VERDADERO;VERDADERO;-49;;;
4565;4583;0;741;VERDADERO;VERDADERO;-18;;;
4565;4583;0;742;VERDADERO;VERDADERO;-18;;;
4565;4583;0;743;VERDADERO;VERDADERO;-18;;;
4565;4583;0;744;VERDADERO;VERDADERO;-18;;;
4565;4603;0;745;VERDADERO;VERDADERO;-38;;;
4597;4603;0;746;VERDADERO;VERDADERO;-6;;;
4597;4623;0;747;VERDADERO;VERDADERO;-26;;;
4597;4623;0;748;VERDADERO;VERDADERO;-26;;;
4597;4623;0;749;VERDADERO;VERDADERO;-26;;;
4597;4643;0;750;VERDADERO;VERDADERO;-46;;;
4597;4643;0;751;VERDADERO;VERDADERO;-46;;;
4633;4663;0;752;VERDADERO;VERDADERO;-30;;;
4633;4663;0;753;VERDADERO;VERDADERO;-30;;;
4633;4663;0;754;VERDADERO;VERDADERO;-30;;;
4633;4683;0;755;VERDADERO;FALSO;-50;;;
4633;4683;0;756;VERDADERO;FALSO;-50;;;
4665;4683;0;757;VERDADERO;VERDADERO;-18;;;
4665;4683;0;758;VERDADERO;VERDADERO;-18;;;
4665;4683;0;759;VERDADERO;VERDADERO;-18;;;
4665;4703;0;760;VERDADERO;VERDADERO;-38;;;
4665;4703;0;761;VERDADERO;VERDADERO;-38;;;
4697;4723;1;762;VERDADERO;VERDADERO;-26;;;
4697;4723;0;763;VERDADERO;VERDADERO;-26;;;
4697;4723;0;764;VERDADERO;VERDADERO;-26;;;
4697;4723;0;765;VERDADERO;VERDADERO;-26;;;
4697;4723;0;766;VERDADERO;VERDADERO;-26;;;
4729;4743;0;767;VERDADERO;VERDADERO;-14;;;
4729;4743;0;768;VERDADERO;VERDADERO;-14;;;
4729;4743;0;769;VERDADERO;VERDADERO;-14;;;
4729;4763;0;770;VERDADERO;VERDADERO;-34;;;
4729;4763;0;771;VERDADERO;VERDADERO;-34;;;
4762;4783;0;772;VERDADERO;VERDADERO;-21;;;
4762;4783;0;773;VERDADERO;VERDADERO;-21;;;
4762;4783;0;774;VERDADERO;VERDADERO;-21;;;
4762;4803;1;775;VERDADERO;VERDADERO;-41;;;
4762;4803;0;776;VERDADERO;VERDADERO;-41;;;
4762;4803;0;777;VERDADERO;VERDADERO;-41;;;
4798;4823;0;778;VERDADERO;VERDADERO;-25;;;
4798;4823;0;779;VERDADERO;VERDADERO;-25;;;
4798;4823;0;780;VERDADERO;VERDADERO;-25;;;
4798;4823;0;781;VERDADERO;VERDADERO;-25;;;
4798;4823;0;782;VERDADERO;VERDADERO;-25;;;
4829;4843;1;783;VERDADERO;VERDADERO;-14;;;
4829;4843;0;784;VERDADERO;VERDADERO;-14;;;
4829;4843;0;785;VERDADERO;VERDADERO;-14;;;
4829;4863;0;786;VERDADERO;VERDADERO;-34;;;
4829;4863;0;787;VERDADERO;VERDADERO;-34;;;
4865;4883;1;788;VERDADERO;VERDADERO;-18;;;
4865;4883;0;789;VERDADERO;VERDADERO;-18;;;
4865;4883;0;790;VERDADERO;VERDADERO;-18;;;
4865;4903;0;791;VERDADERO;VERDADERO;-38;;;
4865;4903;0;792;VERDADERO;VERDADERO;-38;;;
4865;4923;0;793;VERDADERO;FALSO;-58;;;
4901;4923;0;794;VERDADERO;VERDADERO;-22;;;
4901;4923;0;795;VERDADERO;VERDADERO;-22;;;
4901;4923;0;796;VERDADERO;VERDADERO;-22;;;
4901;4923;0;797;VERDADERO;VERDADERO;-22;;;
4901;4943;0;798;VERDADERO;VERDADERO;-42;;;
4933;4943;0;799;VERDADERO;VERDADERO;-10;;;
4933;4943;0;800;VERDADERO;VERDADERO;-10;;;
4933;4963;0;801;VERDADERO;VERDADERO;-30;;;
4933;4963;0;802;VERDADERO;VERDADERO;-30;;;
4933;4963;0;803;VERDADERO;VERDADERO;-30;;;
4965;4963;0;804;VERDADERO;VERDADERO;2;;;
4965;4983;0;805;VERDADERO;VERDADERO;-18;;;
4965;4983;0;806;VERDADERO;VERDADERO;-18;;;
4965;4983;0;807;VERDADERO;VERDADERO;-18;;;
4965;5003;0;808;VERDADERO;VERDADERO;-38;;;
4965;5003;0;809;VERDADERO;VERDADERO;-38;;;
5001;5023;1;810;VERDADERO;VERDADERO;-22;;;
5001;5023;0;811;VERDADERO;VERDADERO;-22;;;
5001;5023;0;812;VERDADERO;VERDADERO;-22;;;
5001;5043;0;813;VERDADERO;VERDADERO;-42;;;
5001;5043;0;814;VERDADERO;VERDADERO;-42;;;
5033;5063;0;815;VERDADERO;VERDADERO;-30;;;
5033;5063;0;816;VERDADERO;VERDADERO;-30;;;
5033;5063;0;817;VERDADERO;VERDADERO;-30;;;
5033;5063;0;818;VERDADERO;VERDADERO;-30;;;
5033;5063;0;819;VERDADERO;VERDADERO;-30;;;
5033;5083;0;820;VERDADERO;FALSO;-50;;;
5069;5083;0;821;VERDADERO;VERDADERO;-14;;;
5069;5103;1;822;VERDADERO;VERDADERO;-34;;;
5069;5103;0;823;VERDADERO;VERDADERO;-34;;;
5069;5103;0;824;VERDADERO;VERDADERO;-34;;;
5069;5103;0;825;VERDADERO;VERDADERO;-34;;;
5101;5103;0;826;VERDADERO;VERDADERO;-2;;;
5101;5123;0;827;VERDADERO;VERDADERO;-22;;;
5101;5123;0;828;VERDADERO;VERDADERO;-22;;;
5101;5143;1;829;VERDADERO;VERDADERO;-42;;;
5101;5143;0;830;VERDADERO;VERDADERO;-42;;;
5101;5143;0;831;VERDADERO;VERDADERO;-42;;;
5137;5163;1;832;VERDADERO;VERDADERO;-26;;;
5137;5163;0;833;VERDADERO;VERDADERO;-26;;;
5137;5183;0;834;VERDADERO;VERDADERO;-46;;;
5137;5183;0;835;VERDADERO;VERDADERO;-46;;;
5169;5183;0;836;VERDADERO;VERDADERO;-14;;;
5169;5203;0;837;VERDADERO;VERDADERO;-34;;;
5169;5203;0;838;VERDADERO;VERDADERO;-34;;;
5169;5203;0;839;VERDADERO;VERDADERO;-34;;;
5169;5203;0;840;VERDADERO;VERDADERO;-34;;;
5169;5223;0;841;VERDADERO;FALSO;-54;;;
5201;5223;0;842;VERDADERO;VERDADERO;-22;;;
5201;5243;0;843;VERDADERO;VERDADERO;-42;;;
5201;5243;0;844;VERDADERO;VERDADERO;-42;;;
5201;5243;0;845;VERDADERO;VERDADERO;-42;;;
5201;5243;0;846;VERDADERO;VERDADERO;-42;;;
5237;5243;0;847;VERDADERO;VERDADERO;-6;;;
5237;5263;0;848;VERDADERO;VERDADERO;-26;;;
5237;5263;0;849;VERDADERO;VERDADERO;-26;;;
5237;5263;0;850;VERDADERO;VERDADERO;-26;;;
5237;5283;0;851;VERDADERO;VERDADERO;-46;;;
5269;5283;0;852;VERDADERO;VERDADERO;-14;;;
5269;5283;0;853;VERDADERO;VERDADERO;-14;;;
5269;5283;0;854;VERDADERO;VERDADERO;-14;;;
5269;5283;0;855;VERDADERO;VERDADERO;-14;;;
5269;5303;0;856;VERDADERO;VERDADERO;-34;;;
5301;5303;0;857;VERDADERO;VERDADERO;-2;;;
5301;5303;0;858;VERDADERO;VERDADERO;-2;;;
5301;5324;0;859;VERDADERO;VERDADERO;-23;;;
5301;5324;0;860;VERDADERO;VERDADERO;-23;;;
5301;5344;0;861;VERDADERO;VERDADERO;-43;;;
5301;5344;0;862;VERDADERO;VERDADERO;-43;;;
5337;5344;0;863;VERDADERO;VERDADERO;-7;;;
5337;5364;0;864;VERDADERO;VERDADERO;-27;;;
5337;5364;0;865;VERDADERO;VERDADERO;-27;;;
5337;5364;0;866;VERDADERO;VERDADERO;-27;;;
5337;5384;0;867;VERDADERO;VERDADERO;-47;;;
5369;5384;0;868;VERDADERO;VERDADERO;-15;;;
5369;5384;0;869;VERDADERO;VERDADERO;-15;;;
5369;5384;0;870;VERDADERO;VERDADERO;-15;;;
5369;5404;0;871;VERDADERO;VERDADERO;-35;;;
5369;5404;0;872;VERDADERO;VERDADERO;-35;;;
5401;5424;1;873;VERDADERO;VERDADERO;-23;;;
5401;5424;0;874;VERDADERO;VERDADERO;-23;;;
5401;5424;0;875;VERDADERO;VERDADERO;-23;;;
5401;5444;0;876;VERDADERO;VERDADERO;-43;;;
5401;5444;0;877;VERDADERO;VERDADERO;-43;;;
5433;5464;1;878;VERDADERO;VERDADERO;-31;;;
5433;5464;0;879;VERDADERO;VERDADERO;-31;;;
5433;5464;0;880;VERDADERO;VERDADERO;-31;;;
5433;5484;0;881;VERDADERO;FALSO;-51;;;
5433;5484;0;882;VERDADERO;FALSO;-51;;;
5465;5484;0;883;VERDADERO;VERDADERO;-19;;;
5465;5484;0;884;VERDADERO;VERDADERO;-19;;;
5465;5504;1;885;VERDADERO;VERDADERO;-39;;;
5465;5504;0;886;VERDADERO;VERDADERO;-39;;;
5465;5504;0;887;VERDADERO;VERDADERO;-39;;;
5465;5524;0;888;VERDADERO;FALSO;-59;;;
5501;5524;0;889;VERDADERO;VERDADERO;-23;;;
5501;5524;0;890;VERDADERO;VERDADERO;-23;;;
5501;5524;0;891;VERDADERO;VERDADERO;-23;;;
5501;5524;0;892;VERDADERO;VERDADERO;-23;;;
5501;5524;0;893;VERDADERO;VERDADERO;-23;;;
5533;5544;1;894;VERDADERO;VERDADERO;-11;;;
5533;5544;0;895;VERDADERO;VERDADERO;-11;;;
5533;5564;0;896;VERDADERO;VERDADERO;-31;;;
5533;5564;0;897;VERDADERO;VERDADERO;-31;;;
5533;5584;0;898;VERDADERO;FALSO;-51;;;
5565;5584;0;899;VERDADERO;VERDADERO;-19;;;
5565;5584;0;900;VERDADERO;VERDADERO;-19;;;
5565;5604;0;901;VERDADERO;VERDADERO;-39;;;
5565;5604;0;902;VERDADERO;VERDADERO;-39;;;
5565;5624;1;903;VERDADERO;FALSO;-59;;;
5601;5624;0;904;VERDADERO;VERDADERO;-23;;;
5601;5624;0;905;VERDADERO;VERDADERO;-23;;;
5601;5624;0;906;VERDADERO;VERDADERO;-23;;;
5601;5624;0;907;VERDADERO;VERDADERO;-23;;;
5601;5644;0;908;VERDADERO;VERDADERO;-43;;;
5633;5644;0;909;VERDADERO;VERDADERO;-11;;;
5633;5644;0;910;VERDADERO;VERDADERO;-11;;;
5633;5664;0;911;VERDADERO;VERDADERO;-31;;;
5633;5664;0;912;VERDADERO;VERDADERO;-31;;;
5633;5684;1;913;VERDADERO;FALSO;-51;;;
5665;5684;0;914;VERDADERO;VERDADERO;-19;;;
5665;5684;0;915;VERDADERO;VERDADERO;-19;;;
5665;5704;0;916;VERDADERO;VERDADERO;-39;;;
5665;5704;0;917;VERDADERO;VERDADERO;-39;;;
5665;5724;0;918;VERDADERO;FALSO;-59;;;
5665;5724;0;919;VERDADERO;FALSO;-59;;;
5701;5724;0;920;VERDADERO;VERDADERO;-23;;;
5701;5724;0;921;VERDADERO;VERDADERO;-23;;;
5701;5744;0;922;VERDADERO;VERDADERO;-43;;;
5701;5744;0;923;VERDADERO;VERDADERO;-43;;;
5701;5764;0;924;VERDADERO;FALSO;-63;;;
5733;5764;0;925;VERDADERO;VERDADERO;-31;;;
5733;5764;0;926;VERDADERO;VERDADERO;-31;;;
5733;5764;0;927;VERDADERO;VERDADERO;-31;;;
5733;5764;0;928;VERDADERO;VERDADERO;-31;;;
5733;5784;0;929;VERDADERO;FALSO;-51;;;
5765;5784;0;930;VERDADERO;VERDADERO;-19;;;
5765;5784;0;931;VERDADERO;VERDADERO;-19;;;
5765;5804;0;932;VERDADERO;VERDADERO;-39;;;
5765;5804;0;933;VERDADERO;VERDADERO;-39;;;
5765;5804;0;934;VERDADERO;VERDADERO;-39;;;
5765;5804;0;935;VERDADERO;VERDADERO;-39;;;
5801;5804;0;936;VERDADERO;VERDADERO;-3;;;
5801;5824;0;937;VERDADERO;VERDADERO;-23;;;
5801;5824;0;938;VERDADERO;VERDADERO;-23;;;
5801;5844;0;939;VERDADERO;VERDADERO;-43;;;
5801;5844;0;940;VERDADERO;VERDADERO;-43;;;
5833;5844;0;941;VERDADERO;VERDADERO;-11;;;
5833;5864;0;942;VERDADERO;VERDADERO;-31;;;
5833;5864;0;943;VERDADERO;VERDADERO;-31;;;
5833;5884;1;944;VERDADERO;FALSO;-51;;;
5833;5884;0;945;VERDADERO;FALSO;-51;;;
5865;5884;0;946;VERDADERO;VERDADERO;-19;;;
5865;5904;0;947;VERDADERO;VERDADERO;-39;;;
5865;5904;0;948;VERDADERO;VERDADERO;-39;;;
5865;5904;0;949;VERDADERO;VERDADERO;-39;;;
5865;5904;0;950;VERDADERO;VERDADERO;-39;;;
5897;5924;0;951;VERDADERO;VERDADERO;-27;;;
5897;5924;0;952;VERDADERO;VERDADERO;-27;;;
5897;5924;0;953;VERDADERO;VERDADERO;-27;;;
5897;5944;0;954;VERDADERO;VERDADERO;-47;;;
5897;5944;0;955;VERDADERO;VERDADERO;-47;;;
5929;5944;0;956;VERDADERO;VERDADERO;-15;;;
5929;5944;0;957;VERDADERO;VERDADERO;-15;;;
5929;5944;0;958;VERDADERO;VERDADERO;-15;;;
5929;5944;0;959;VERDADERO;VERDADERO;-15;;;
5929;5944;0;960;VERDADERO;VERDADERO;-15;;;
5929;5964;0;961;VERDADERO;VERDADERO;-35;;;
5965;5964;0;962;VERDADERO;VERDADERO;1;;;
5965;5984;0;963;VERDADERO;VERDADERO;-19;;;
5965;5984;0;964;VERDADERO;VERDADERO;-19;;;
5965;5984;0;965;VERDADERO;VERDADERO;-19;;;
5965;6004;0;966;VERDADERO;VERDADERO;-39;;;
5997;6004;0;967;VERDADERO;VERDADERO;-7;;;
5997;6004;0;968;VERDADERO;VERDADERO;-7;;;
5997;6024;0;969;VERDADERO;VERDADERO;-27;;;
5997;6024;0;970;VERDADERO;VERDADERO;-27;;;
5997;6024;0;971;VERDADERO;VERDADERO;-27;;;
6029;6044;0;972;VERDADERO;VERDADERO;-15;;;
6029;6044;0;973;VERDADERO;VERDADERO;-15;;;
6029;6044;0;974;VERDADERO;VERDADERO;-15;;;
6029;6044;0;975;VERDADERO;VERDADERO;-15;;;
6029;6044;0;976;VERDADERO;VERDADERO;-15;;;
6061;6064;0;977;VERDADERO;VERDADERO;-3;;;
6061;6064;0;978;VERDADERO;VERDADERO;-3;;;
6061;6064;0;979;VERDADERO;VERDADERO;-3;;;
6061;6084;0;980;VERDADERO;VERDADERO;-23;;;
6061;6084;0;981;VERDADERO;VERDADERO;-23;;;
6094;6104;0;982;VERDADERO;VERDADERO;-10;;;
6094;6104;0;983;VERDADERO;VERDADERO;-10;;;
6094;6104;0;984;VERDADERO;VERDADERO;-10;;;
6094;6124;1;985;VERDADERO;VERDADERO;-30;;;
6094;6124;0;986;VERDADERO;VERDADERO;-30;;;
6094;6124;0;987;VERDADERO;VERDADERO;-30;;;
6129;6144;1;988;VERDADERO;VERDADERO;-15;;;
6129;6144;0;989;VERDADERO;VERDADERO;-15;;;
6129;6164;0;990;VERDADERO;VERDADERO;-35;;;
6129;6164;0;991;VERDADERO;VERDADERO;-35;;;
6129;6184;0;992;VERDADERO;FALSO;-55;;;
6161;6184;0;993;VERDADERO;VERDADERO;-23;;;
6161;6184;0;994;VERDADERO;VERDADERO;-23;;;
6161;6204;0;995;VERDADERO;VERDADERO;-43;;;
6161;6204;0;996;VERDADERO;VERDADERO;-43;;;
6161;6204;0;997;VERDADERO;VERDADERO;-43;;;
6196;6204;0;998;VERDADERO;VERDADERO;-8;;;
6196;6224;0;999;VERDADERO;VERDADERO;-28;;;
6196;6224;0;1000;VERDADERO;VERDADERO;-28;;;
6196;6244;0;1001;VERDADERO;VERDADERO;-48;;;
6196;6244;0;1002;VERDADERO;VERDADERO;-48;;;
6229;6244;0;1003;VERDADERO;VERDADERO;-15;;;
6229;6244;0;1004;VERDADERO;VERDADERO;-15;;;
6229;6244;0;1005;VERDADERO;VERDADERO;-15;;;
6229;6244;0;1006;VERDADERO;VERDADERO;-15;;;
6229;6264;0;1007;VERDADERO;VERDADERO;-35;;;
6229;6264;0;1008;VERDADERO;VERDADERO;-35;;;
6265;6284;0;1009;VERDADERO;VERDADERO;-19;;;
6265;6284;0;1010;VERDADERO;VERDADERO;-19;;;
6265;6284;0;1011;VERDADERO;VERDADERO;-19;;;
6265;6304;0;1012;VERDADERO;VERDADERO;-39;;;
6265;6304;0;1013;VERDADERO;VERDADERO;-39;;;
6265;6324;0;1014;VERDADERO;FALSO;-59;;;
6302;6324;0;1015;VERDADERO;VERDADERO;-22;;;
6302;6344;0;1016;VERDADERO;VERDADERO;-42;;;
6302;6344;0;1017;VERDADERO;VERDADERO;-42;;;
6302;6344;0;1018;VERDADERO;VERDADERO;-42;;;
6329;6344;0;1019;VERDADERO;VERDADERO;-15;;;
6329;6364;0;1020;VERDADERO;VERDADERO;-35;;;
6329;6364;0;1021;VERDADERO;VERDADERO;-35;;;
6329;6364;0;1022;VERDADERO;VERDADERO;-35;;;
6329;6384;1;1023;VERDADERO;FALSO;-55;;;
6365;6384;0;1024;VERDADERO;VERDADERO;-19;;;
6365;6384;0;1025;VERDADERO;VERDADERO;-19;;;
6365;6384;0;1026;VERDADERO;VERDADERO;-19;;;
6365;6404;0;1027;VERDADERO;VERDADERO;-39;;;
6365;6404;0;1028;VERDADERO;VERDADERO;-39;;;
6397;6404;0;1029;VERDADERO;VERDADERO;-7;;;
6397;6424;0;1030;VERDADERO;VERDADERO;-27;;;
6397;6424;0;1031;VERDADERO;VERDADERO;-27;;;
6397;6424;0;1032;VERDADERO;VERDADERO;-27;;;
6397;6424;0;1033;VERDADERO;VERDADERO;-27;;;
6397;6444;0;1034;VERDADERO;VERDADERO;-47;;;
6433;6444;0;1035;VERDADERO;VERDADERO;-11;;;
6433;6444;0;1036;VERDADERO;VERDADERO;-11;;;
6433;6464;0;1037;VERDADERO;VERDADERO;-31;;;
6433;6464;0;1038;VERDADERO;VERDADERO;-31;;;
6433;6484;0;1039;VERDADERO;FALSO;-51;;;
6433;6484;0;1040;VERDADERO;FALSO;-51;;;
6469;6504;0;1041;VERDADERO;VERDADERO;-35;;;
6469;6504;0;1042;VERDADERO;VERDADERO;-35;;;
6469;6504;0;1043;VERDADERO;VERDADERO;-35;;;
6469;6524;0;1044;VERDADERO;FALSO;-55;;;
6469;6524;0;1045;VERDADERO;FALSO;-55;;;
6501;6524;0;1046;VERDADERO;VERDADERO;-23;;;
6501;6524;0;1047;VERDADERO;VERDADERO;-23;;;
6501;6524;0;1048;VERDADERO;VERDADERO;-23;;;
6501;6524;0;1049;VERDADERO;VERDADERO;-23;;;
6501;6544;1;1050;VERDADERO;VERDADERO;-43;;;
6533;6544;0;1051;VERDADERO;VERDADERO;-11;;;
6533;6564;0;1052;VERDADERO;VERDADERO;-31;;;
6533;6564;0;1053;VERDADERO;VERDADERO;-31;;;
6533;6564;0;1054;VERDADERO;VERDADERO;-31;;;
6533;6564;0;1055;VERDADERO;VERDADERO;-31;;;
6533;6564;0;1056;VERDADERO;VERDADERO;-31;;;
6569;6564;0;1057;VERDADERO;VERDADERO;5;;;
6569;6584;0;1058;VERDADERO;VERDADERO;-15;;;
6569;6584;0;1059;VERDADERO;VERDADERO;-15;;;
6569;6584;0;1060;VERDADERO;VERDADERO;-15;;;
6569;6604;0;1061;VERDADERO;VERDADERO;-35;;;
6601;6604;0;1062;VERDADERO;VERDADERO;-3;;;
6601;6624;0;1063;VERDADERO;VERDADERO;-23;;;
6601;6624;0;1064;VERDADERO;VERDADERO;-23;;;
6601;6624;0;1065;VERDADERO;VERDADERO;-23;;;
6601;6644;0;1066;VERDADERO;VERDADERO;-43;;;
6633;6644;0;1067;VERDADERO;VERDADERO;-11;;;
6633;6664;0;1068;VERDADERO;VERDADERO;-31;;;
6633;6664;0;1069;VERDADERO;VERDADERO;-31;;;
6633;6664;0;1070;VERDADERO;VERDADERO;-31;;;
6633;6664;0;1071;VERDADERO;VERDADERO;-31;;;
6665;6664;0;1072;VERDADERO;VERDADERO;1;;;
6665;6664;0;1073;VERDADERO;VERDADERO;1;;;
6665;6684;0;1074;VERDADERO;VERDADERO;-19;;;
6665;6684;0;1075;VERDADERO;VERDADERO;-19;;;
6665;6705;0;1076;VERDADERO;VERDADERO;-40;;;
6696;6705;0;1077;VERDADERO;VERDADERO;-9;;;
6696;6705;0;1078;VERDADERO;VERDADERO;-9;;;
6696;6725;0;1079;VERDADERO;VERDADERO;-29;;;
6696;6725;0;1080;VERDADERO;VERDADERO;-29;;;
6696;6725;0;1081;VERDADERO;VERDADERO;-29;;;
6696;6745;1;1082;VERDADERO;VERDADERO;-49;;;
6733;6745;0;1083;VERDADERO;VERDADERO;-12;;;
6733;6765;1;1084;VERDADERO;VERDADERO;-32;;;
6733;6765;0;1085;VERDADERO;VERDADERO;-32;;;
6733;6765;0;1086;VERDADERO;VERDADERO;-32;;;
6733;6765;0;1087;VERDADERO;VERDADERO;-32;;;
6765;6765;0;1088;VERDADERO;VERDADERO;0;;;
6765;6765;0;1089;VERDADERO;VERDADERO;0;;;
6765;6785;0;1090;VERDADERO;VERDADERO;-20;;;
6765;6785;0;1091;VERDADERO;VERDADERO;-20;;;
6765;6805;0;1092;VERDADERO;VERDADERO;-40;;;
6797;6805;0;1093;VERDADERO;VERDADERO;-8;;;
6797;6805;0;1094;VERDADERO;VERDADERO;-8;;;
6797;6825;0;1095;VERDADERO;VERDADERO;-28;;;
6797;6825;0;1096;VERDADERO;VERDADERO;-28;;;
6797;6825;0;1097;VERDADERO;VERDADERO;-28;;;
6797;6825;0;1098;VERDADERO;VERDADERO;-28;;;
6833;6845;1;1099;VERDADERO;VERDADERO;-12;;;
6833;6845;0;1100;VERDADERO;VERDADERO;-12;;;
6833;6865;0;1101;VERDADERO;VERDADERO;-32;;;
6833;6865;0;1102;VERDADERO;VERDADERO;-32;;;
6833;6865;0;1103;VERDADERO;VERDADERO;-32;;;
6865;6885;1;1104;VERDADERO;VERDADERO;-20;;;
6865;6885;0;1105;VERDADERO;VERDADERO;-20;;;
6865;6905;0;1106;VERDADERO;VERDADERO;-40;;;
6865;6905;0;1107;VERDADERO;VERDADERO;-40;;;
6865;6905;0;1108;VERDADERO;VERDADERO;-40;;;
6897;6925;0;1109;VERDADERO;VERDADERO;-28;;;
6897;6925;0;1110;VERDADERO;VERDADERO;-28;;;
6897;6925;0;1111;VERDADERO;VERDADERO;-28;;;
6897;6925;0;1112;VERDADERO;VERDADERO;-28;;;
6897;6925;0;1113;VERDADERO;VERDADERO;-28;;;
6933;6945;0;1114;VERDADERO;VERDADERO;-12;;;
6933;6945;0;1115;VERDADERO;VERDADERO;-12;;;
6933;6945;0;1116;VERDADERO;VERDADERO;-12;;;
6933;6965;0;1117;VERDADERO;VERDADERO;-32;;;
6933;6965;0;1118;VERDADERO;VERDADERO;-32;;;
6965;6985;0;1119;VERDADERO;VERDADERO;-20;;;
6965;6985;0;1120;VERDADERO;VERDADERO;-20;;;
6965;6985;0;1121;VERDADERO;VERDADERO;-20;;;
6965;7005;1;1122;VERDADERO;VERDADERO;-40;;;
6965;7005;0;1123;VERDADERO;VERDADERO;-40;;;
6997;7005;0;1124;VERDADERO;VERDADERO;-8;;;
6997;7025;0;1125;VERDADERO;VERDADERO;-28;;;
6997;7025;0;1126;VERDADERO;VERDADERO;-28;;;
6997;7025;0;1127;VERDADERO;VERDADERO;-28;;;
6997;7025;0;1128;VERDADERO;VERDADERO;-28;;;
6997;7025;0;1129;VERDADERO;VERDADERO;-28;;;
7033;7045;0;1130;VERDADERO;VERDADERO;-12;;;
7033;7045;0;1131;VERDADERO;VERDADERO;-12;;;
7033;7045;0;1132;VERDADERO;VERDADERO;-12;;;
7033;7065;0;1133;VERDADERO;VERDADERO;-32;;;
7033;7065;0;1134;VERDADERO;VERDADERO;-32;;;
7065;7085;0;1135;VERDADERO;VERDADERO;-20;;;
7065;7085;0;1136;VERDADERO;VERDADERO;-20;;;
7065;7085;0;1137;VERDADERO;VERDADERO;-20;;;
7065;7105;0;1138;VERDADERO;VERDADERO;-40;;;
7065;7105;0;1139;VERDADERO;VERDADERO;-40;;;
7097;7105;0;1140;VERDADERO;VERDADERO;-8;;;
7097;7125;0;1141;VERDADERO;VERDADERO;-28;;;
7097;7125;0;1142;VERDADERO;VERDADERO;-28;;;
7097;7125;0;1143;VERDADERO;VERDADERO;-28;;;
7097;7125;0;1144;VERDADERO;VERDADERO;-28;;;
7129;7125;0;1145;VERDADERO;VERDADERO;4;;;
7129;7125;0;1146;VERDADERO;VERDADERO;4;;;
7129;7125;0;1147;VERDADERO;VERDADERO;4;;;
7129;7145;1;1148;VERDADERO;VERDADERO;-16;;;
7129;7145;0;1149;VERDADERO;VERDADERO;-16;;;
7160;7165;0;1150;VERDADERO;VERDADERO;-5;;;
7160;7165;0;1151;VERDADERO;VERDADERO;-5;;;
7160;7165;0;1152;VERDADERO;VERDADERO;-5;;;
7160;7185;0;1153;VERDADERO;VERDADERO;-25;;;
7160;7185;0;1154;VERDADERO;VERDADERO;-25;;;
7160;7205;0;1155;VERDADERO;VERDADERO;-45;;;
7197;7205;0;1156;VERDADERO;VERDADERO;-8;;;
7197;7225;0;1157;VERDADERO;VERDADERO;-28;;;
7197;7225;0;1158;VERDADERO;VERDADERO;-28;;;
7197;7225;0;1159;VERDADERO;VERDADERO;-28;;;
7197;7245;0;1160;VERDADERO;VERDADERO;-48;;;
7229;7245;0;1161;VERDADERO;VERDADERO;-16;;;
7229;7265;1;1162;VERDADERO;VERDADERO;-36;;;
7229;7265;0;1163;VERDADERO;VERDADERO;-36;;;
7229;7265;0;1164;VERDADERO;VERDADERO;-36;;;
7229;7285;0;1165;VERDADERO;FALSO;-56;;;
7261;7285;0;1166;VERDADERO;VERDADERO;-24;;;
7261;7285;0;1167;VERDADERO;VERDADERO;-24;;;
7261;7285;0;1168;VERDADERO;VERDADERO;-24;;;
7261;7285;0;1169;VERDADERO;VERDADERO;-24;;;
7261;7305;0;1170;VERDADERO;VERDADERO;-44;;;
7293;7305;0;1171;VERDADERO;VERDADERO;-12;;;
7293;7325;0;1172;VERDADERO;VERDADERO;-32;;;
7293;7325;0;1173;VERDADERO;VERDADERO;-32;;;
7293;7325;0;1174;VERDADERO;VERDADERO;-32;;;
7293;7325;0;1175;VERDADERO;VERDADERO;-32;;;
7326;7325;0;1176;VERDADERO;VERDADERO;1;;;
7326;7345;0;1177;VERDADERO;VERDADERO;-19;;;
7326;7345;0;1178;VERDADERO;VERDADERO;-19;;;
7326;7365;0;1179;VERDADERO;VERDADERO;-39;;;
7326;7365;0;1180;VERDADERO;VERDADERO;-39;;;
7326;7365;0;1181;VERDADERO;VERDADERO;-39;;;
7361;7385;1;1182;VERDADERO;VERDADERO;-24;;;
7361;7385;0;1183;VERDADERO;VERDADERO;-24;;;
7361;7405;0;1184;VERDADERO;VERDADERO;-44;;;
7361;7405;0;1185;VERDADERO;VERDADERO;-44;;;
7361;7405;0;1186;VERDADERO;VERDADERO;-44;;;
7393;7425;0;1187;VERDADERO;VERDADERO;-32;;;
7393;7425;0;1188;VERDADERO;VERDADERO;-32;;;
7393;7425;0;1189;VERDADERO;VERDADERO;-32;;;
7393;7425;0;1190;VERDADERO;VERDADERO;-32;;;
7393;7445;0;1191;VERDADERO;FALSO;-52;;;
7393;7445;0;1192;VERDADERO;FALSO;-52;;;
7429;7465;0;1193;VERDADERO;VERDADERO;-36;;;
7429;7465;0;1194;VERDADERO;VERDADERO;-36;;;
7429;7465;0;1195;VERDADERO;VERDADERO;-36;;;
7429;7465;0;1196;VERDADERO;VERDADERO;-36;;;
7429;7465;0;1197;VERDADERO;VERDADERO;-36;;;
7461;7465;0;1198;VERDADERO;VERDADERO;-4;;;
7461;7485;0;1199;VERDADERO;VERDADERO;-24;;;
7461;7485;0;1200;VERDADERO;VERDADERO;-24;;;
7461;7505;0;1201;VERDADERO;VERDADERO;-44;;;
7461;7505;0;1202;VERDADERO;VERDADERO;-44;;;
7461;7505;0;1203;VERDADERO;VERDADERO;-44;;;
7497;7505;0;1204;VERDADERO;VERDADERO;-8;;;
7497;7505;0;1205;VERDADERO;VERDADERO;-8;;;
7497;7505;0;1206;VERDADERO;VERDADERO;-8;;;
7497;7525;0;1207;VERDADERO;VERDADERO;-28;;;
7497;7525;0;1208;VERDADERO;VERDADERO;-28;;;
7530;7545;0;1209;VERDADERO;VERDADERO;-15;;;
7530;7545;0;1210;VERDADERO;VERDADERO;-15;;;
7530;7545;0;1211;VERDADERO;VERDADERO;-15;;;
7530;7565;0;1212;VERDADERO;VERDADERO;-35;;;
7530;7565;0;1213;VERDADERO;VERDADERO;-35;;;
7561;7585;0;1214;VERDADERO;VERDADERO;-24;;;
7561;7585;0;1215;VERDADERO;VERDADERO;-24;;;
7561;7585;0;1216;VERDADERO;VERDADERO;-24;;;
7561;7605;0;1217;VERDADERO;VERDADERO;-44;;;
7561;7605;0;1218;VERDADERO;VERDADERO;-44;;;
7561;7605;0;1219;VERDADERO;VERDADERO;-44;;;
7597;7605;0;1220;VERDADERO;VERDADERO;-8;;;
7597;7625;0;1221;VERDADERO;VERDADERO;-28;;;
7597;7625;0;1222;VERDADERO;VERDADERO;-28;;;
7597;7645;0;1223;VERDADERO;VERDADERO;-48;;;
7597;7645;0;1224;VERDADERO;VERDADERO;-48;;;
7629;7645;0;1225;VERDADERO;VERDADERO;-16;;;
7629;7645;0;1226;VERDADERO;VERDADERO;-16;;;
7629;7645;0;1227;VERDADERO;VERDADERO;-16;;;
7629;7665;0;1228;VERDADERO;VERDADERO;-36;;;
7629;7665;0;1229;VERDADERO;VERDADERO;-36;;;
7665;7685;0;1230;VERDADERO;VERDADERO;-20;;;
7665;7685;0;1231;VERDADERO;VERDADERO;-20;;;
7665;7685;0;1232;VERDADERO;VERDADERO;-20;;;
7665;7705;0;1233;VERDADERO;VERDADERO;-40;;;
7665;7705;0;1234;VERDADERO;VERDADERO;-40;;;
7665;7705;0;1235;VERDADERO;VERDADERO;-40;;;
7697;7705;0;1236;VERDADERO;VERDADERO;-8;;;
7697;7705;0;1237;VERDADERO;VERDADERO;-8;;;
7697;7705;0;1238;VERDADERO;VERDADERO;-8;;;
7697;7725;0;1239;VERDADERO;VERDADERO;-28;;;
7697;7725;0;1240;VERDADERO;VERDADERO;-28;;;
7733;7745;0;1241;VERDADERO;VERDADERO;-12;;;
7733;7745;0;1242;VERDADERO;VERDADERO;-12;;;
7733;7745;0;1243;VERDADERO;VERDADERO;-12;;;
7733;7745;0;1244;VERDADERO;VERDADERO;-12;;;
7733;7745;0;1245;VERDADERO;VERDADERO;-12;;;
7733;7745;0;1246;VERDADERO;VERDADERO;-12;;;
7765;7765;1;1247;VERDADERO;VERDADERO;0;;;
7765;7765;0;1248;VERDADERO;VERDADERO;0;;;
7765;7765;0;1249;VERDADERO;VERDADERO;0;;;
7765;7785;0;1250;VERDADERO;VERDADERO;-20;;;
7765;7785;0;1251;VERDADERO;VERDADERO;-20;;;
7797;7805;0;1252;VERDADERO;VERDADERO;-8;;;
7797;7805;0;1253;VERDADERO;VERDADERO;-8;;;
7797;7805;0;1254;VERDADERO;VERDADERO;-8;;;
7797;7825;1;1255;VERDADERO;VERDADERO;-28;;;
7797;7825;0;1256;VERDADERO;VERDADERO;-28;;;
7829;7846;0;1257;VERDADERO;VERDADERO;-17;;;
7829;7846;0;1258;VERDADERO;VERDADERO;-17;;;
7829;7846;0;1259;VERDADERO;VERDADERO;-17;;;
7829;7866;1;1260;VERDADERO;VERDADERO;-37;;;
7829;7866;0;1261;VERDADERO;VERDADERO;-37;;;
7862;7866;0;1262;VERDADERO;VERDADERO;-4;;;
7862;7866;0;1263;VERDADERO;VERDADERO;-4;;;
7862;7886;1;1264;VERDADERO;VERDADERO;-24;;;
7862;7886;0;1265;VERDADERO;VERDADERO;-24;;;
7893;7906;0;1266;VERDADERO;VERDADERO;-13;;;
7893;7906;0;1267;VERDADERO;VERDADERO;-13;;;
7893;7906;0;1268;VERDADERO;VERDADERO;-13;;;
7893;7906;0;1269;VERDADERO;VERDADERO;-13;;;
7893;7906;0;1270;VERDADERO;VERDADERO;-13;;;
7925;7906;0;1271;VERDADERO;VERDADERO;19;;;
7925;7926;0;1272;VERDADERO;VERDADERO;-1;;;
7925;7926;0;1273;VERDADERO;VERDADERO;-1;;;
7925;7947;0;1274;VERDADERO;VERDADERO;-22;;;
7925;7947;0;1275;VERDADERO;VERDADERO;-22;;;
7925;7947;0;1276;VERDADERO;VERDADERO;-22;;;
7961;7967;0;1277;VERDADERO;VERDADERO;-6;;;
7961;7967;0;1278;VERDADERO;VERDADERO;-6;;;
7961;7987;0;1279;VERDADERO;VERDADERO;-26;;;
7961;7987;0;1280;VERDADERO;VERDADERO;-26;;;
7961;7987;0;1281;VERDADERO;VERDADERO;-26;;;
7993;8007;0;1282;VERDADERO;VERDADERO;-14;;;
7993;8007;0;1283;VERDADERO;VERDADERO;-14;;;
7993;8027;0;1284;VERDADERO;VERDADERO;-34;;;
7993;8027;0;1285;VERDADERO;VERDADERO;-34;;;
7993;8027;0;1286;VERDADERO;VERDADERO;-34;;;
7993;8027;0;1287;VERDADERO;VERDADERO;-34;;;
8025;8047;0;1288;VERDADERO;VERDADERO;-22;;;
8025;8047;0;1289;VERDADERO;VERDADERO;-22;;;
8025;8067;0;1290;VERDADERO;VERDADERO;-42;;;
8025;8067;0;1291;VERDADERO;VERDADERO;-42;;;
8025;8067;0;1292;VERDADERO;VERDADERO;-42;;;
8025;8067;0;1293;VERDADERO;VERDADERO;-42;;;
8063;8067;0;1294;VERDADERO;VERDADERO;-4;;;
8063;8067;0;1295;VERDADERO;VERDADERO;-4;;;
8063;8087;0;1296;VERDADERO;VERDADERO;-24;;;
8063;8087;0;1297;VERDADERO;VERDADERO;-24;;;
8093;8107;0;1298;VERDADERO;VERDADERO;-14;;;
8093;8107;0;1299;VERDADERO;VERDADERO;-14;;;
8093;8107;0;1300;VERDADERO;VERDADERO;-14;;;
8093;8127;0;1301;VERDADERO;VERDADERO;-34;;;
8093;8127;0;1302;VERDADERO;VERDADERO;-34;;;
8125;8127;0;1303;VERDADERO;VERDADERO;-2;;;
8125;8147;0;1304;VERDADERO;VERDADERO;-22;;;
8125;8147;0;1305;VERDADERO;VERDADERO;-22;;;
8125;8147;0;1306;VERDADERO;VERDADERO;-22;;;
8125;8167;0;1307;VERDADERO;VERDADERO;-42;;;
8125;8167;0;1308;VERDADERO;VERDADERO;-42;;;
8161;8187;0;1309;VERDADERO;VERDADERO;-26;;;
8161;8187;0;1310;VERDADERO;VERDADERO;-26;;;
8161;8187;0;1311;VERDADERO;VERDADERO;-26;;;
8161;8207;0;1312;VERDADERO;VERDADERO;-46;;;
8161;8207;0;1313;VERDADERO;VERDADERO;-46;;;
8161;8227;0;1314;VERDADERO;FALSO;-66;;;
8197;8227;0;1315;VERDADERO;VERDADERO;-30;;;
8197;8227;0;1316;VERDADERO;VERDADERO;-30;;;
8197;8227;0;1317;VERDADERO;VERDADERO;-30;;;
8197;8227;0;1318;VERDADERO;VERDADERO;-30;;;
8197;8247;0;1319;VERDADERO;FALSO;-50;;;
8228;8247;0;1320;VERDADERO;VERDADERO;-19;;;
8228;8267;0;1321;VERDADERO;VERDADERO;-39;;;
8228;8267;0;1322;VERDADERO;VERDADERO;-39;;;
8228;8267;0;1323;VERDADERO;VERDADERO;-39;;;
8261;8267;0;1324;VERDADERO;VERDADERO;-6;;;
8261;8267;0;1325;VERDADERO;VERDADERO;-6;;;
8261;8267;0;1326;VERDADERO;VERDADERO;-6;;;
8261;8287;0;1327;VERDADERO;VERDADERO;-26;;;
8261;8287;0;1328;VERDADERO;VERDADERO;-26;;;
8261;8307;0;1329;VERDADERO;VERDADERO;-46;;;
8297;8307;0;1330;VERDADERO;VERDADERO;-10;;;
8297;8307;0;1331;VERDADERO;VERDADERO;-10;;;
8297;8327;0;1332;VERDADERO;VERDADERO;-30;;;
8297;8327;0;1333;VERDADERO;VERDADERO;-30;;;
8297;8327;0;1334;VERDADERO;VERDADERO;-30;;;
8297;8347;0;1335;VERDADERO;FALSO;-50;;;
8334;8347;0;1336;VERDADERO;VERDADERO;-13;;;
8334;8347;0;1337;VERDADERO;VERDADERO;-13;;;
8334;8367;0;1338;VERDADERO;VERDADERO;-33;;;
8334;8367;0;1339;VERDADERO;VERDADERO;-33;;;
8334;8367;0;1340;VERDADERO;VERDADERO;-33;;;
8365;8367;0;1341;VERDADERO;VERDADERO;-2;;;
8365;8367;0;1342;VERDADERO;VERDADERO;-2;;;
8365;8367;0;1343;VERDADERO;VERDADERO;-2;;;
8365;8367;0;1344;VERDADERO;VERDADERO;-2;;;
8365;8387;0;1345;VERDADERO;VERDADERO;-22;;;
8365;8387;0;1346;VERDADERO;VERDADERO;-22;;;
8401;8387;0;1347;VERDADERO;VERDADERO;14;;;
8401;8407;0;1348;VERDADERO;VERDADERO;-6;;;
8401;8407;0;1349;VERDADERO;VERDADERO;-6;;;
8401;8427;0;1350;VERDADERO;VERDADERO;-26;;;
8401;8427;0;1351;VERDADERO;VERDADERO;-26;;;
8433;8427;0;1352;VERDADERO;VERDADERO;6;;;
8433;8447;0;1353;VERDADERO;VERDADERO;-14;;;
8433;8447;0;1354;VERDADERO;VERDADERO;-14;;;
8433;8447;0;1355;VERDADERO;VERDADERO;-14;;;
8433;8467;0;1356;VERDADERO;VERDADERO;-34;;;
8465;8467;0;1357;VERDADERO;VERDADERO;-2;;;
8465;8487;0;1358;VERDADERO;VERDADERO;-22;;;
8465;8487;0;1359;VERDADERO;VERDADERO;-22;;;
8465;8487;0;1360;VERDADERO;VERDADERO;-22;;;
8465;8507;0;1361;VERDADERO;VERDADERO;-42;;;
8497;8507;0;1362;VERDADERO;VERDADERO;-10;;;
8497;8527;0;1363;VERDADERO;VERDADERO;-30;;;
8497;8527;0;1364;VERDADERO;VERDADERO;-30;;;
8497;8527;0;1365;VERDADERO;VERDADERO;-30;;;
8497;8527;0;1366;VERDADERO;VERDADERO;-30;;;
8529;8527;0;1367;VERDADERO;VERDADERO;2;;;
8529;8547;0;1368;VERDADERO;VERDADERO;-18;;;
8529;8547;0;1369;VERDADERO;VERDADERO;-18;;;
8529;8567;0;1370;VERDADERO;VERDADERO;-38;;;
8529;8567;0;1371;VERDADERO;VERDADERO;-38;;;
8529;8567;0;1372;VERDADERO;VERDADERO;-38;;;
8565;8587;0;1373;VERDADERO;VERDADERO;-22;;;
8565;8587;0;1374;VERDADERO;VERDADERO;-22;;;
8565;8607;0;1375;VERDADERO;VERDADERO;-42;;;
8565;8607;0;1376;VERDADERO;VERDADERO;-42;;;
8565;8607;0;1377;VERDADERO;VERDADERO;-42;;;
8597;8627;0;1378;VERDADERO;VERDADERO;-30;;;
8597;8627;0;1379;VERDADERO;VERDADERO;-30;;;
8597;8627;0;1380;VERDADERO;VERDADERO;-30;;;
8597;8627;0;1381;VERDADERO;VERDADERO;-30;;;
8597;8627;0;1382;VERDADERO;VERDADERO;-30;;;
8629;8647;0;1383;VERDADERO;VERDADERO;-18;;;
8629;8647;0;1384;VERDADERO;VERDADERO;-18;;;
8629;8647;0;1385;VERDADERO;VERDADERO;-18;;;
8629;8667;0;1386;VERDADERO;VERDADERO;-38;;;
8629;8667;0;1387;VERDADERO;VERDADERO;-38;;;
8661;8687;1;1388;VERDADERO;VERDADERO;-26;;;
8661;8687;0;1389;VERDADERO;VERDADERO;-26;;;
8661;8687;0;1390;VERDADERO;VERDADERO;-26;;;
8661;8687;0;1391;VERDADERO;VERDADERO;-26;;;
8661;8707;0;1392;VERDADERO;VERDADERO;-46;;;
8693;8707;0;1393;VERDADERO;VERDADERO;-14;;;
8693;8727;0;1394;VERDADERO;VERDADERO;-34;;;
8693;8727;0;1395;VERDADERO;VERDADERO;-34;;;
8693;8727;0;1396;VERDADERO;VERDADERO;-34;;;
8693;8727;0;1397;VERDADERO;VERDADERO;-34;;;
8725;8727;0;1398;VERDADERO;VERDADERO;-2;;;
8725;8747;0;1399;VERDADERO;VERDADERO;-22;;;
8725;8747;0;1400;VERDADERO;VERDADERO;-22;;;
8725;8747;0;1401;VERDADERO;VERDADERO;-22;;;
8725;8767;0;1402;VERDADERO;VERDADERO;-42;;;
8757;8767;0;1403;VERDADERO;VERDADERO;-10;;;
8757;8787;0;1404;VERDADERO;VERDADERO;-30;;;
8757;8787;0;1405;VERDADERO;VERDADERO;-30;;;
8757;8807;0;1406;VERDADERO;FALSO;-50;;;
8757;8807;0;1407;VERDADERO;FALSO;-50;;;
8793;8807;0;1408;VERDADERO;VERDADERO;-14;;;
8793;8827;0;1409;VERDADERO;VERDADERO;-34;;;
8793;8827;0;1410;VERDADERO;VERDADERO;-34;;;
8793;8827;0;1411;VERDADERO;VERDADERO;-34;;;
8793;8827;0;1412;VERDADERO;VERDADERO;-34;;;
8793;8827;0;1413;VERDADERO;VERDADERO;-34;;;
8825;8847;0;1414;VERDADERO;VERDADERO;-22;;;
8825;8847;0;1415;VERDADERO;VERDADERO;-22;;;
8825;8867;0;1416;VERDADERO;VERDADERO;-42;;;
8825;8867;0;1417;VERDADERO;VERDADERO;-42;;;
8857;8867;0;1418;VERDADERO;VERDADERO;-10;;;
8857;8867;0;1419;VERDADERO;VERDADERO;-10;;;
8857;8867;0;1420;VERDADERO;VERDADERO;-10;;;
8857;8867;0;1421;VERDADERO;VERDADERO;-10;;;
8857;8887;0;1422;VERDADERO;VERDADERO;-30;;;
8857;8887;0;1423;VERDADERO;VERDADERO;-30;;;
8857;8907;0;1424;VERDADERO;FALSO;-50;;;
8896;8907;0;1425;VERDADERO;VERDADERO;-11;;;
8896;8907;0;1426;VERDADERO;VERDADERO;-11;;;
8896;8927;0;1427;VERDADERO;VERDADERO;-31;;;
8896;8927;0;1428;VERDADERO;VERDADERO;-31;;;
8925;8927;0;1429;VERDADERO;VERDADERO;-2;;;
8925;8947;0;1430;VERDADERO;VERDADERO;-22;;;
8925;8947;0;1431;VERDADERO;VERDADERO;-22;;;
8925;8947;0;1432;VERDADERO;VERDADERO;-22;;;
8925;8967;1;1433;VERDADERO;VERDADERO;-42;;;
8957;8967;0;1434;VERDADERO;VERDADERO;-10;;;
8957;8987;0;1435;VERDADERO;VERDADERO;-30;;;
8957;8987;0;1436;VERDADERO;VERDADERO;-30;;;
8957;9007;1;1437;VERDADERO;FALSO;-50;;;
8957;9007;0;1438;VERDADERO;FALSO;-50;;;
8957;9007;0;1439;VERDADERO;FALSO;-50;;;
8993;9027;1;1440;VERDADERO;VERDADERO;-34;;;
8993;9027;0;1441;VERDADERO;VERDADERO;-34;;;
8993;9027;0;1442;VERDADERO;VERDADERO;-34;;;
8993;9027;0;1443;VERDADERO;VERDADERO;-34;;;
8993;9027;0;1444;VERDADERO;VERDADERO;-34;;;
8993;9027;0;1445;VERDADERO;VERDADERO;-34;;;
9028;9047;1;1446;VERDADERO;VERDADERO;-19;;;
9028;9047;0;1447;VERDADERO;VERDADERO;-19;;;
9028;9067;0;1448;VERDADERO;VERDADERO;-39;;;
9028;9067;0;1449;VERDADERO;VERDADERO;-39;;;
9028;9067;0;1450;VERDADERO;VERDADERO;-39;;;
9060;9067;0;1451;VERDADERO;VERDADERO;-7;;;
9060;9067;0;1452;VERDADERO;VERDADERO;-7;;;
9060;9087;0;1453;VERDADERO;VERDADERO;-27;;;
9060;9087;0;1454;VERDADERO;VERDADERO;-27;;;
9060;9107;0;1455;VERDADERO;VERDADERO;-47;;;
9093;9107;0;1456;VERDADERO;VERDADERO;-14;;;
9093;9107;0;1457;VERDADERO;VERDADERO;-14;;;
9093;9127;0;1458;VERDADERO;VERDADERO;-34;;;
9093;9127;0;1459;VERDADERO;VERDADERO;-34;;;
9093;9127;0;1460;VERDADERO;VERDADERO;-34;;;
9093;9127;0;1461;VERDADERO;VERDADERO;-34;;;
9129;9147;0;1462;VERDADERO;VERDADERO;-18;;;
9129;9147;0;1463;VERDADERO;VERDADERO;-18;;;
9129;9147;0;1464;VERDADERO;VERDADERO;-18;;;
9129;9167;0;1465;VERDADERO;VERDADERO;-38;;;
9129;9167;0;1466;VERDADERO;VERDADERO;-38;;;
9161;9167;0;1467;VERDADERO;VERDADERO;-6;;;
9161;9167;0;1468;VERDADERO;VERDADERO;-6;;;
9161;9187;0;1469;VERDADERO;VERDADERO;-26;;;
9161;9187;0;1470;VERDADERO;VERDADERO;-26;;;
9161;9207;0;1471;VERDADERO;VERDADERO;-46;;;
9197;9207;0;1472;VERDADERO;VERDADERO;-10;;;
9197;9207;0;1473;VERDADERO;VERDADERO;-10;;;
9197;9227;0;1474;VERDADERO;VERDADERO;-30;;;
9197;9227;0;1475;VERDADERO;VERDADERO;-30;;;
9197;9247;0;1476;VERDADERO;FALSO;-50;;;
9229;9247;0;1477;VERDADERO;VERDADERO;-18;;;
9229;9247;0;1478;VERDADERO;VERDADERO;-18;;;
9229;9267;0;1479;VERDADERO;VERDADERO;-38;;;
9229;9267;0;1480;VERDADERO;VERDADERO;-38;;;
9229;9267;0;1481;VERDADERO;VERDADERO;-38;;;
9229;9267;0;1482;VERDADERO;VERDADERO;-38;;;
9265;9267;0;1483;VERDADERO;VERDADERO;-2;;;
9265;9287;0;1484;VERDADERO;VERDADERO;-22;;;
9265;9287;0;1485;VERDADERO;VERDADERO;-22;;;
9265;9307;0;1486;VERDADERO;VERDADERO;-42;;;
9265;9307;0;1487;VERDADERO;VERDADERO;-42;;;
9297;9307;0;1488;VERDADERO;VERDADERO;-10;;;
9297;9327;0;1489;VERDADERO;VERDADERO;-30;;;
9297;9327;0;1490;VERDADERO;VERDADERO;-30;;;
9297;9347;0;1491;VERDADERO;FALSO;-50;;;
9297;9347;0;1492;VERDADERO;FALSO;-50;;;
9329;9347;0;1493;VERDADERO;VERDADERO;-18;;;
9329;9367;0;1494;VERDADERO;VERDADERO;-38;;;
9329;9367;0;1495;VERDADERO;VERDADERO;-38;;;
9329;9367;0;1496;VERDADERO;VERDADERO;-38;;;
9329;9367;0;1497;VERDADERO;VERDADERO;-38;;;
9329;9387;0;1498;VERDADERO;FALSO;-58;;;
9365;9387;0;1499;VERDADERO;VERDADERO;-22;;;
9365;9387;0;1500;VERDADERO;VERDADERO;-22;;;
9365;9407;0;1501;VERDADERO;VERDADERO;-42;;;
9365;9407;0;1502;VERDADERO;VERDADERO;-42;;;
9365;9407;0;1503;VERDADERO;VERDADERO;-42;;;
9397;9407;0;1504;VERDADERO;VERDADERO;-10;;;
9397;9427;0;1505;VERDADERO;VERDADERO;-30;;;
9397;9427;0;1506;VERDADERO;VERDADERO;-30;;;
9397;9447;0;1507;VERDADERO;FALSO;-50;;;
9397;9447;0;1508;VERDADERO;FALSO;-50;;;
9429;9447;0;1509;VERDADERO;VERDADERO;-18;;;
9429;9447;0;1510;VERDADERO;VERDADERO;-18;;;
9429;9447;0;1511;VERDADERO;VERDADERO;-18;;;
9429;9467;0;1512;VERDADERO;VERDADERO;-38;;;
9429;9467;0;1513;VERDADERO;VERDADERO;-38;;;
9461;9467;0;1514;VERDADERO;VERDADERO;-6;;;
9461;9487;0;1515;VERDADERO;VERDADERO;-26;;;
9461;9487;0;1516;VERDADERO;VERDADERO;-26;;;
9461;9507;0;1517;VERDADERO;VERDADERO;-46;;;
9461;9507;0;1518;VERDADERO;VERDADERO;-46;;;
9493;9507;0;1519;VERDADERO;VERDADERO;-14;;;
9493;9527;0;1520;VERDADERO;VERDADERO;-34;;;
9493;9527;0;1521;VERDADERO;VERDADERO;-34;;;
9493;9547;0;1522;VERDADERO;FALSO;-54;;;
9493;9547;0;1523;VERDADERO;FALSO;-54;;;
9528;9547;0,00E+00;1524;VERDADERO;VERDADERO;-19;;;
9528;9547;0;1525;VERDADERO;VERDADERO;-19;;;
9528;9547;0;1526;VERDADERO;VERDADERO;-19;;;
9528;9567;0;1527;VERDADERO;VERDADERO;-39;;;
9528;9567;0;1528;VERDADERO;VERDADERO;-39;;;
9561;9587;0;1529;VERDADERO;VERDADERO;-26;;;
9561;9587;0;1530;VERDADERO;VERDADERO;-26;;;
9561;9587;0;1531;VERDADERO;VERDADERO;-26;;;
9561;9587;0;1532;VERDADERO;VERDADERO;-26;;;
9561;9587;0;1533;VERDADERO;VERDADERO;-26;;;
9561;9587;0;1534;VERDADERO;VERDADERO;-26;;;
9593;9607;0;1535;VERDADERO;VERDADERO;-14;;;
9593;9607;0;1536;VERDADERO;VERDADERO;-14;;;
9593;9627;0;1537;VERDADERO;VERDADERO;-34;;;
9593;9627;0;1538;VERDADERO;VERDADERO;-34;;;
9593;9627;0;1539;VERDADERO;VERDADERO;-34;;;
9629;9647;0;1540;VERDADERO;VERDADERO;-18;;;
9629;9647;0;1541;VERDADERO;VERDADERO;-18;;;
9629;9647;0;1542;VERDADERO;VERDADERO;-18;;;
9629;9667;0;1543;VERDADERO;VERDADERO;-38;;;
9629;9667;0;1544;VERDADERO;VERDADERO;-38;;;
9657;9667;0;1545;VERDADERO;VERDADERO;-10;;;
9657;9687;0;1546;VERDADERO;VERDADERO;-30;;;
9657;9687;0;1547;VERDADERO;VERDADERO;-30;;;
9657;9687;0;1548;VERDADERO;VERDADERO;-30;;;
9657;9687;0;1549;VERDADERO;VERDADERO;-30;;;
9657;9687;0;1550;VERDADERO;VERDADERO;-30;;;
9693;9707;0;1551;VERDADERO;VERDADERO;-14;;;
9693;9707;0;1552;VERDADERO;VERDADERO;-14;;;
9693;9707;0;1553;VERDADERO;VERDADERO;-14;;;
9693;9727;0;1554;VERDADERO;VERDADERO;-34;;;
9725;9727;0;1555;VERDADERO;VERDADERO;-2;;;
9725;9747;0;1556;VERDADERO;VERDADERO;-22;;;
9725;9747;0;1557;VERDADERO;VERDADERO;-22;;;
9725;9747;0;1558;VERDADERO;VERDADERO;-22;;;
9725;9767;0;1559;VERDADERO;VERDADERO;-42;;;
9725;9767;0;1560;VERDADERO;VERDADERO;-42;;;
9761;9787;0;1561;VERDADERO;VERDADERO;-26;;;
9761;9787;0;1562;VERDADERO;VERDADERO;-26;;;
9761;9787;0;1563;VERDADERO;VERDADERO;-26;;;
9761;9787;0;1564;VERDADERO;VERDADERO;-26;;;
9761;9807;0;1565;VERDADERO;VERDADERO;-46;;;
9793;9807;0;1566;VERDADERO;VERDADERO;-14;;;
9793;9807;0;1567;VERDADERO;VERDADERO;-14;;;
9793;9827;0;1568;VERDADERO;VERDADERO;-34;;;
9793;9827;0;1569;VERDADERO;VERDADERO;-34;;;
9793;9827;0;1570;VERDADERO;VERDADERO;-34;;;
9793;9827;0;1571;VERDADERO;VERDADERO;-34;;;
9829;9827;0;1572;VERDADERO;VERDADERO;2;;;
9829;9847;0;1573;VERDADERO;VERDADERO;-18;;;
9829;9847;0;1574;VERDADERO;VERDADERO;-18;;;
9829;9847;0;1575;VERDADERO;VERDADERO;-18;;;
9829;9867;0;1576;VERDADERO;VERDADERO;-38;;;
9861;9867;0;1577;VERDADERO;VERDADERO;-6;;;
9861;9887;0;1578;VERDADERO;VERDADERO;-26;;;
9861;9887;0;1579;VERDADERO;VERDADERO;-26;;;
9861;9887;0;1580;VERDADERO;VERDADERO;-26;;;
9861;9907;0;1581;VERDADERO;VERDADERO;-46;;;
9893;9907;0;1582;VERDADERO;VERDADERO;-14;;;
9893;9907;0;1583;VERDADERO;VERDADERO;-14;;;
9893;9927;1;1584;VERDADERO;VERDADERO;-34;;;
9893;9927;0;1585;VERDADERO;VERDADERO;-34;;;
9893;9927;0;1586;VERDADERO;VERDADERO;-34;;;
9929;9927;0;1587;VERDADERO;VERDADERO;2;;;
9929;9927;0;1588;VERDADERO;VERDADERO;2;;;
9929;9927;0;1589;VERDADERO;VERDADERO;2;;;
9929;9947;0;1590;VERDADERO;VERDADERO;-18;;;
9929;9947;0;1591;VERDADERO;VERDADERO;-18;;;
9961;9967;0;1592;VERDADERO;VERDADERO;-6;;;
9961;9967;0;1593;VERDADERO;VERDADERO;-6;;;
9961;9967;0;1594;VERDADERO;VERDADERO;-6;;;
9961;9987;0;1595;VERDADERO;VERDADERO;-26;;;
9961;9987;0;1596;VERDADERO;VERDADERO;-26;;;
9992;10007;0;1597;VERDADERO;VERDADERO;-15;;;
9992;10007;0;1598;VERDADERO;VERDADERO;-15;;;
9992;10007;0;1599;VERDADERO;VERDADERO;-15;;;
9992;10027;0;1600;VERDADERO;VERDADERO;-35;;;
9992;10027;0;1601;VERDADERO;VERDADERO;-35;;;
10025;10047;0;1602;VERDADERO;VERDADERO;-22;;;
10025;10047;0;1603;VERDADERO;VERDADERO;-22;;;
10025;10067;1;1604;VERDADERO;VERDADERO;-42;;;
10025;10067;0;1605;VERDADERO;VERDADERO;-42;;;
10025;10067;0;1606;VERDADERO;VERDADERO;-42;;;
10057;10087;0;1607;VERDADERO;VERDADERO;-30;;;
10057;10087;0;1608;VERDADERO;VERDADERO;-30;;;
10057;10087;0;1609;VERDADERO;VERDADERO;-30;;;
10057;10087;0;1610;VERDADERO;VERDADERO;-30;;;
10057;10107;0;1611;VERDADERO;FALSO;-50;;;
10057;10107;0;1612;VERDADERO;FALSO;-50;;;
10093;10107;0;1613;VERDADERO;VERDADERO;-14;;;
10093;10127;0;1614;VERDADERO;VERDADERO;-34;;;
10093;10127;0;1615;VERDADERO;VERDADERO;-34;;;
10093;10127;0;1616;VERDADERO;VERDADERO;-34;;;
10093;10127;0;1617;VERDADERO;VERDADERO;-34;;;
10125;10127;0;1618;VERDADERO;VERDADERO;-2;;;
10125;10147;0;1619;VERDADERO;VERDADERO;-22;;;
10125;10147;0;1620;VERDADERO;VERDADERO;-22;;;
10125;10167;0;1621;VERDADERO;VERDADERO;-42;;;
10125;10167;0;1622;VERDADERO;VERDADERO;-42;;;
10125;10167;0;1623;VERDADERO;VERDADERO;-42;;;
10157;10167;0;1624;VERDADERO;VERDADERO;-10;;;
10157;10187;0;1625;VERDADERO;VERDADERO;-30;;;
10157;10187;0;1626;VERDADERO;VERDADERO;-30;;;
10157;10187;0;1627;VERDADERO;VERDADERO;-30;;;
10157;10207;0;1628;VERDADERO;FALSO;-50;;;
10193;10207;0;1629;VERDADERO;VERDADERO;-14;;;
10193;10227;0;1630;VERDADERO;VERDADERO;-34;;;
10193;10227;0;1631;VERDADERO;VERDADERO;-34;;;
10193;10227;0;1632;VERDADERO;VERDADERO;-34;;;
10193;10227;0;1633;VERDADERO;VERDADERO;-34;;;
10225;10247;0;1634;VERDADERO;VERDADERO;-22;;;
10225;10247;0;1635;VERDADERO;VERDADERO;-22;;;
10225;10247;0;1636;VERDADERO;VERDADERO;-22;;;
10225;10267;0;1637;VERDADERO;VERDADERO;-42;;;
10225;10267;0;1638;VERDADERO;VERDADERO;-42;;;
10225;10267;0;1639;VERDADERO;VERDADERO;-42;;;
10261;10267;0;1640;VERDADERO;VERDADERO;-6;;;
10261;10287;0;1641;VERDADERO;VERDADERO;-26;;;
10261;10287;0;1642;VERDADERO;VERDADERO;-26;;;
10261;10287;0;1643;VERDADERO;VERDADERO;-26;;;
10261;10307;0;1644;VERDADERO;VERDADERO;-46;;;
10261;10307;0;1645;VERDADERO;VERDADERO;-46;;;
10301;10327;1;1646;VERDADERO;VERDADERO;-26;;;
10301;10327;0;1647;VERDADERO;VERDADERO;-26;;;
10301;10327;0;1648;VERDADERO;VERDADERO;-26;;;
10301;10347;0;1649;VERDADERO;VERDADERO;-46;;;
10301;10347;0;1650;VERDADERO;VERDADERO;-46;;;
10329;10367;0;1651;VERDADERO;VERDADERO;-38;;;
10329;10367;0;1652;VERDADERO;VERDADERO;-38;;;
10329;10367;0;1653;VERDADERO;VERDADERO;-38;;;
10329;10367;0;1654;VERDADERO;VERDADERO;-38;;;
10329;10367;0;1655;VERDADERO;VERDADERO;-38;;;
10361;10387;0;1656;VERDADERO;VERDADERO;-26;;;
10361;10387;0;1657;VERDADERO;VERDADERO;-26;;;
10361;10407;0;1658;VERDADERO;VERDADERO;-46;;;
10361;10407;0;1659;VERDADERO;VERDADERO;-46;;;
10361;10407;0;1660;VERDADERO;VERDADERO;-46;;;
10398;10407;0;1661;VERDADERO;VERDADERO;-9;;;
10398;10407;0;1662;VERDADERO;VERDADERO;-9;;;
10398;10407;0;1663;VERDADERO;VERDADERO;-9;;;
10398;10427;0;1664;VERDADERO;VERDADERO;-29;;;
10398;10427;0;1665;VERDADERO;VERDADERO;-29;;;
10398;10427;0;1666;VERDADERO;VERDADERO;-29;;;
10435;10447;0;1667;VERDADERO;VERDADERO;-12;;;
10435;10447;0;1668;VERDADERO;VERDADERO;-12;;;
10435;10447;0;1669;VERDADERO;VERDADERO;-12;;;
10435;10447;0;1670;VERDADERO;VERDADERO;-12;;;
10435;10447;0;1671;VERDADERO;VERDADERO;-12;;;
10465;10467;0;1672;VERDADERO;VERDADERO;-2;;;
10465;10467;0;1673;VERDADERO;VERDADERO;-2;;;
10465;10467;0;1674;VERDADERO;VERDADERO;-2;;;
10465;10487;0;1675;VERDADERO;VERDADERO;-22;;;
10465;10487;0;1676;VERDADERO;VERDADERO;-22;;;
10497;10507;1;1677;VERDADERO;VERDADERO;-10;;;
10497;10507;0;1678;VERDADERO;VERDADERO;-10;;;
10497;10507;0;1679;VERDADERO;VERDADERO;-10;;;
10497;10527;0;1680;VERDADERO;VERDADERO;-30;;;
10497;10527;0;1681;VERDADERO;VERDADERO;-30;;;
10529;10527;0;1682;VERDADERO;VERDADERO;2;;;
10529;10547;1;1683;VERDADERO;VERDADERO;-18;;;
10529;10547;0;1684;VERDADERO;VERDADERO;-18;;;
10529;10567;1;1685;VERDADERO;VERDADERO;-38;;;
10529;10567;0;1686;VERDADERO;VERDADERO;-38;;;
10529;10567;0;1687;VERDADERO;VERDADERO;-38;;;
10566;10587;0;1688;VERDADERO;VERDADERO;-21;;;
10566;10587;0;1689;VERDADERO;VERDADERO;-21;;;
10566;10607;0;1690;VERDADERO;VERDADERO;-41;;;
10566;10607;0;1691;VERDADERO;VERDADERO;-41;;;
10566;10607;0;1692;VERDADERO;VERDADERO;-41;;;
10597;10607;0;1693;VERDADERO;VERDADERO;-10;;;
10597;10627;0;1694;VERDADERO;VERDADERO;-30;;;
10597;10627;0;1695;VERDADERO;VERDADERO;-30;;;
10597;10647;1;1696;VERDADERO;FALSO;-50;;;
10597;10647;0;1697;VERDADERO;FALSO;-50;;;
10629;10647;0;1698;VERDADERO;VERDADERO;-18;;;
10629;10647;0;1699;VERDADERO;VERDADERO;-18;;;
10629;10647;0;1700;VERDADERO;VERDADERO;-18;;;
10629;10647;0;1701;VERDADERO;VERDADERO;-18;;;
10629;10667;0;1702;VERDADERO;VERDADERO;-38;;;
10661;10667;0;1703;VERDADERO;VERDADERO;-6;;;
10661;10667;0;1704;VERDADERO;VERDADERO;-6;;;
10661;10687;0;1705;VERDADERO;VERDADERO;-26;;;
10661;10687;0;1706;VERDADERO;VERDADERO;-26;;;
10661;10707;0;1707;VERDADERO;VERDADERO;-46;;;
10661;10707;0;1708;VERDADERO;VERDADERO;-46;;;
10699;10707;0;1709;VERDADERO;VERDADERO;-8;;;
10699;10727;0;1710;VERDADERO;VERDADERO;-28;;;
10699;10727;0;1711;VERDADERO;VERDADERO;-28;;;
10699;10747;0;1712;VERDADERO;VERDADERO;-48;;;
10699;10747;0;1713;VERDADERO;VERDADERO;-48;;;
10725;10747;0;1714;VERDADERO;VERDADERO;-22;;;
10725;10747;0;1715;VERDADERO;VERDADERO;-22;;;
10725;10747;0;1716;VERDADERO;VERDADERO;-22;;;
10725;10747;0;1717;VERDADERO;VERDADERO;-22;;;
10725;10767;1;1718;VERDADERO;VERDADERO;-42;;;
10725;10767;0;1719;VERDADERO;VERDADERO;-42;;;
10761;10787;1;1720;VERDADERO;VERDADERO;-26;;;
10761;10787;0;1721;VERDADERO;VERDADERO;-26;;;
10761;10787;0;1722;VERDADERO;VERDADERO;-26;;;
10761;10807;0;1723;VERDADERO;VERDADERO;-46;;;
10793;10807;0;1724;VERDADERO;VERDADERO;-14;;;
10793;10827;0;1725;VERDADERO;VERDADERO;-34;;;
10793;10827;0;1726;VERDADERO;VERDADERO;-34;;;
10793;10827;0;1727;VERDADERO;VERDADERO;-34;;;
10793;10847;1;1728;VERDADERO;FALSO;-54;;;
10828;10847;0;1729;VERDADERO;VERDADERO;-19;;;
10828;10847;0;1730;VERDADERO;VERDADERO;-19;;;
10828;10867;0;1731;VERDADERO;VERDADERO;-39;;;
10828;10867;0;1732;VERDADERO;VERDADERO;-39;;;
10828;10867;0;1733;VERDADERO;VERDADERO;-39;;;
10857;10887;0;1734;VERDADERO;VERDADERO;-30;;;
10857;10887;0;1735;VERDADERO;VERDADERO;-30;;;
10857;10887;0;1736;VERDADERO;VERDADERO;-30;;;
10857;10887;0;1737;VERDADERO;VERDADERO;-30;;;
10857;10907;0;1738;VERDADERO;FALSO;-50;;;
10889;10907;0;1739;VERDADERO;VERDADERO;-18;;;
10889;10927;0;1740;VERDADERO;VERDADERO;-38;;;
10889;10927;0;1741;VERDADERO;VERDADERO;-38;;;
10889;10927;0;1742;VERDADERO;VERDADERO;-38;;;
10889;10927;0;1743;VERDADERO;VERDADERO;-38;;;
10921;10927;0;1744;VERDADERO;VERDADERO;-6;;;
10921;10947;0;1745;VERDADERO;VERDADERO;-26;;;
10921;10947;0;1746;VERDADERO;VERDADERO;-26;;;
10921;10947;0;1747;VERDADERO;VERDADERO;-26;;;
10921;10967;0;1748;VERDADERO;VERDADERO;-46;;;
10952;10967;0;1749;VERDADERO;VERDADERO;-15;;;
10952;10987;0;1750;VERDADERO;VERDADERO;-35;;;
10952;10987;0;1751;VERDADERO;VERDADERO;-35;;;
10952;10987;0;1752;VERDADERO;VERDADERO;-35;;;
10952;11007;0;1753;VERDADERO;FALSO;-55;;;
10952;11007;0;1754;VERDADERO;FALSO;-55;;;
10989;11027;1;1755;VERDADERO;VERDADERO;-38;;;
10989;11027;0;1756;VERDADERO;VERDADERO;-38;;;
10989;11027;0;1757;VERDADERO;VERDADERO;-38;;;
10989;11027;0;1758;VERDADERO;VERDADERO;-38;;;
10989;11027;0;1759;VERDADERO;VERDADERO;-38;;;
11021;11027;0;1760;VERDADERO;VERDADERO;-6;;;
11021;11047;0;1761;VERDADERO;VERDADERO;-26;;;
11021;11047;0;1762;VERDADERO;VERDADERO;-26;;;
11021;11067;0;1763;VERDADERO;VERDADERO;-46;;;
11021;11067;0;1764;VERDADERO;VERDADERO;-46;;;
11055;11067;0;1765;VERDADERO;VERDADERO;-12;;;
11055;11067;0;1766;VERDADERO;VERDADERO;-12;;;
11055;11067;0;1767;VERDADERO;VERDADERO;-12;;;
11055;11087;0;1768;VERDADERO;VERDADERO;-32;;;
11055;11087;0;1769;VERDADERO;VERDADERO;-32;;;
11055;11107;1;1770;VERDADERO;FALSO;-52;;;
11089;11107;0;1771;VERDADERO;VERDADERO;-18;;;
11089;11107;0;1772;VERDADERO;VERDADERO;-18;;;
11089;11127;0;1773;VERDADERO;VERDADERO;-38;;;
11089;11127;0;1774;VERDADERO;VERDADERO;-38;;;
11089;11147;0;1775;VERDADERO;FALSO;-58;;;
11121;11147;0;1776;VERDADERO;VERDADERO;-26;;;
11121;11147;0;1777;VERDADERO;VERDADERO;-26;;;
11121;11167;0;1778;VERDADERO;VERDADERO;-46;;;
11121;11167;0;1779;VERDADERO;VERDADERO;-46;;;
11121;11167;0;1780;VERDADERO;VERDADERO;-46;;;
11157;11167;0;1781;VERDADERO;VERDADERO;-10;;;
11157;11167;0;1782;VERDADERO;VERDADERO;-10;;;
11157;11187;1;1783;VERDADERO;VERDADERO;-30;;;
11157;11187;0;1784;VERDADERO;VERDADERO;-30;;;
11157;11207;0;1785;VERDADERO;FALSO;-50;;;
11189;11207;0;1786;VERDADERO;VERDADERO;-18;;;
11189;11207;0,00E+00;1787;VERDADERO;VERDADERO;-18;;;
11189;11207;0;1788;VERDADERO;VERDADERO;-18;;;
11189;11207;0;1789;VERDADERO;VERDADERO;-18;;;
11189;11227;0;1790;VERDADERO;VERDADERO;-38;;;
11189;11227;0;1791;VERDADERO;VERDADERO;-38;;;
11225;11227;0;1792;VERDADERO;VERDADERO;-2;;;
11225;11247;0;1793;VERDADERO;VERDADERO;-22;;;
11225;11247;0;1794;VERDADERO;VERDADERO;-22;;;
11225;11267;1;1795;VERDADERO;VERDADERO;-42;;;
11225;11267;0;1796;VERDADERO;VERDADERO;-42;;;
11258;11287;0;1797;VERDADERO;VERDADERO;-29;;;
11258;11287;0;1798;VERDADERO;VERDADERO;-29;;;
11258;11287;0;1799;VERDADERO;VERDADERO;-29;;;
11258;11307;0;1800;VERDADERO;VERDADERO;-49;;;
11258;11307;0;1801;VERDADERO;VERDADERO;-49;;;
11289;11307;0;1802;VERDADERO;VERDADERO;-18;;;
11289;11307;0;1803;VERDADERO;VERDADERO;-18;;;
11289;11307;0;1804;VERDADERO;VERDADERO;-18;;;
11289;11327;0;1805;VERDADERO;VERDADERO;-38;;;
11289;11327;0;1806;VERDADERO;VERDADERO;-38;;;
11289;11347;0;1807;VERDADERO;FALSO;-58;;;
11325;11347;0;1808;VERDADERO;VERDADERO;-22;;;
11325;11347;0;1809;VERDADERO;VERDADERO;-22;;;
11325;11347;0;1810;VERDADERO;VERDADERO;-22;;;
11325;11347;0;1811;VERDADERO;VERDADERO;-22;;;
11325;11367;0;1812;VERDADERO;VERDADERO;-42;;;
11357;11367;0;1813;VERDADERO;VERDADERO;-10;;;
11357;11387;0;1814;VERDADERO;VERDADERO;-30;;;
11357;11387;0;1815;VERDADERO;VERDADERO;-30;;;
11357;11387;0;1816;VERDADERO;VERDADERO;-30;;;
11357;11407;0;1817;VERDADERO;FALSO;-50;;;
11393;11407;0;1818;VERDADERO;VERDADERO;-14;;;
11393;11427;1;1819;VERDADERO;VERDADERO;-34;;;
11393;11427;0;1820;VERDADERO;VERDADERO;-34;;;
11393;11427;0;1821;VERDADERO;VERDADERO;-34;;;
11393;11447;1;1822;VERDADERO;FALSO;-54;;;
11393;11447;0;1823;VERDADERO;FALSO;-54;;;
11425;11447;0;1824;VERDADERO;VERDADERO;-22;;;
11425;11447;0;1825;VERDADERO;VERDADERO;-22;;;
11425;11467;0;1826;VERDADERO;VERDADERO;-42;;;
11425;11467;0;1827;VERDADERO;VERDADERO;-42;;;
11425;11487;0;1828;VERDADERO;FALSO;-62;;;
11461;11487;0;1829;VERDADERO;VERDADERO;-26;;;
11461;11487;0;1830;VERDADERO;VERDADERO;-26;;;
11461;11487;0;1831;VERDADERO;VERDADERO;-26;;;
11461;11487;0;1832;VERDADERO;VERDADERO;-26;;;
11461;11487;0;1833;VERDADERO;VERDADERO;-26;;;
11493;11507;0;1834;VERDADERO;VERDADERO;-14;;;
11493;11507;0;1835;VERDADERO;VERDADERO;-14;;;
11493;11527;0;1836;VERDADERO;VERDADERO;-34;;;
11493;11527;0;1837;VERDADERO;VERDADERO;-34;;;
11493;11527;0;1838;VERDADERO;VERDADERO;-34;;;
11493;11547;0;1839;VERDADERO;FALSO;-54;;;
11529;11547;0;1840;VERDADERO;VERDADERO;-18;;;
11529;11547;0;1841;VERDADERO;VERDADERO;-18;;;
11529;11567;0;1842;VERDADERO;VERDADERO;-38;;;
11529;11567;0;1843;VERDADERO;VERDADERO;-38;;;
11529;11587;0;1844;VERDADERO;FALSO;-58;;;
11562;11587;0;1845;VERDADERO;VERDADERO;-25;;;
11562;11587;0;1846;VERDADERO;VERDADERO;-25;;;
11562;11587;0;1847;VERDADERO;VERDADERO;-25;;;
11562;11587;0;1848;VERDADERO;VERDADERO;-25;;;
11562;11587;0;1849;VERDADERO;VERDADERO;-25;;;
11562;11607;0;1850;VERDADERO;VERDADERO;-45;;;
11597;11607;0;1851;VERDADERO;VERDADERO;-10;;;
11597;11627;0;1852;VERDADERO;VERDADERO;-30;;;
11597;11627;0;1853;VERDADERO;VERDADERO;-30;;;
11597;11627;0;1854;VERDADERO;VERDADERO;-30;;;
11597;11627;0;1855;VERDADERO;VERDADERO;-30;;;
11629;11627;0;1856;VERDADERO;VERDADERO;2;;;
11629;11647;0;1857;VERDADERO;VERDADERO;-18;;;
11629;11647;0;1858;VERDADERO;VERDADERO;-18;;;
11629;11667;0;1859;VERDADERO;VERDADERO;-38;;;
11629;11667;0;1860;VERDADERO;VERDADERO;-38;;;
11661;11667;0;1861;VERDADERO;VERDADERO;-6;;;
11661;11687;0;1862;VERDADERO;VERDADERO;-26;;;
11661;11687;0;1863;VERDADERO;VERDADERO;-26;;;
11661;11707;0;1864;VERDADERO;VERDADERO;-46;;;
11661;11707;0;1865;VERDADERO;VERDADERO;-46;;;
11661;11707;0;1866;VERDADERO;VERDADERO;-46;;;
11697;11727;0;1867;VERDADERO;VERDADERO;-30;;;
11697;11727;0;1868;VERDADERO;VERDADERO;-30;;;
11697;11727;0;1869;VERDADERO;VERDADERO;-30;;;
11697;11727;0;1870;VERDADERO;VERDADERO;-30;;;
11725;11727;0;1871;VERDADERO;VERDADERO;-2;;;
11725;11747;0;1872;VERDADERO;VERDADERO;-22;;;
11725;11747;0;1873;VERDADERO;VERDADERO;-22;;;
11725;11767;0;1874;VERDADERO;VERDADERO;-42;;;
11725;11767;0;1875;VERDADERO;VERDADERO;-42;;;
11725;11767;0;1876;VERDADERO;VERDADERO;-42;;;
11761;11767;0;1877;VERDADERO;VERDADERO;-6;;;
11761;11767;0;1878;VERDADERO;VERDADERO;-6;;;
11761;11787;0;1879;VERDADERO;VERDADERO;-26;;;
11761;11787;0;1880;VERDADERO;VERDADERO;-26;;;
11761;11807;1;1881;VERDADERO;VERDADERO;-46;;;
11794;11807;0;1882;VERDADERO;VERDADERO;-13;;;
11794;11807;0;1883;VERDADERO;VERDADERO;-13;;;
11794;11827;0;1884;VERDADERO;VERDADERO;-33;;;
11794;11827;0;1885;VERDADERO;VERDADERO;-33;;;
11794;11847;0;1886;VERDADERO;FALSO;-53;;;
11794;11847;0;1887;VERDADERO;FALSO;-53;;;
11829;11847;0;1888;VERDADERO;VERDADERO;-18;;;
11829;11867;0;1889;VERDADERO;VERDADERO;-38;;;
11829;11867;0;1890;VERDADERO;VERDADERO;-38;;;
11829;11867;0;1891;VERDADERO;VERDADERO;-38;;;
11857;11867;0;1892;VERDADERO;VERDADERO;-10;;;
11857;11867;0;1893;VERDADERO;VERDADERO;-10;;;
11857;11887;0;1894;VERDADERO;VERDADERO;-30;;;
11857;11887;0;1895;VERDADERO;VERDADERO;-30;;;
11857;11887;0;1896;VERDADERO;VERDADERO;-30;;;
11857;11907;0;1897;VERDADERO;FALSO;-50;;;
11890;11907;0;1898;VERDADERO;VERDADERO;-17;;;
11890;11907;0;1899;VERDADERO;VERDADERO;-17;;;
11890;11907;0;1900;VERDADERO;VERDADERO;-17;;;
11890;11927;0;1901;VERDADERO;VERDADERO;-37;;;
11921;11927;0;1902;VERDADERO;VERDADERO;-6;;;
11921;11927;0;1903;VERDADERO;VERDADERO;-6;;;
11921;11947;0;1904;VERDADERO;VERDADERO;-26;;;
11921;11947;0;1905;VERDADERO;VERDADERO;-26;;;
11921;11967;0;1906;VERDADERO;VERDADERO;-46;;;
11953;11967;0;1907;VERDADERO;VERDADERO;-14;;;
11953;11967;0;1908;VERDADERO;VERDADERO;-14;;;
11953;11987;0;1909;VERDADERO;VERDADERO;-34;;;
11953;11987;0;1910;VERDADERO;VERDADERO;-34;;;
11953;12007;0;1911;VERDADERO;FALSO;-54;;;
11953;12007;0;1912;VERDADERO;FALSO;-54;;;
11989;12007;0;1913;VERDADERO;VERDADERO;-18;;;
11989;12007;0;1914;VERDADERO;VERDADERO;-18;;;
11989;12027;0;1915;VERDADERO;VERDADERO;-38;;;
11989;12027;0;1916;VERDADERO;VERDADERO;-38;;;
11989;12027;0;1917;VERDADERO;VERDADERO;-38;;;
12021;12047;0;1918;VERDADERO;VERDADERO;-26;;;
12021;12047;0;1919;VERDADERO;VERDADERO;-26;;;
12021;12047;0;1920;VERDADERO;VERDADERO;-26;;;
12021;12047;0;1921;VERDADERO;VERDADERO;-26;;;
12021;12047;0;1922;VERDADERO;VERDADERO;-26;;;
12055;12067;0;1923;VERDADERO;VERDADERO;-12;;;
12055;12067;0;1924;VERDADERO;VERDADERO;-12;;;
12055;12087;0;1925;VERDADERO;VERDADERO;-32;;;
12055;12087;0;1926;VERDADERO;VERDADERO;-32;;;
12055;12087;0;1927;VERDADERO;VERDADERO;-32;;;
12055;12107;0;1928;VERDADERO;FALSO;-52;;;
12089;12107;0;1929;VERDADERO;VERDADERO;-18;;;
12089;12107;0;1930;VERDADERO;VERDADERO;-18;;;
12089;12107;0;1931;VERDADERO;VERDADERO;-18;;;
12089;12127;0;1932;VERDADERO;VERDADERO;-38;;;
12089;12127;0;1933;VERDADERO;VERDADERO;-38;;;
12121;12147;0;1934;VERDADERO;VERDADERO;-26;;;
12121;12147;0;1935;VERDADERO;VERDADERO;-26;;;
12121;12147;0;1936;VERDADERO;VERDADERO;-26;;;
12121;12147;0;1937;VERDADERO;VERDADERO;-26;;;
12121;12147;0;1938;VERDADERO;VERDADERO;-26;;;
12121;12167;0;1939;VERDADERO;VERDADERO;-46;;;
12157;12167;0;1940;VERDADERO;VERDADERO;-10;;;
12157;12167;0;1941;VERDADERO;VERDADERO;-10;;;
12157;12187;1;1942;VERDADERO;VERDADERO;-30;;;
12157;12187;0;1943;VERDADERO;VERDADERO;-30;;;
12157;12207;1;1944;VERDADERO;FALSO;-50;;;
12189;12207;0;1945;VERDADERO;VERDADERO;-18;;;
12189;12207;0;1946;VERDADERO;VERDADERO;-18;;;
12189;12207;0;1947;VERDADERO;VERDADERO;-18;;;
12189;12227;0;1948;VERDADERO;VERDADERO;-38;;;
12189;12227;0;1949;VERDADERO;VERDADERO;-38;;;
12225;12247;0;1950;VERDADERO;VERDADERO;-22;;;
12225;12247;0;1951;VERDADERO;VERDADERO;-22;;;
12225;12247;0;1952;VERDADERO;VERDADERO;-22;;;
12225;12247;0;1953;VERDADERO;VERDADERO;-22;;;
12225;12247;0;1954;VERDADERO;VERDADERO;-22;;;
12257;12247;0;1955;VERDADERO;VERDADERO;10;;;
12257;12267;1;1956;VERDADERO;VERDADERO;-10;;;
12257;12267;0;1957;VERDADERO;VERDADERO;-10;;;
12257;12287;0;1958;VERDADERO;VERDADERO;-30;;;
12257;12287;0;1959;VERDADERO;VERDADERO;-30;;;
12289;12287;0;1960;VERDADERO;VERDADERO;2;;;
12289;12307;0;1961;VERDADERO;VERDADERO;-18;;;
12289;12307;0;1962;VERDADERO;VERDADERO;-18;;;
12289;12307;0;1963;VERDADERO;VERDADERO;-18;;;
12289;12327;0;1964;VERDADERO;VERDADERO;-38;;;
12289;12327;0;1965;VERDADERO;VERDADERO;-38;;;
12325;12347;0;1966;VERDADERO;VERDADERO;-22;;;
12325;12347;0;1967;VERDADERO;VERDADERO;-22;;;
12325;12347;0;1968;VERDADERO;VERDADERO;-22;;;
12325;12347;0;1969;VERDADERO;VERDADERO;-22;;;
12325;12347;0;1970;VERDADERO;VERDADERO;-22;;;
12357;12347;0;1971;VERDADERO;VERDADERO;10;;;
12357;12367;0;1972;VERDADERO;VERDADERO;-10;;;
12357;12367;0;1973;VERDADERO;VERDADERO;-10;;;
12357;12387;0;1974;VERDADERO;VERDADERO;-30;;;
12357;12387;0;1975;VERDADERO;VERDADERO;-30;;;
12357;12387;0;1976;VERDADERO;VERDADERO;-30;;;
12393;12407;0;1977;VERDADERO;VERDADERO;-14;;;
12393;12407;0;1978;VERDADERO;VERDADERO;-14;;;
12393;12407;0;1979;VERDADERO;VERDADERO;-14;;;
12393;12427;0;1980;VERDADERO;VERDADERO;-34;;;
12393;12427;0;1981;VERDADERO;VERDADERO;-34;;;
12425;12447;0;1982;VERDADERO;VERDADERO;-22;;;
12425;12447;0;1983;VERDADERO;VERDADERO;-22;;;
12425;12447;0;1984;VERDADERO;VERDADERO;-22;;;
12425;12467;0;1985;VERDADERO;VERDADERO;-42;;;
12425;12467;0;1986;VERDADERO;VERDADERO;-42;;;
12457;12487;0;1987;VERDADERO;VERDADERO;-30;;;
12457;12487;0;1988;VERDADERO;VERDADERO;-30;;;
12457;12487;0;1989;VERDADERO;VERDADERO;-30;;;
12457;12507;0;1990;VERDADERO;FALSO;-50;;;
12457;12507;0;1991;VERDADERO;FALSO;-50;;;
12489;12507;0;1992;VERDADERO;VERDADERO;-18;;;
12489;12507;0;1993;VERDADERO;VERDADERO;-18;;;
12489;12507;0;1994;VERDADERO;VERDADERO;-18;;;
12489;12507;0;1995;VERDADERO;VERDADERO;-18;;;
12489;12527;0;1996;VERDADERO;VERDADERO;-38;;;
12521;12527;0;1997;VERDADERO;VERDADERO;-6;;;
12521;12547;0;1998;VERDADERO;VERDADERO;-26;;;
12521;12547;0;1999;VERDADERO;VERDADERO;-26;;;
12521;12547;0;2000;VERDADERO;VERDADERO;-26;;;
12521;12547;0;2001;VERDADERO;VERDADERO;-26;;;
12521;12547;0;2002;VERDADERO;VERDADERO;-26;;;
12557;12547;0;2003;VERDADERO;VERDADERO;10;;;
12557;12547;0;2004;VERDADERO;VERDADERO;10;;;
12557;12567;1;2005;VERDADERO;VERDADERO;-10;;;
12557;12567;0;2006;VERDADERO;VERDADERO;-10;;;
12557;12587;0;2007;VERDADERO;VERDADERO;-30;;;
12589;12587;0;2008;VERDADERO;VERDADERO;2;;;
12589;12607;0;2009;VERDADERO;VERDADERO;-18;;;
12589;12607;0;2010;VERDADERO;VERDADERO;-18;;;
12589;12607;0;2011;VERDADERO;VERDADERO;-18;;;
12589;12627;1;2012;VERDADERO;VERDADERO;-38;;;
12621;12627;0;2013;VERDADERO;VERDADERO;-6;;;
12621;12647;0;2014;VERDADERO;VERDADERO;-26;;;
12621;12647;0;2015;VERDADERO;VERDADERO;-26;;;
12621;12647;0;2016;VERDADERO;VERDADERO;-26;;;
12621;12667;0;2017;VERDADERO;VERDADERO;-46;;;
12657;12667;0;2018;VERDADERO;VERDADERO;-10;;;
12657;12687;0;2019;VERDADERO;VERDADERO;-30;;;
12657;12687;0;2020;VERDADERO;VERDADERO;-30;;;
12657;12687;0;2021;VERDADERO;VERDADERO;-30;;;
12657;12707;0;2022;VERDADERO;FALSO;-50;;;
12689;12707;0;2023;VERDADERO;VERDADERO;-18;;;
12689;12707;0;2024;VERDADERO;VERDADERO;-18;;;
12689;12707;0;2025;VERDADERO;VERDADERO;-18;;;
12689;12727;0;2026;VERDADERO;VERDADERO;-38;;;
12689;12727;0;2027;VERDADERO;VERDADERO;-38;;;
12689;12747;0;2028;VERDADERO;FALSO;-58;;;
12725;12747;0;2029;VERDADERO;VERDADERO;-22;;;
12725;12747;0;2030;VERDADERO;VERDADERO;-22;;;
12725;12747;0;2031;VERDADERO;VERDADERO;-22;;;
12725;12747;0;2032;VERDADERO;VERDADERO;-22;;;
12725;12747;0;2033;VERDADERO;VERDADERO;-22;;;
12725;12767;0;2034;VERDADERO;VERDADERO;-42;;;
12757;12767;0;2035;VERDADERO;VERDADERO;-10;;;
12757;12787;0;2036;VERDADERO;VERDADERO;-30;;;
12757;12787;0;2037;VERDADERO;VERDADERO;-30;;;
12757;12787;0;2038;VERDADERO;VERDADERO;-30;;;
12757;12807;0;2039;VERDADERO;FALSO;-50;;;
12793;12807;0;2040;VERDADERO;VERDADERO;-14;;;
12793;12827;0;2041;VERDADERO;VERDADERO;-34;;;
12793;12827;0;2042;VERDADERO;VERDADERO;-34;;;
12793;12827;0;2043;VERDADERO;VERDADERO;-34;;;
12793;12847;0;2044;VERDADERO;FALSO;-54;;;
12825;12847;0;2045;VERDADERO;VERDADERO;-22;;;
12825;12847;0;2046;VERDADERO;VERDADERO;-22;;;
12825;12847;0;2047;VERDADERO;VERDADERO;-22;;;
12825;12847;0;2048;VERDADERO;VERDADERO;-22;;;
12825;12867;0;2049;VERDADERO;VERDADERO;-42;;;
12857;12867;0;2050;VERDADERO;VERDADERO;-10;;;
12857;12887;0;2051;VERDADERO;VERDADERO;-30;;;
12857;12887;0;2052;VERDADERO;VERDADERO;-30;;;
12857;12887;0;2053;VERDADERO;VERDADERO;-30;;;
12857;12887;0;2054;VERDADERO;VERDADERO;-30;;;
12889;12887;0;2055;VERDADERO;VERDADERO;2;;;
12889;12887;0;2056;VERDADERO;VERDADERO;2;;;
12889;12887;0;2057;VERDADERO;VERDADERO;2;;;
12889;12907;0;2058;VERDADERO;VERDADERO;-18;;;
12889;12907;0;2059;VERDADERO;VERDADERO;-18;;;
12921;12907;0;2060;VERDADERO;VERDADERO;14;;;
12921;12928;1;2061;VERDADERO;VERDADERO;-7;;;
12921;12928;0;2062;VERDADERO;VERDADERO;-7;;;
12921;12948;0;2063;VERDADERO;VERDADERO;-27;;;
12921;12948;0;2064;VERDADERO;VERDADERO;-27;;;
12953;12948;0;2065;VERDADERO;VERDADERO;5;;;
12953;12968;1;2066;VERDADERO;VERDADERO;-15;;;
12953;12968;0;2067;VERDADERO;VERDADERO;-15;;;
12953;12988;0;2068;VERDADERO;VERDADERO;-35;;;
12953;12988;0;2069;VERDADERO;VERDADERO;-35;;;
12985;12988;0;2070;VERDADERO;VERDADERO;-3;;;
12985;13008;0;2071;VERDADERO;VERDADERO;-23;;;
12985;13008;0;2072;VERDADERO;VERDADERO;-23;;;
12985;13028;0;2073;VERDADERO;VERDADERO;-43;;;
12985;13028;0;2074;VERDADERO;VERDADERO;-43;;;
12985;13028;0;2075;VERDADERO;VERDADERO;-43;;;
13021;13048;0;2076;VERDADERO;VERDADERO;-27;;;
13021;13048;0;2077;VERDADERO;VERDADERO;-27;;;
13021;13048;0;2078;VERDADERO;VERDADERO;-27;;;
13021;13048;0;2079;VERDADERO;VERDADERO;-27;;;
13021;13068;1;2080;VERDADERO;VERDADERO;-47;;;
13053;13068;0;2081;VERDADERO;VERDADERO;-15;;;
13053;13068;0;2082;VERDADERO;VERDADERO;-15;;;
13053;13088;0;2083;VERDADERO;VERDADERO;-35;;;
13053;13088;0;2084;VERDADERO;VERDADERO;-35;;;
13053;13088;0;2085;VERDADERO;VERDADERO;-35;;;
13085;13088;0;2086;VERDADERO;VERDADERO;-3;;;
13085;13108;0;2087;VERDADERO;VERDADERO;-23;;;
13085;13108;0;2088;VERDADERO;VERDADERO;-23;;;
13085;13108;0;2089;VERDADERO;VERDADERO;-23;;;
13085;13128;1;2090;VERDADERO;VERDADERO;-43;;;
13085;13128;0;2091;VERDADERO;VERDADERO;-43;;;
13085;13148;1;2092;VERDADERO;FALSO;-63;;;
13126;13148;0;2093;VERDADERO;VERDADERO;-22;;;
13126;13148;0;2094;VERDADERO;VERDADERO;-22;;;
13126;13168;0;2095;VERDADERO;VERDADERO;-42;;;
13126;13168;0;2096;VERDADERO;VERDADERO;-42;;;
13154;13188;0;2097;VERDADERO;VERDADERO;-34;;;
13154;13188;0;2098;VERDADERO;VERDADERO;-34;;;
13154;13188;0;2099;VERDADERO;VERDADERO;-34;;;
13154;13188;0;2100;VERDADERO;VERDADERO;-34;;;
13154;13188;0;2101;VERDADERO;VERDADERO;-34;;;
13185;13188;0;2102;VERDADERO;VERDADERO;-3;;;
13185;13208;0;2103;VERDADERO;VERDADERO;-23;;;
13185;13208;0;2104;VERDADERO;VERDADERO;-23;;;
13185;13208;0;2105;VERDADERO;VERDADERO;-23;;;
13185;13228;0;2106;VERDADERO;VERDADERO;-43;;;
13185;13228;0;2107;VERDADERO;VERDADERO;-43;;;
13221;13248;0;2108;VERDADERO;VERDADERO;-27;;;
13221;13248;0;2109;VERDADERO;VERDADERO;-27;;;
13221;13248;0;2110;VERDADERO;VERDADERO;-27;;;
13221;13268;0;2111;VERDADERO;VERDADERO;-47;;;
13221;13268;0;2112;VERDADERO;VERDADERO;-47;;;
13221;13288;0;2113;VERDADERO;FALSO;-67;;;
13257;13288;0;2114;VERDADERO;VERDADERO;-31;;;
13257;13288;0;2115;VERDADERO;VERDADERO;-31;;;
13257;13288;0;2116;VERDADERO;VERDADERO;-31;;;
13257;13288;0;2117;VERDADERO;VERDADERO;-31;;;
13257;13288;0;2118;VERDADERO;VERDADERO;-31;;;
13289;13308;0;2119;VERDADERO;VERDADERO;-19;;;
13289;13308;0;2120;VERDADERO;VERDADERO;-19;;;
13289;13328;0;2121;VERDADERO;VERDADERO;-39;;;
13289;13328;0;2122;VERDADERO;VERDADERO;-39;;;
13289;13328;0;2123;VERDADERO;VERDADERO;-39;;;
13321;13328;0;2124;VERDADERO;VERDADERO;-7;;;
13321;13328;0;2125;VERDADERO;VERDADERO;-7;;;
13321;13348;0;2126;VERDADERO;VERDADERO;-27;;;
13321;13348;0;2127;VERDADERO;VERDADERO;-27;;;
13321;13369;0;2128;VERDADERO;VERDADERO;-48;;;
13357;13369;0;2129;VERDADERO;VERDADERO;-12;;;
13357;13389;0;2130;VERDADERO;VERDADERO;-32;;;
13357;13389;0;2131;VERDADERO;VERDADERO;-32;;;
13357;13389;0;2132;VERDADERO;VERDADERO;-32;;;
13357;13409;0;2133;VERDADERO;FALSO;-52;;;
13389;13409;0;2134;VERDADERO;VERDADERO;-20;;;
13389;13409;0;2135;VERDADERO;VERDADERO;-20;;;
13389;13429;0;2136;VERDADERO;VERDADERO;-40;;;
13389;13429;0;2137;VERDADERO;VERDADERO;-40;;;
13389;13429;0;2138;VERDADERO;VERDADERO;-40;;;
13389;13429;0;2139;VERDADERO;VERDADERO;-40;;;
13425;13429;0;2140;VERDADERO;VERDADERO;-4;;;
13425;13449;0;2141;VERDADERO;VERDADERO;-24;;;
13425;13449;0;2142;VERDADERO;VERDADERO;-24;;;
13425;13449;0;2143;VERDADERO;VERDADERO;-24;;;
13425;13469;0;2144;VERDADERO;VERDADERO;-44;;;
13457;13469;0;2145;VERDADERO;VERDADERO;-12;;;
13457;13469;0;2146;VERDADERO;VERDADERO;-12;;;
13457;13469;0;2147;VERDADERO;VERDADERO;-12;;;
13457;13489;1;2148;VERDADERO;VERDADERO;-32;;;
13457;13489;0;2149;VERDADERO;VERDADERO;-32;;;
13457;13489;0;2150;VERDADERO;VERDADERO;-32;;;
13493;13510;0;2151;VERDADERO;VERDADERO;-17;;;
13493;13510;0;2152;VERDADERO;VERDADERO;-17;;;
13493;13530;0;2153;VERDADERO;VERDADERO;-37;;;
13493;13530;0;2154;VERDADERO;VERDADERO;-37;;;
13493;13530;0;2155;VERDADERO;VERDADERO;-37;;;
13525;13550;0;2156;VERDADERO;VERDADERO;-25;;;
13525;13550;0;2157;VERDADERO;VERDADERO;-25;;;
13525;13570;1;2158;VERDADERO;VERDADERO;-45;;;
13525;13570;0;2159;VERDADERO;VERDADERO;-45;;;
13525;13570;0;2160;VERDADERO;VERDADERO;-45;;;
13557;13570;0;2161;VERDADERO;VERDADERO;-13;;;
13557;13570;0;2162;VERDADERO;VERDADERO;-13;;;
13557;13590;0;2163;VERDADERO;VERDADERO;-33;;;
13557;13590;0;2164;VERDADERO;VERDADERO;-33;;;
13557;13590;0;2165;VERDADERO;VERDADERO;-33;;;
13557;13610;0;2166;VERDADERO;FALSO;-53;;;
13593;13610;0;2167;VERDADERO;VERDADERO;-17;;;
13593;13610;0;2168;VERDADERO;VERDADERO;-17;;;
13593;13610;0;2169;VERDADERO;VERDADERO;-17;;;
13593;13610;0;2170;VERDADERO;VERDADERO;-17;;;
13593;13630;0;2171;VERDADERO;VERDADERO;-37;;;
13625;13630;0;2172;VERDADERO;VERDADERO;-5;;;
13625;13650;0;2173;VERDADERO;VERDADERO;-25;;;
13625;13650;0;2174;VERDADERO;VERDADERO;-25;;;
13625;13650;0;2175;VERDADERO;VERDADERO;-25;;;
13625;13670;0;2176;VERDADERO;VERDADERO;-45;;;
13657;13670;0;2177;VERDADERO;VERDADERO;-13;;;
13657;13690;0;2178;VERDADERO;VERDADERO;-33;;;
13657;13690;0;2179;VERDADERO;VERDADERO;-33;;;
13657;13690;0;2180;VERDADERO;VERDADERO;-33;;;
13657;13710;0;2181;VERDADERO;FALSO;-53;;;
13657;13710;0;2182;VERDADERO;FALSO;-53;;;
13693;13710;0;2183;VERDADERO;VERDADERO;-17;;;
13693;13710;0;2184;VERDADERO;VERDADERO;-17;;;
13693;13730;0;2185;VERDADERO;VERDADERO;-37;;;
13693;13730;0;2186;VERDADERO;VERDADERO;-37;;;
13693;13730;0;2187;VERDADERO;VERDADERO;-37;;;
13725;13750;0;2188;VERDADERO;VERDADERO;-25;;;
13725;13750;0;2189;VERDADERO;VERDADERO;-25;;;
13725;13750;0;2190;VERDADERO;VERDADERO;-25;;;
13725;13750;0;2191;VERDADERO;VERDADERO;-25;;;
13725;13770;0;2192;VERDADERO;VERDADERO;-45;;;
13757;13770;0;2193;VERDADERO;VERDADERO;-13;;;
13757;13770;0;2194;VERDADERO;VERDADERO;-13;;;
13757;13790;0;2195;VERDADERO;VERDADERO;-33;;;
13757;13790;0;2196;VERDADERO;VERDADERO;-33;;;
13757;13810;0;2197;VERDADERO;FALSO;-53;;;
13792;13810;0;2198;VERDADERO;VERDADERO;-18;;;
13792;13810;0;2199;VERDADERO;VERDADERO;-18;;;
13792;13830;0;2200;VERDADERO;VERDADERO;-38;;;
13792;13830;0;2201;VERDADERO;VERDADERO;-38;;;
13792;13850;1;2202;VERDADERO;FALSO;-58;;;
13792;13850;0;2203;VERDADERO;FALSO;-58;;;
13825;13850;0;2204;VERDADERO;VERDADERO;-25;;;
13825;13850;0;2205;VERDADERO;VERDADERO;-25;;;
13825;13850;0;2206;VERDADERO;VERDADERO;-25;;;
13825;13870;0;2207;VERDADERO;VERDADERO;-45;;;
13825;13870;0;2208;VERDADERO;VERDADERO;-45;;;
13857;13890;1;2209;VERDADERO;VERDADERO;-33;;;
13857;13890;0;2210;VERDADERO;VERDADERO;-33;;;
13857;13890;0;2211;VERDADERO;VERDADERO;-33;;;
13857;13890;0;2212;VERDADERO;VERDADERO;-33;;;
13857;13890;0;2213;VERDADERO;VERDADERO;-33;;;
13893;13890;0;2214;VERDADERO;VERDADERO;3;;;
13893;13910;0;2215;VERDADERO;VERDADERO;-17;;;
13893;13910;0;2216;VERDADERO;VERDADERO;-17;;;
13893;13930;0;2217;VERDADERO;VERDADERO;-37;;;
13893;13930;0;2218;VERDADERO;VERDADERO;-37;;;
13925;13930;0;2219;VERDADERO;VERDADERO;-5;;;
13925;13950;0;2220;VERDADERO;VERDADERO;-25;;;
13925;13950;0;2221;VERDADERO;VERDADERO;-25;;;
13925;13970;0;2222;VERDADERO;VERDADERO;-45;;;
13925;13970;0;2223;VERDADERO;VERDADERO;-45;;;
13957;13970;0;2224;VERDADERO;VERDADERO;-13;;;
13957;13990;0;2225;VERDADERO;VERDADERO;-33;;;
13957;13990;0;2226;VERDADERO;VERDADERO;-33;;;
13957;13990;0;2227;VERDADERO;VERDADERO;-33;;;
13957;13990;0;2228;VERDADERO;VERDADERO;-33;;;
13957;13990;0;2229;VERDADERO;VERDADERO;-33;;;
13989;13990;0;2230;VERDADERO;VERDADERO;-1;;;
13989;14010;1;2231;VERDADERO;VERDADERO;-21;;;
13989;14010;0;2232;VERDADERO;VERDADERO;-21;;;
13989;14030;0;2233;VERDADERO;VERDADERO;-41;;;
13989;14030;0;2234;VERDADERO;VERDADERO;-41;;;
14021;14030;0;2235;VERDADERO;VERDADERO;-9;;;
14021;14030;0;2236;VERDADERO;VERDADERO;-9;;;
14021;14030;0;2237;VERDADERO;VERDADERO;-9;;;
14021;14050;0;2238;VERDADERO;VERDADERO;-29;;;
14021;14050;0;2239;VERDADERO;VERDADERO;-29;;;
14057;14050;0;2240;VERDADERO;VERDADERO;7;;;
14057;14071;0;2241;VERDADERO;VERDADERO;-14;;;
14057;14071;0;2242;VERDADERO;VERDADERO;-14;;;
14057;14091;0;2243;VERDADERO;VERDADERO;-34;;;
14057;14091;0;2244;VERDADERO;VERDADERO;-34;;;
14089;14111;1;2245;VERDADERO;VERDADERO;-22;;;
14089;14111;0;2246;VERDADERO;VERDADERO;-22;;;
14089;14111;0;2247;VERDADERO;VERDADERO;-22;;;
14089;14131;0;2248;VERDADERO;VERDADERO;-42;;;
14089;14131;0;2249;VERDADERO;VERDADERO;-42;;;
14089;14131;0;2250;VERDADERO;VERDADERO;-42;;;
14125;14131;0;2251;VERDADERO;VERDADERO;-6;;;
14125;14151;0;2252;VERDADERO;VERDADERO;-26;;;
14125;14151;0;2253;VERDADERO;VERDADERO;-26;;;
14125;14151;0;2254;VERDADERO;VERDADERO;-26;;;
14125;14171;0;2255;VERDADERO;VERDADERO;-46;;;
14157;14171;0;2256;VERDADERO;VERDADERO;-14;;;
14157;14191;0;2257;VERDADERO;VERDADERO;-34;;;
14157;14191;0;2258;VERDADERO;VERDADERO;-34;;;
14157;14191;0;2259;VERDADERO;VERDADERO;-34;;;
14157;14211;0;2260;VERDADERO;FALSO;-54;;;
14189;14211;0;2261;VERDADERO;VERDADERO;-22;;;
14189;14231;0;2262;VERDADERO;VERDADERO;-42;;;
14189;14231;0;2263;VERDADERO;VERDADERO;-42;;;
14189;14231;0;2264;VERDADERO;VERDADERO;-42;;;
14189;14231;0;2265;VERDADERO;VERDADERO;-42;;;
14189;14251;0;2266;VERDADERO;FALSO;-62;;;
14225;14251;0;2267;VERDADERO;VERDADERO;-26;;;
14225;14271;0;2268;VERDADERO;VERDADERO;-46;;;
14225;14271;0;2269;VERDADERO;VERDADERO;-46;;;
14225;14271;0;2270;VERDADERO;VERDADERO;-46;;;
14225;14271;0;2271;VERDADERO;VERDADERO;-46;;;
14257;14271;0;2272;VERDADERO;VERDADERO;-14;;;
14257;14291;0;2273;VERDADERO;VERDADERO;-34;;;
14257;14291;0;2274;VERDADERO;VERDADERO;-34;;;
14257;14311;0;2275;VERDADERO;FALSO;-54;;;
14257;14311;0;2276;VERDADERO;FALSO;-54;;;
14289;14311;0;2277;VERDADERO;VERDADERO;-22;;;
14289;14311;0;2278;VERDADERO;VERDADERO;-22;;;
14289;14311;0;2279;VERDADERO;VERDADERO;-22;;;
14289;14311;0;2280;VERDADERO;VERDADERO;-22;;;
14289;14311;0;2281;VERDADERO;VERDADERO;-22;;;
14325;14331;0;2282;VERDADERO;VERDADERO;-6;;;
14325;14331;0;2283;VERDADERO;VERDADERO;-6;;;
14325;14351;0;2284;VERDADERO;VERDADERO;-26;;;
14325;14351;0;2285;VERDADERO;VERDADERO;-26;;;
14325;14351;0;2286;VERDADERO;VERDADERO;-26;;;
14357;14371;0;2287;VERDADERO;VERDADERO;-14;;;
14357;14371;0;2288;VERDADERO;VERDADERO;-14;;;
14357;14371;0;2289;VERDADERO;VERDADERO;-14;;;
14357;14391;0;2290;VERDADERO;VERDADERO;-34;;;
14357;14391;0;2291;VERDADERO;VERDADERO;-34;;;
14389;14411;0;2292;VERDADERO;VERDADERO;-22;;;
14389;14411;0;2293;VERDADERO;VERDADERO;-22;;;
14389;14411;0;2294;VERDADERO;VERDADERO;-22;;;
14389;14411;0;2295;VERDADERO;VERDADERO;-22;;;
14389;14411;0;2296;VERDADERO;VERDADERO;-22;;;
14389;14411;0;2297;VERDADERO;VERDADERO;-22;;;
14425;14411;0;2298;VERDADERO;VERDADERO;14;;;
14425;14411;0;2299;VERDADERO;VERDADERO;14;;;
14425;14411;0,00E+00;2300;VERDADERO;VERDADERO;14;;;
14425;14431;0;2301;VERDADERO;VERDADERO;-6;;;
14425;14431;0;2302;VERDADERO;VERDADERO;-6;;;
14457;14451;0;2303;VERDADERO;VERDADERO;6;;;
14457;14451;0;2304;VERDADERO;VERDADERO;6;;;
14457;14471;0;2305;VERDADERO;VERDADERO;-14;;;
14457;14471;0;2306;VERDADERO;VERDADERO;-14;;;
14457;14471;0;2307;VERDADERO;VERDADERO;-14;;;
14489;14491;0;2308;VERDADERO;VERDADERO;-2;;;
14489;14491;0;2309;VERDADERO;VERDADERO;-2;;;
14489;14511;0;2310;VERDADERO;VERDADERO;-22;;;
14489;14511;0;2311;VERDADERO;VERDADERO;-22;;;
14489;14511;0;2312;VERDADERO;VERDADERO;-22;;;
14489;14531;0;2313;VERDADERO;VERDADERO;-42;;;
14524;14531;0;2314;VERDADERO;VERDADERO;-7;;;
14524;14551;0;2315;VERDADERO;VERDADERO;-27;;;
14524;14551;0;2316;VERDADERO;VERDADERO;-27;;;
14524;14551;0;2317;VERDADERO;VERDADERO;-27;;;
14524;14571;0;2318;VERDADERO;VERDADERO;-47;;;
14557;14571;0;2319;VERDADERO;VERDADERO;-14;;;
14557;14591;0;2320;VERDADERO;VERDADERO;-34;;;
14557;14591;0;2321;VERDADERO;VERDADERO;-34;;;
14557;14591;0;2322;VERDADERO;VERDADERO;-34;;;
14557;14611;0;2323;VERDADERO;FALSO;-54;;;
14589;14611;0;2324;VERDADERO;VERDADERO;-22;;;
14589;14631;0;2325;VERDADERO;VERDADERO;-42;;;
14589;14631;0;2326;VERDADERO;VERDADERO;-42;;;
14589;14631;0;2327;VERDADERO;VERDADERO;-42;;;
14589;14631;0;2328;VERDADERO;VERDADERO;-42;;;
14621;14631;0;2329;VERDADERO;VERDADERO;-10;;;
14621;14651;0;2330;VERDADERO;VERDADERO;-30;;;
14621;14651;0;2331;VERDADERO;VERDADERO;-30;;;
14621;14651;0;2332;VERDADERO;VERDADERO;-30;;;
14621;14671;0;2333;VERDADERO;FALSO;-50;;;
14653;14671;0;2334;VERDADERO;VERDADERO;-18;;;
14653;14671;0;2335;VERDADERO;VERDADERO;-18;;;
14653;14671;0;2336;VERDADERO;VERDADERO;-18;;;
14653;14691;0;2337;VERDADERO;VERDADERO;-38;;;
14653;14691;0;2338;VERDADERO;VERDADERO;-38;;;
14653;14691;0;2339;VERDADERO;VERDADERO;-38;;;
14689;14711;0;2340;VERDADERO;VERDADERO;-22;;;
14689;14711;0;2341;VERDADERO;VERDADERO;-22;;;
14689;14731;0;2342;VERDADERO;VERDADERO;-42;;;
14689;14731;0;2343;VERDADERO;VERDADERO;-42;;;
14689;14731;0;2344;VERDADERO;VERDADERO;-42;;;
14721;14751;0;2345;VERDADERO;VERDADERO;-30;;;
14721;14751;0;2346;VERDADERO;VERDADERO;-30;;;
14721;14751;0;2347;VERDADERO;VERDADERO;-30;;;
14721;14771;0;2348;VERDADERO;FALSO;-50;;;
14721;14771;0;2349;VERDADERO;FALSO;-50;;;
14752;14771;0;2350;VERDADERO;VERDADERO;-19;;;
14752;14771;0;2351;VERDADERO;VERDADERO;-19;;;
14752;14791;1;2352;VERDADERO;VERDADERO;-39;;;
14752;14791;0;2353;VERDADERO;VERDADERO;-39;;;
14752;14811;0;2354;VERDADERO;FALSO;-59;;;
14786;14811;0;2355;VERDADERO;VERDADERO;-25;;;
14786;14811;0;2356;VERDADERO;VERDADERO;-25;;;
14786;14811;0;2357;VERDADERO;VERDADERO;-25;;;
14786;14811;0;2358;VERDADERO;VERDADERO;-25;;;
14786;14811;0;2359;VERDADERO;VERDADERO;-25;;;
14817;14831;0;2360;VERDADERO;VERDADERO;-14;;;
14817;14831;0;2361;VERDADERO;VERDADERO;-14;;;
14817;14831;0;2362;VERDADERO;VERDADERO;-14;;;
14817;14851;0;2363;VERDADERO;VERDADERO;-34;;;
14817;14851;0;2364;VERDADERO;VERDADERO;-34;;;
14817;14871;0;2365;VERDADERO;FALSO;-54;;;
14853;14871;0;2366;VERDADERO;VERDADERO;-18;;;
14853;14871;0;2367;VERDADERO;VERDADERO;-18;;;
14853;14891;0;2368;VERDADERO;VERDADERO;-38;;;
14853;14891;0;2369;VERDADERO;VERDADERO;-38;;;
14853;14911;0;2370;VERDADERO;FALSO;-58;;;
14885;14911;0;2371;VERDADERO;VERDADERO;-26;;;
14885;14911;0;2372;VERDADERO;VERDADERO;-26;;;
14885;14911;0;2373;VERDADERO;VERDADERO;-26;;;
14885;14931;0;2374;VERDADERO;VERDADERO;-46;;;
14885;14931;0;2375;VERDADERO;VERDADERO;-46;;;
14921;14951;1;2376;VERDADERO;VERDADERO;-30;;;
14921;14951;0;2377;VERDADERO;VERDADERO;-30;;;
14921;14951;0;2378;VERDADERO;VERDADERO;-30;;;
14921;14951;0;2379;VERDADERO;VERDADERO;-30;;;
14921;14951;0;2380;VERDADERO;VERDADERO;-30;;;
14953;14951;0;2381;VERDADERO;VERDADERO;2;;;
14953;14971;0;2382;VERDADERO;VERDADERO;-18;;;
14953;14971;0;2383;VERDADERO;VERDADERO;-18;;;
14953;14991;0;2384;VERDADERO;VERDADERO;-38;;;
14953;14991;0;2385;VERDADERO;VERDADERO;-38;;;
14953;15011;0;2386;VERDADERO;FALSO;-58;;;
14989;15011;0;2387;VERDADERO;VERDADERO;-22;;;
14989;15011;0;2388;VERDADERO;VERDADERO;-22;;;
14989;15031;0;2389;VERDADERO;VERDADERO;-42;;;
14989;15031;0;2390;VERDADERO;VERDADERO;-42;;;
14989;15051;1;2391;VERDADERO;FALSO;-62;;;
15021;15051;0;2392;VERDADERO;VERDADERO;-30;;;
15021;15051;0;2393;VERDADERO;VERDADERO;-30;;;
15021;15051;0;2394;VERDADERO;VERDADERO;-30;;;
15021;15051;0;2395;VERDADERO;VERDADERO;-30;;;
15021;15051;0;2396;VERDADERO;VERDADERO;-30;;;
15053;15051;0;2397;VERDADERO;VERDADERO;2;;;
15053;15071;1;2398;VERDADERO;VERDADERO;-18;;;
15053;15071;0;2399;VERDADERO;VERDADERO;-18;;;
15053;15091;0;2400;VERDADERO;VERDADERO;-38;;;
15053;15091;0;2401;VERDADERO;VERDADERO;-38;;;
15053;15091;0;2402;VERDADERO;VERDADERO;-38;;;
15089;15091;0;2403;VERDADERO;VERDADERO;-2;;;
15089;15091;0;2404;VERDADERO;VERDADERO;-2;;;
15089;15111;0;2405;VERDADERO;VERDADERO;-22;;;
15089;15111;0;2406;VERDADERO;VERDADERO;-22;;;
15089;15111;0;2407;VERDADERO;VERDADERO;-22;;;
15121;15131;0;2408;VERDADERO;VERDADERO;-10;;;
15121;15131;0;2409;VERDADERO;VERDADERO;-10;;;
15121;15151;0;2410;VERDADERO;VERDADERO;-30;;;
15121;15151;0;2411;VERDADERO;VERDADERO;-30;;;
15121;15151;0;2412;VERDADERO;VERDADERO;-30;;;
15153;15171;0;2413;VERDADERO;VERDADERO;-18;;;
15153;15171;0;2414;VERDADERO;VERDADERO;-18;;;
15153;15171;0;2415;VERDADERO;VERDADERO;-18;;;
15153;15191;0;2416;VERDADERO;VERDADERO;-38;;;
15153;15191;0;2417;VERDADERO;VERDADERO;-38;;;
15185;15191;0;2418;VERDADERO;VERDADERO;-6;;;
15185;15191;0;2419;VERDADERO;VERDADERO;-6;;;
15185;15211;0;2420;VERDADERO;VERDADERO;-26;;;
15185;15211;0;2421;VERDADERO;VERDADERO;-26;;;
15185;15231;0;2422;VERDADERO;VERDADERO;-46;;;
15218;15231;0;2423;VERDADERO;VERDADERO;-13;;;
15218;15231;0;2424;VERDADERO;VERDADERO;-13;;;
15218;15251;0;2425;VERDADERO;VERDADERO;-33;;;
15218;15251;0;2426;VERDADERO;VERDADERO;-33;;;
15218;15271;0;2427;VERDADERO;FALSO;-53;;;
15218;15271;0;2428;VERDADERO;FALSO;-53;;;
15253;15271;0;2429;VERDADERO;VERDADERO;-18;;;
15253;15291;0;2430;VERDADERO;VERDADERO;-38;;;
15253;15291;0;2431;VERDADERO;VERDADERO;-38;;;
15253;15291;0;2432;VERDADERO;VERDADERO;-38;;;
15253;15291;0;2433;VERDADERO;VERDADERO;-38;;;
15285;15311;0;2434;VERDADERO;VERDADERO;-26;;;
15285;15311;0;2435;VERDADERO;VERDADERO;-26;;;
15285;15311;0;2436;VERDADERO;VERDADERO;-26;;;
15285;15331;0;2437;VERDADERO;VERDADERO;-46;;;
15285;15331;0;2438;VERDADERO;VERDADERO;-46;;;
15317;15331;0;2439;VERDADERO;VERDADERO;-14;;;
15317;15331;0;2440;VERDADERO;VERDADERO;-14;;;
15317;15331;0;2441;VERDADERO;VERDADERO;-14;;;
15317;15351;0;2442;VERDADERO;VERDADERO;-34;;;
15317;15351;0;2443;VERDADERO;VERDADERO;-34;;;
15317;15371;0;2444;VERDADERO;FALSO;-54;;;
15353;15371;0;2445;VERDADERO;VERDADERO;-18;;;
15353;15371;0;2446;VERDADERO;VERDADERO;-18;;;
15353;15371;0;2447;VERDADERO;VERDADERO;-18;;;
15353;15371;0;2448;VERDADERO;VERDADERO;-18;;;
15353;15391;0;2449;VERDADERO;VERDADERO;-38;;;
15385;15391;0;2450;VERDADERO;VERDADERO;-6;;;
15385;15391;0;2451;VERDADERO;VERDADERO;-6;;;
15385;15412;0;2452;VERDADERO;VERDADERO;-27;;;
15385;15412;0;2453;VERDADERO;VERDADERO;-27;;;
15385;15432;1;2454;VERDADERO;VERDADERO;-47;;;
15385;15432;0;2455;VERDADERO;VERDADERO;-47;;;
15421;15432;0;2456;VERDADERO;VERDADERO;-11;;;
15421;15432;0;2457;VERDADERO;VERDADERO;-11;;;
15421;15452;0;2458;VERDADERO;VERDADERO;-31;;;
15421;15452;0;2459;VERDADERO;VERDADERO;-31;;;
15421;15472;0;2460;VERDADERO;FALSO;-51;;;
15454;15472;0;2461;VERDADERO;VERDADERO;-18;;;
15454;15472;0;2462;VERDADERO;VERDADERO;-18;;;
15454;15472;0;2463;VERDADERO;VERDADERO;-18;;;
15454;15472;0;2464;VERDADERO;VERDADERO;-18;;;
15454;15472;0;2465;VERDADERO;VERDADERO;-18;;;
15454;15472;0;2466;VERDADERO;VERDADERO;-18;;;
15489;15492;0;2467;VERDADERO;VERDADERO;-3;;;
15489;15492;0;2468;VERDADERO;VERDADERO;-3;;;
15489;15492;0;2469;VERDADERO;VERDADERO;-3;;;
15489;15512;0;2470;VERDADERO;VERDADERO;-23;;;
15489;15512;0;2471;VERDADERO;VERDADERO;-23;;;
15521;15532;0;2472;VERDADERO;VERDADERO;-11;;;
15521;15532;0;2473;VERDADERO;VERDADERO;-11;;;
15521;15532;0;2474;VERDADERO;VERDADERO;-11;;;
15521;15552;1;2475;VERDADERO;VERDADERO;-31;;;
15521;15552;0;2476;VERDADERO;VERDADERO;-31;;;
15558;15572;0;2477;VERDADERO;VERDADERO;-14;;;
15558;15572;0;2478;VERDADERO;VERDADERO;-14;;;
15558;15592;0;2479;VERDADERO;VERDADERO;-34;;;
15558;15592;0;2480;VERDADERO;VERDADERO;-34;;;
15558;15592;0;2481;VERDADERO;VERDADERO;-34;;;
15558;15592;0;2482;VERDADERO;VERDADERO;-34;;;
15591;15592;0;2483;VERDADERO;VERDADERO;-1;;;
15591;15592;0;2484;VERDADERO;VERDADERO;-1;;;
15591;15592;0;2485;VERDADERO;VERDADERO;-1;;;
15591;15592;0;2486;VERDADERO;VERDADERO;-1;;;
15591;15592;0;2487;VERDADERO;VERDADERO;-1;;;
15624;15592;0;2488;VERDADERO;VERDADERO;32;;;
15624;15592;0;2489;VERDADERO;VERDADERO;32;;;
15624;15592;0;2490;VERDADERO;VERDADERO;32;;;
15624;15592;0;2491;VERDADERO;VERDADERO;32;;;
15624;15592;0;2492;VERDADERO;VERDADERO;32;;;
15624;15592;0;2493;VERDADERO;VERDADERO;32;;;
15657;15592;0;2494;FALSO;VERDADERO;65;;;
15657;15592;0;2495;FALSO;VERDADERO;65;;;
15657;15592;0;2496;FALSO;VERDADERO;65;;;
15657;15592;0;2497;FALSO;VERDADERO;65;;;
15657;15592;0;2498;FALSO;VERDADERO;65;;;
15689;15592;0;2499;FALSO;VERDADERO;97;;;
15689;15592;0;2500;FALSO;VERDADERO;97;;;
15689;15592;0;2501;FALSO;VERDADERO;97;;;
15689;15592;0;2502;FALSO;VERDADERO;97;;;
15689;15592;0;2503;FALSO;VERDADERO;97;;;
15689;15592;0;2504;FALSO;VERDADERO;97;;;
15722;15592;0;2505;FALSO;VERDADERO;130;;;
15722;15592;0;2506;FALSO;VERDADERO;130;;;
15722;15592;0;2507;FALSO;VERDADERO;130;;;
15722;15592;0;2508;FALSO;VERDADERO;130;;;
15722;15592;0;2509;FALSO;VERDADERO;130;;;
15722;15592;0;2510;FALSO;VERDADERO;130;;;
15757;15592;0;2511;FALSO;VERDADERO;165;;;
15757;15592;0;2512;FALSO;VERDADERO;165;;;
15757;15592;0;2513;FALSO;VERDADERO;165;;;
15757;15592;0;2514;FALSO;VERDADERO;165;;;
15757;15592;0;2515;FALSO;VERDADERO;165;;;
15789;15592;0;2516;FALSO;VERDADERO;197;;;
15789;15592;0;2517;FALSO;VERDADERO;197;;;
15789;15592;0;2518;FALSO;VERDADERO;197;;;
15789;15592;0;2519;FALSO;VERDADERO;197;;;
15789;15592;0;2520;FALSO;VERDADERO;197;;;
15821;15592;0;2521;FALSO;VERDADERO;229;;;
15821;15592;0;2522;FALSO;VERDADERO;229;;;
15821;15592;0;2523;FALSO;VERDADERO;229;;;
15821;15592;0;2524;FALSO;VERDADERO;229;;;
15821;15592;0;2525;FALSO;VERDADERO;229;;;
15821;15592;0;2526;FALSO;VERDADERO;229;;;
15821;15592;0;2527;FALSO;VERDADERO;229;;;
15860;15592;0;2528;FALSO;VERDADERO;268;;;
15860;15592;0;2529;FALSO;VERDADERO;268;;;
15860;15592;0;2530;FALSO;VERDADERO;268;;;
15860;15592;0;2531;FALSO;VERDADERO;268;;;
15887;15592;0;2532;FALSO;VERDADERO;295;;;
15887;15592;0;2533;FALSO;VERDADERO;295;;;
15887;15592;0;2534;FALSO;VERDADERO;295;;;
15887;15592;0;2535;FALSO;VERDADERO;295;;;
15887;15592;0;2536;FALSO;VERDADERO;295;;;
15887;15592;0;2537;FALSO;VERDADERO;295;;;
15921;15592;0;2538;FALSO;VERDADERO;329;;;
15921;15592;0;2539;FALSO;VERDADERO;329;;;
15921;15592;0;2540;FALSO;VERDADERO;329;;;
15921;15592;0;2541;FALSO;VERDADERO;329;;;
15921;15592;0;2542;FALSO;VERDADERO;329;;;
15953;15592;0;2543;FALSO;VERDADERO;361;;;
15953;15592;0;2544;FALSO;VERDADERO;361;;;
15953;15592;0;2545;FALSO;VERDADERO;361;;;
15953;15592;0;2546;FALSO;VERDADERO;361;;;
15953;15592;0;2547;FALSO;VERDADERO;361;;;
15985;15592;0;2548;FALSO;VERDADERO;393;;;
15985;15592;0;2549;FALSO;VERDADERO;393;;;
15985;15592;0;2550;FALSO;VERDADERO;393;;;
15985;15592;0;2551;FALSO;VERDADERO;393;;;
15985;15592;0;2552;FALSO;VERDADERO;393;;;
15985;15592;0;2553;FALSO;VERDADERO;393;;;
15985;15592;0;2554;FALSO;VERDADERO;393;;;
16023;15592;0;2555;FALSO;VERDADERO;431;;;
16023;15592;0;2556;FALSO;VERDADERO;431;;;
16023;15592;0;2557;FALSO;VERDADERO;431;;;
16023;15592;0;2558;FALSO;VERDADERO;431;;;
16049;15592;0;2559;FALSO;VERDADERO;457;;;
16049;15592;0;2560;FALSO;VERDADERO;457;;;
16049;15592;0;2561;FALSO;VERDADERO;457;;;
16049;15592;0;2562;FALSO;VERDADERO;457;;;
16049;15592;0;2563;FALSO;VERDADERO;457;;;
16049;15592;0;2564;FALSO;VERDADERO;457;;;
16085;15592;0;2565;FALSO;VERDADERO;493;;;
16085;15592;0;2566;FALSO;VERDADERO;493;;;
16085;15592;0;2567;FALSO;VERDADERO;493;;;
16085;15592;0;2568;FALSO;VERDADERO;493;;;
16085;15592;0;2569;FALSO;VERDADERO;493;;;
16117;15592;0;2570;FALSO;VERDADERO;525;;;
16117;15592;0;2571;FALSO;VERDADERO;525;;;
16117;15592;0;2572;FALSO;VERDADERO;525;;;
16117;15592;0;2573;FALSO;VERDADERO;525;;;
16117;15592;0;2574;FALSO;VERDADERO;525;;;
16117;15592;0;2575;FALSO;VERDADERO;525;;;
16153;15592;0;2576;FALSO;VERDADERO;561;;;
16153;15592;0;2577;FALSO;VERDADERO;561;;;
16153;15592;0;2578;FALSO;VERDADERO;561;;;
16153;15592;0;2579;FALSO;VERDADERO;561;;;
16153;15592;0;2580;FALSO;VERDADERO;561;;;
16185;15592;0;2581;FALSO;VERDADERO;593;;;
16185;15592;0;2582;FALSO;VERDADERO;593;;;
16185;15592;0;2583;FALSO;VERDADERO;593;;;
16185;15592;0;2584;FALSO;VERDADERO;593;;;
16185;15592;0;2585;FALSO;VERDADERO;593;;;
16185;15592;0;2586;FALSO;VERDADERO;593;;;
16221;15592;0;2587;FALSO;VERDADERO;629;;;
16221;15592;0;2588;FALSO;VERDADERO;629;;;
16221;15592;0;2589;FALSO;VERDADERO;629;;;
16221;15592;0;2590;FALSO;VERDADERO;629;;;
16221;15592;0;2591;FALSO;VERDADERO;629;;;
16221;15592;0;2592;FALSO;VERDADERO;629;;;
16253;15592;0;2593;FALSO;VERDADERO;661;;;
16253;15592;0;2594;FALSO;VERDADERO;661;;;
16253;15592;0;2595;FALSO;VERDADERO;661;;;
16253;15592;0;2596;FALSO;VERDADERO;661;;;
16253;15592;0;2597;FALSO;VERDADERO;661;;;
16285;15592;0;2598;FALSO;VERDADERO;693;;;
16285;15592;0;2599;FALSO;VERDADERO;693;;;
16285;15592;0;2600;FALSO;VERDADERO;693;;;
16285;15592;0;2601;FALSO;VERDADERO;693;;;
16285;15592;0;2602;FALSO;VERDADERO;693;;;
16285;15592;0;2603;FALSO;VERDADERO;693;;;
16321;15592;0;2604;FALSO;VERDADERO;729;;;
16321;15592;0;2605;FALSO;VERDADERO;729;;;
16321;15592;0;2606;FALSO;VERDADERO;729;;;
16321;15592;0;2607;FALSO;VERDADERO;729;;;
16321;15592;0;2608;FALSO;VERDADERO;729;;;
16353;15592;0;2609;FALSO;VERDADERO;761;;;
16353;15592;0;2610;FALSO;VERDADERO;761;;;
16353;15592;0;2611;FALSO;VERDADERO;761;;;
16353;15592;0;2612;FALSO;VERDADERO;761;;;
16353;15592;0;2613;FALSO;VERDADERO;761;;;
16385;15592;0;2614;FALSO;VERDADERO;793;;;
16385;15592;0;2615;FALSO;VERDADERO;793;;;
16385;15592;0;2616;FALSO;VERDADERO;793;;;
16385;15592;0;2617;FALSO;VERDADERO;793;;;
16385;15592;0;2618;FALSO;VERDADERO;793;;;
16385;15592;0;2619;FALSO;VERDADERO;793;;;
16417;15592;0;2620;FALSO;VERDADERO;825;;;
16417;15592;0;2621;FALSO;VERDADERO;825;;;
16417;15592;0;2622;FALSO;VERDADERO;825;;;
16417;15592;0;2623;FALSO;VERDADERO;825;;;
16417;15592;0;2624;FALSO;VERDADERO;825;;;
16449;15592;0;2625;FALSO;VERDADERO;857;;;
16449;15592;0;2626;FALSO;VERDADERO;857;;;
16449;15592;0;2627;FALSO;VERDADERO;857;;;
16449;15592;0;2628;FALSO;VERDADERO;857;;;
16449;15592;0;2629;FALSO;VERDADERO;857;;;
16449;15592;0;2630;FALSO;VERDADERO;857;;;
16485;15592;0;2631;FALSO;VERDADERO;893;;;
16485;15592;0;2632;FALSO;VERDADERO;893;;;
16485;15592;0;2633;FALSO;VERDADERO;893;;;
16485;15592;0;2634;FALSO;VERDADERO;893;;;
16485;15592;0;2635;FALSO;VERDADERO;893;;;
16517;15592;0;2636;FALSO;VERDADERO;925;;;
16517;15592;0;2637;FALSO;VERDADERO;925;;;
16517;15592;0;2638;FALSO;VERDADERO;925;;;
16517;15592;0;2639;FALSO;VERDADERO;925;;;
16517;15592;0;2640;FALSO;VERDADERO;925;;;
16549;15592;0;2641;FALSO;VERDADERO;957;;;
16549;15592;0;2642;FALSO;VERDADERO;957;;;
16549;15592;0;2643;FALSO;VERDADERO;957;;;
16549;15592;0;2644;FALSO;VERDADERO;957;;;
16549;15592;0;2645;FALSO;VERDADERO;957;;;
16549;15592;0;2646;FALSO;VERDADERO;957;;;
16585;15592;0;2647;FALSO;VERDADERO;993;;;
16585;15592;0;2648;FALSO;VERDADERO;993;;;
16585;15592;0;2649;FALSO;VERDADERO;993;;;
16585;15592;0;2650;FALSO;VERDADERO;993;;;
16585;15592;0;2651;FALSO;VERDADERO;993;;;
16585;15592;0;2652;FALSO;VERDADERO;993;;;
16617;15592;0;2653;FALSO;VERDADERO;1025;;;
16617;15592;0;2654;FALSO;VERDADERO;1025;;;
16617;15592;0;2655;FALSO;VERDADERO;1025;;;
16617;15592;0;2656;FALSO;VERDADERO;1025;;;
16617;15592;0;2657;FALSO;VERDADERO;1025;;;
16617;15592;0;2658;FALSO;VERDADERO;1025;;;
16653;15592;0;2659;FALSO;VERDADERO;1061;;;
16653;15592;0;2660;FALSO;VERDADERO;1061;;;
16653;15592;0;2661;FALSO;VERDADERO;1061;;;
16653;15592;0;2662;FALSO;VERDADERO;1061;;;
16653;15592;0;2663;FALSO;VERDADERO;1061;;;
16653;15592;0;2664;FALSO;VERDADERO;1061;;;
16689;15592;0;2665;FALSO;VERDADERO;1097;;;
16689;15592;0;2666;FALSO;VERDADERO;1097;;;
16689;15592;0;2667;FALSO;VERDADERO;1097;;;
16689;15592;0;2668;FALSO;VERDADERO;1097;;;
16689;15592;0;2669;FALSO;VERDADERO;1097;;;
16721;15592;0;2670;FALSO;VERDADERO;1129;;;
16721;15592;0;2671;FALSO;VERDADERO;1129;;;
16721;15592;0;2672;FALSO;VERDADERO;1129;;;
16721;15592;0;2673;FALSO;VERDADERO;1129;;;
16721;15592;0;2674;FALSO;VERDADERO;1129;;;
16753;15592;0;2675;FALSO;VERDADERO;1161;;;
16753;15592;0;2676;FALSO;VERDADERO;1161;;;
16753;15592;0;2677;FALSO;VERDADERO;1161;;;
16753;15592;0;2678;FALSO;VERDADERO;1161;;;
16753;15592;0;2679;FALSO;VERDADERO;1161;;;
16753;15592;0;2680;FALSO;VERDADERO;1161;;;
16789;15592;0;2681;FALSO;VERDADERO;1197;;;
16789;15592;0;2682;FALSO;VERDADERO;1197;;;
16789;15592;0;2683;FALSO;VERDADERO;1197;;;
16789;15612;0;2684;FALSO;VERDADERO;1177;;;
16789;15612;0;2685;FALSO;VERDADERO;1177;;;
16789;15612;0;2686;FALSO;VERDADERO;1177;;;
16823;15632;0;2687;FALSO;VERDADERO;1191;;;
16823;15632;0;2688;FALSO;VERDADERO;1191;;;
16823;15652;0;2689;FALSO;VERDADERO;1171;;;
16823;15652;0;2690;FALSO;VERDADERO;1171;;;
16823;15652;0;2691;FALSO;VERDADERO;1171;;;
16857;15672;0;2692;FALSO;VERDADERO;1185;;;
16857;15672;0;2693;FALSO;VERDADERO;1185;;;
16857;15692;0;2694;FALSO;VERDADERO;1165;;;
16857;15692;0;2695;FALSO;VERDADERO;1165;;;
16857;15712;0;2696;FALSO;VERDADERO;1145;;;
16889;15712;0;2697;FALSO;VERDADERO;1177;;;
16889;15712;0;2698;FALSO;VERDADERO;1177;;;
16889;15732;0;2699;FALSO;VERDADERO;1157;;;
16889;15732;0;2700;FALSO;VERDADERO;1157;;;
16889;15752;0;2701;FALSO;VERDADERO;1137;;;
16921;15752;0;2702;FALSO;VERDADERO;1169;;;
16921;15752;0;2703;FALSO;VERDADERO;1169;;;
16921;15772;1;2704;FALSO;VERDADERO;1149;;;
16921;15772;0;2705;FALSO;VERDADERO;1149;;;
16921;15792;0;2706;FALSO;VERDADERO;1129;;;
16954;15792;0;2707;FALSO;VERDADERO;1162;;;
16954;15792;0;2708;FALSO;VERDADERO;1162;;;
16954;15812;1;2709;FALSO;VERDADERO;1142;;;
16954;15812;0;2710;FALSO;VERDADERO;1142;;;
16954;15832;0;2711;FALSO;VERDADERO;1122;;;
16985;15832;0;2712;FALSO;VERDADERO;1153;;;
16985;15852;0;2713;FALSO;VERDADERO;1133;;;
16985;15852;0;2714;FALSO;VERDADERO;1133;;;
16985;15852;0;2715;FALSO;VERDADERO;1133;;;
16985;15872;0;2716;FALSO;VERDADERO;1113;;;
17021;15872;0;2717;FALSO;VERDADERO;1149;;;
17021;15892;1;2718;FALSO;VERDADERO;1129;;;
17021;15892;0;2719;FALSO;VERDADERO;1129;;;
17021;15892;0;2720;FALSO;VERDADERO;1129;;;
17021;15912;0;2721;FALSO;VERDADERO;1109;;;
17053;15912;0;2722;FALSO;VERDADERO;1141;;;
17053;15932;0;2723;FALSO;VERDADERO;1121;;;
17053;15932;0;2724;FALSO;VERDADERO;1121;;;
17053;15932;0;2725;FALSO;VERDADERO;1121;;;
17053;15952;1;2726;FALSO;VERDADERO;1101;;;
17053;15952;0;2727;FALSO;VERDADERO;1101;;;
17087;15972;0;2728;FALSO;VERDADERO;1115;;;
17087;15972;0;2729;FALSO;VERDADERO;1115;;;
17087;15972;0;2730;FALSO;VERDADERO;1115;;;
17087;15992;0;2731;FALSO;VERDADERO;1095;;;
17117;15992;0;2732;FALSO;VERDADERO;1125;;;
17117;16012;1;2733;FALSO;VERDADERO;1105;;;
17117;16012;0;2734;FALSO;VERDADERO;1105;;;
17117;16012;0;2735;FALSO;VERDADERO;1105;;;
17117;16032;0;2736;FALSO;VERDADERO;1085;;;
17149;16032;0;2737;FALSO;VERDADERO;1117;;;
17149;16052;0;2738;FALSO;VERDADERO;1097;;;
17149;16052;0;2739;FALSO;VERDADERO;1097;;;
17149;16072;1;2740;FALSO;VERDADERO;1077;;;
17149;16072;0;2741;FALSO;VERDADERO;1077;;;
17181;16072;0;2742;FALSO;VERDADERO;1109;;;
17181;16092;0;2743;FALSO;VERDADERO;1089;;;
17181;16092;0;2744;FALSO;VERDADERO;1089;;;
17181;16112;1;2745;FALSO;VERDADERO;1069;;;
17181;16112;0;2746;FALSO;VERDADERO;1069;;;
17213;16112;0;2747;FALSO;VERDADERO;1101;;;
17213;16132;0;2748;FALSO;VERDADERO;1081;;;
17213;16132;0;2749;FALSO;VERDADERO;1081;;;
17213;16152;0;2750;FALSO;VERDADERO;1061;;;
17213;16152;0;2751;FALSO;VERDADERO;1061;;;
17213;16152;0;2752;FALSO;VERDADERO;1061;;;
17249;16172;0;2753;FALSO;VERDADERO;1077;;;
17249;16172;0;2754;FALSO;VERDADERO;1077;;;
17249;16192;0;2755;FALSO;VERDADERO;1057;;;
17249;16192;0;2756;FALSO;VERDADERO;1057;;;
17249;16192;0;2757;FALSO;VERDADERO;1057;;;
17281;16212;0;2758;FALSO;VERDADERO;1069;;;
17281;16212;0;2759;FALSO;VERDADERO;1069;;;
17281;16232;0;2760;FALSO;VERDADERO;1049;;;
17281;16232;0;2761;FALSO;VERDADERO;1049;;;
17281;16232;0;2762;FALSO;VERDADERO;1049;;;
17315;16252;0;2763;FALSO;VERDADERO;1063;;;
17315;16252;0;2764;FALSO;VERDADERO;1063;;;
17315;16272;0;2765;FALSO;VERDADERO;1043;;;
17315;16272;0;2766;FALSO;VERDADERO;1043;;;
17315;16272;0;2767;FALSO;VERDADERO;1043;;;
17315;16292;0;2768;FALSO;VERDADERO;1023;;;
17349;16292;0;2769;FALSO;VERDADERO;1057;;;
17349;16312;0;2770;FALSO;VERDADERO;1037;;;
17349;16312;0;2771;FALSO;VERDADERO;1037;;;
17349;16332;0;2772;FALSO;VERDADERO;1017;;;
17381;16332;0;2773;FALSO;VERDADERO;1049;;;
17381;16332;0;2774;FALSO;VERDADERO;1049;;;
17381;16352;0;2775;FALSO;VERDADERO;1029;;;
17381;16352;0;2776;FALSO;VERDADERO;1029;;;
17381;16372;0;2777;FALSO;VERDADERO;1009;;;
17381;16372;0;2778;FALSO;VERDADERO;1009;;;
17417;16372;0;2779;FALSO;VERDADERO;1045;;;
17417;16392;0;2780;FALSO;VERDADERO;1025;;;
17417;16392;0;2781;FALSO;VERDADERO;1025;;;
17417;16412;1;2782;FALSO;VERDADERO;1005;;;
17417;16412;0;2783;FALSO;VERDADERO;1005;;;
17449;16412;0;2784;FALSO;VERDADERO;1037;;;
17449;16432;0;2785;FALSO;VERDADERO;1017;;;
17449;16432;0;2786;FALSO;VERDADERO;1017;;;
17449;16452;0,00E+00;2787;FALSO;VERDADERO;997;;;
17449;16452;0;2788;FALSO;VERDADERO;997;;;
17449;16452;0;2789;FALSO;VERDADERO;997;;;
17485;16472;0;2790;FALSO;VERDADERO;1013;;;
17485;16472;0;2791;FALSO;VERDADERO;1013;;;
17485;16492;0;2792;FALSO;VERDADERO;993;;;
17485;16492;0;2793;FALSO;VERDADERO;993;;;
17485;16492;0;2794;FALSO;VERDADERO;993;;;
17517;16512;0;2795;FALSO;VERDADERO;1005;;;
17517;16512;0;2796;FALSO;VERDADERO;1005;;;
17517;16532;0;2797;FALSO;VERDADERO;985;;;
17517;16532;0;2798;FALSO;VERDADERO;985;;;
17517;16532;0;2799;FALSO;VERDADERO;985;;;
17548;16890;0;2800;FALSO;VERDADERO;658;;;
17548;16890;0;2801;FALSO;VERDADERO;658;;;
17548;16910;0;2802;FALSO;VERDADERO;638;;;
17548;16910;0;2803;FALSO;VERDADERO;638;;;
17548;16910;0;2804;FALSO;VERDADERO;638;;;
17548;16930;0;2805;FALSO;VERDADERO;618;;;
17585;16930;0;2806;FALSO;VERDADERO;655;;;
17585;16950;0;2807;FALSO;VERDADERO;635;;;
17585;16950;0;2808;FALSO;VERDADERO;635;;;
17585;16950;0;2809;FALSO;VERDADERO;635;;;
17585;16970;0;2810;FALSO;VERDADERO;615;;;
17617;16970;0;2811;FALSO;VERDADERO;647;;;
17617;16991;0;2812;FALSO;VERDADERO;626;;;
17617;16991;0;2813;FALSO;VERDADERO;626;;;
17617;17011;0;2814;FALSO;VERDADERO;606;;;
17649;17011;0;2815;FALSO;VERDADERO;638;;;
17649;17011;0;2816;FALSO;VERDADERO;638;;;
17649;17031;0;2817;FALSO;VERDADERO;618;;;
17649;17031;0;2818;FALSO;VERDADERO;618;;;
17649;17051;0;2819;FALSO;VERDADERO;598;;;
17649;17051;0;2820;FALSO;VERDADERO;598;;;
17688;17051;0;2821;FALSO;VERDADERO;637;;;
17688;17071;0;2822;FALSO;VERDADERO;617;;;
17688;17071;0;2823;FALSO;VERDADERO;617;;;
17688;17091;0;2824;FALSO;VERDADERO;597;;;
17688;17091;0;2825;FALSO;VERDADERO;597;;;
17717;17091;0;2826;FALSO;VERDADERO;626;;;
17717;17111;0;2827;FALSO;VERDADERO;606;;;
17717;17111;0;2828;FALSO;VERDADERO;606;;;
17717;17131;0;2829;FALSO;VERDADERO;586;;;
17717;17131;0;2830;FALSO;VERDADERO;586;;;
17753;17151;0;2831;FALSO;VERDADERO;602;;;
17753;17151;0;2832;FALSO;VERDADERO;602;;;
17753;17151;0;2833;FALSO;VERDADERO;602;;;
17753;17171;0;2834;FALSO;VERDADERO;582;;;
17753;17171;0;2835;FALSO;VERDADERO;582;;;
17784;17191;0;2836;FALSO;VERDADERO;593;;;
17784;17191;0;2837;FALSO;VERDADERO;593;;;
17784;17191;0;2838;FALSO;VERDADERO;593;;;
17784;17211;0;2839;FALSO;VERDADERO;573;;;
17784;17211;0;2840;FALSO;VERDADERO;573;;;
17784;17231;1;2841;FALSO;VERDADERO;553;;;
17784;17231;0;2842;FALSO;VERDADERO;553;;;
17829;17231;0;2843;FALSO;VERDADERO;598;;;
17829;17251;1;2844;FALSO;VERDADERO;578;;;
17829;17251;0;2845;FALSO;VERDADERO;578;;;
17829;17271;0;2846;FALSO;VERDADERO;558;;;
17855;17271;0;2847;FALSO;VERDADERO;584;;;
17855;17271;0;2848;FALSO;VERDADERO;584;;;
17855;17291;0;2849;FALSO;VERDADERO;564;;;
17855;17291;0;2850;FALSO;VERDADERO;564;;;
17855;17311;0;2851;FALSO;VERDADERO;544;;;
17855;17311;0;2852;FALSO;VERDADERO;544;;;
17889;17311;0;2853;FALSO;VERDADERO;578;;;
17889;17331;0;2854;FALSO;VERDADERO;558;;;
17889;17331;0;2855;FALSO;VERDADERO;558;;;
17889;17351;0;2856;FALSO;VERDADERO;538;;;
17889;17351;0;2857;FALSO;VERDADERO;538;;;
17921;17351;0;2858;FALSO;VERDADERO;570;;;
17921;17371;0;2859;FALSO;VERDADERO;550;;;
17921;17371;0;2860;FALSO;VERDADERO;550;;;
17921;17391;0;2861;FALSO;VERDADERO;530;;;
17921;17391;0;2862;FALSO;VERDADERO;530;;;
17921;17391;0;2863;FALSO;VERDADERO;530;;;
17958;17411;0;2864;FALSO;VERDADERO;547;;;
17958;17411;0;2865;FALSO;VERDADERO;547;;;
17958;17431;0;2866;FALSO;VERDADERO;527;;;
17958;17431;0;2867;FALSO;VERDADERO;527;;;
17985;17431;0;2868;FALSO;VERDADERO;554;;;
17985;17451;0;2869;FALSO;VERDADERO;534;;;
17985;17451;0;2870;FALSO;VERDADERO;534;;;
17985;17471;0;2871;FALSO;VERDADERO;514;;;
17985;17471;0;2872;FALSO;VERDADERO;514;;;
18017;17471;0;2873;FALSO;VERDADERO;546;;;
18017;17491;0;2874;FALSO;VERDADERO;526;;;
18017;17491;0;2875;FALSO;VERDADERO;526;;;
18017;17512;0;2876;FALSO;VERDADERO;505;;;
18017;17512;0;2877;FALSO;VERDADERO;505;;;
18049;17512;0;2878;FALSO;VERDADERO;537;;;
18049;17532;1;2879;FALSO;VERDADERO;517;;;
18049;17532;0;2880;FALSO;VERDADERO;517;;;
18049;17552;0;2881;FALSO;VERDADERO;497;;;
18081;17552;0;2882;FALSO;VERDADERO;529;;;
18081;17572;0;2883;FALSO;VERDADERO;509;;;
18081;17572;0;2884;FALSO;VERDADERO;509;;;
18081;17572;0;2885;FALSO;VERDADERO;509;;;
18081;17592;1;2886;FALSO;VERDADERO;489;;;
18081;17592;0;2887;FALSO;VERDADERO;489;;;
18120;17612;0;2888;FALSO;VERDADERO;508;;;
18120;17612;0;2889;FALSO;VERDADERO;508;;;
18120;17632;0;2890;FALSO;VERDADERO;488;;;
18120;17632;0;2891;FALSO;VERDADERO;488;;;
18120;17632;0;2892;FALSO;VERDADERO;488;;;
18149;17652;0;2893;FALSO;VERDADERO;497;;;
18149;17652;0;2894;FALSO;VERDADERO;497;;;
18149;17672;0;2895;FALSO;VERDADERO;477;;;
18149;17672;0;2896;FALSO;VERDADERO;477;;;
18149;17672;0;2897;FALSO;VERDADERO;477;;;
18181;17693;0;2898;FALSO;VERDADERO;488;;;
18181;17693;0;2899;FALSO;VERDADERO;488;;;
18181;17713;0;2900;FALSO;VERDADERO;468;;;
18181;17713;0;2901;FALSO;VERDADERO;468;;;
18181;17713;0;2902;FALSO;VERDADERO;468;;;
18218;17733;0;2903;FALSO;VERDADERO;485;;;
18218;17733;0;2904;FALSO;VERDADERO;485;;;
18218;17753;0;2905;FALSO;VERDADERO;465;;;
18218;17753;0;2906;FALSO;VERDADERO;465;;;
18218;17773;0;2907;FALSO;VERDADERO;445;;;
18253;17773;0;2908;FALSO;VERDADERO;480;;;
18253;17773;0;2909;FALSO;VERDADERO;480;;;
18253;17793;0;2910;FALSO;VERDADERO;460;;;
18253;17793;0;2911;FALSO;VERDADERO;460;;;
18253;17813;0;2912;FALSO;VERDADERO;440;;;
18253;17813;0;2913;FALSO;VERDADERO;440;;;
18286;17813;0;2914;FALSO;VERDADERO;473;;;
18286;17833;0;2915;FALSO;VERDADERO;453;;;
18286;17833;0;2916;FALSO;VERDADERO;453;;;
18286;17853;0;2917;FALSO;VERDADERO;433;;;
18317;17853;0;2918;FALSO;VERDADERO;464;;;
18317;17853;0;2919;FALSO;VERDADERO;464;;;
18317;17873;0;2920;FALSO;VERDADERO;444;;;
18317;17873;0;2921;FALSO;VERDADERO;444;;;
18317;17893;0;2922;FALSO;VERDADERO;424;;;
18317;17893;0;2923;FALSO;VERDADERO;424;;;
18353;17913;0;2924;FALSO;VERDADERO;440;;;
18353;17913;0;2925;FALSO;VERDADERO;440;;;
18353;17913;0;2926;FALSO;VERDADERO;440;;;
18353;17933;0;2927;FALSO;VERDADERO;420;;;
18353;17933;0;2928;FALSO;VERDADERO;420;;;
18385;17953;0;2929;FALSO;VERDADERO;432;;;
18385;17953;0;2930;FALSO;VERDADERO;432;;;
18385;17953;0;2931;FALSO;VERDADERO;432;;;
18385;17973;0;2932;FALSO;VERDADERO;412;;;
18385;17973;0;2933;FALSO;VERDADERO;412;;;
18385;17993;0;2934;FALSO;VERDADERO;392;;;
18423;17993;0;2935;FALSO;VERDADERO;430;;;
18423;17993;0;2936;FALSO;VERDADERO;430;;;
18423;18013;0;2937;FALSO;VERDADERO;410;;;
18423;18013;0;2938;FALSO;VERDADERO;410;;;
18423;18033;0;2939;FALSO;VERDADERO;390;;;
18453;18033;0;2940;FALSO;VERDADERO;420;;;
18453;18033;0;2941;FALSO;VERDADERO;420;;;
18453;18053;0;2942;FALSO;VERDADERO;400;;;
18453;18053;0;2943;FALSO;VERDADERO;400;;;
18453;18073;0;2944;FALSO;VERDADERO;380;;;
18490;18073;0;2945;FALSO;VERDADERO;417;;;
18490;18073;0;2946;FALSO;VERDADERO;417;;;
18490;18093;0;2947;FALSO;VERDADERO;397;;;
18490;18093;0;2948;FALSO;VERDADERO;397;;;
18490;18113;0;2949;FALSO;VERDADERO;377;;;
18522;18113;0;2950;FALSO;VERDADERO;409;;;
18522;18113;0;2951;FALSO;VERDADERO;409;;;
18522;18133;0;2952;FALSO;VERDADERO;389;;;
18522;18133;0;2953;FALSO;VERDADERO;389;;;
18522;18153;0;2954;FALSO;VERDADERO;369;;;
18522;18153;0;2955;FALSO;VERDADERO;369;;;
18555;18173;0;2956;FALSO;VERDADERO;382;;;
18555;18173;0;2957;FALSO;VERDADERO;382;;;
18555;18173;0;2958;FALSO;VERDADERO;382;;;
18555;18193;0;2959;FALSO;VERDADERO;362;;;
18585;18193;0;2960;FALSO;VERDADERO;392;;;
18585;18193;0;2961;FALSO;VERDADERO;392;;;
18585;18213;0;2962;FALSO;VERDADERO;372;;;
18585;18213;0;2963;FALSO;VERDADERO;372;;;
18585;18233;0;2964;FALSO;VERDADERO;352;;;
18617;18233;0;2965;FALSO;VERDADERO;384;;;
18617;18233;0;2966;FALSO;VERDADERO;384;;;
18617;18253;0;2967;FALSO;VERDADERO;364;;;
18617;18253;0;2968;FALSO;VERDADERO;364;;;
18617;18273;0;2969;FALSO;VERDADERO;344;;;
18649;18273;0;2970;FALSO;VERDADERO;376;;;
18649;18293;0;2971;FALSO;VERDADERO;356;;;
18649;18293;0;2972;FALSO;VERDADERO;356;;;
18649;18293;0;2973;FALSO;VERDADERO;356;;;
18649;18313;0;2974;FALSO;VERDADERO;336;;;
18682;18313;0;2975;FALSO;VERDADERO;369;;;
18682;18333;0;2976;FALSO;VERDADERO;349;;;
18682;18333;0;2977;FALSO;VERDADERO;349;;;
18682;18333;0;2978;FALSO;VERDADERO;349;;;
18682;18353;0;2979;FALSO;VERDADERO;329;;;
18682;18353;0;2980;FALSO;VERDADERO;329;;;
18717;18373;0;2981;FALSO;VERDADERO;344;;;
18717;18373;0;2982;FALSO;VERDADERO;344;;;
18717;18373;0;2983;FALSO;VERDADERO;344;;;
18717;18393;0;2984;FALSO;VERDADERO;324;;;
18717;18393;0;2985;FALSO;VERDADERO;324;;;
18749;18413;0;2986;FALSO;VERDADERO;336;;;
18749;18413;0;2987;FALSO;VERDADERO;336;;;
18749;18433;0;2988;FALSO;VERDADERO;316;;;
18749;18433;0;2989;FALSO;VERDADERO;316;;;
18749;18433;0;2990;FALSO;VERDADERO;316;;;
18785;18453;0;2991;FALSO;VERDADERO;332;;;
18785;18453;0;2992;FALSO;VERDADERO;332;;;
18785;18473;0;2993;FALSO;VERDADERO;312;;;
18785;18473;0;2994;FALSO;VERDADERO;312;;;
18785;18473;0;2995;FALSO;VERDADERO;312;;;
18785;18493;1;2996;FALSO;VERDADERO;292;;;
18818;18493;0;2997;FALSO;VERDADERO;325;;;
18818;18513;0;2998;FALSO;VERDADERO;305;;;
18818;18513;0;2999;FALSO;VERDADERO;305;;;
18818;18533;0;3000;FALSO;VERDADERO;285;;;
18818;18533;0;3001;FALSO;VERDADERO;285;;;
18853;18533;0;3002;FALSO;VERDADERO;320;;;
18853;18553;0;3003;FALSO;VERDADERO;300;;;
18853;18553;0;3004;FALSO;VERDADERO;300;;;
18853;18573;0;3005;FALSO;VERDADERO;280;;;
18853;18573;0;3006;FALSO;VERDADERO;280;;;
18884;18573;0;3007;FALSO;VERDADERO;311;;;
18884;18593;0;3008;FALSO;VERDADERO;291;;;
18884;18593;0;3009;FALSO;VERDADERO;291;;;
18884;18613;0;3010;FALSO;VERDADERO;271;;;
18884;18613;0;3011;FALSO;VERDADERO;271;;;
18917;18613;0;3012;FALSO;VERDADERO;304;;;
18917;18633;0;3013;FALSO;VERDADERO;284;;;
18917;18633;0;3014;FALSO;VERDADERO;284;;;
18917;18653;0;3015;FALSO;VERDADERO;264;;;
18917;18653;0;3016;FALSO;VERDADERO;264;;;
18952;18653;0;3017;FALSO;VERDADERO;299;;;
18952;18673;1;3018;FALSO;VERDADERO;279;;;
18952;18673;0;3019;FALSO;VERDADERO;279;;;
18952;18693;0;3020;FALSO;VERDADERO;259;;;
18952;18693;0;3021;FALSO;VERDADERO;259;;;
18981;18693;0;3022;FALSO;VERDADERO;288;;;
18981;18713;0;3023;FALSO;VERDADERO;268;;;
18981;18713;0;3024;FALSO;VERDADERO;268;;;
18981;18733;0;3025;FALSO;VERDADERO;248;;;
18981;18733;0;3026;FALSO;VERDADERO;248;;;
18981;18733;0;3027;FALSO;VERDADERO;248;;;
19016;18753;0;3028;FALSO;VERDADERO;263;;;
19016;18753;0;3029;FALSO;VERDADERO;263;;;
19016;18773;0;3030;FALSO;VERDADERO;243;;;
19016;18773;0;3031;FALSO;VERDADERO;243;;;
19049;18793;0;3032;FALSO;VERDADERO;256;;;
19049;18793;0;3033;FALSO;VERDADERO;256;;;
19049;18793;0;3034;FALSO;VERDADERO;256;;;
19049;18813;0;3035;FALSO;VERDADERO;236;;;
19049;18813;0;3036;FALSO;VERDADERO;236;;;
19080;18833;0;3037;FALSO;VERDADERO;247;;;
19080;18833;0;3038;FALSO;VERDADERO;247;;;
19080;18833;0;3039;FALSO;VERDADERO;247;;;
19080;18853;0;3040;FALSO;VERDADERO;227;;;
19080;18853;0;3041;FALSO;VERDADERO;227;;;
19113;18873;0;3042;FALSO;VERDADERO;240;;;
19113;18873;0;3043;FALSO;VERDADERO;240;;;
19113;18893;0;3044;FALSO;VERDADERO;220;;;
19113;18893;0;3045;FALSO;VERDADERO;220;;;
19113;18893;0;3046;FALSO;VERDADERO;220;;;
19145;18913;0;3047;FALSO;VERDADERO;232;;;
19145;18913;0;3048;FALSO;VERDADERO;232;;;
19145;18933;0;3049;FALSO;VERDADERO;212;;;
19145;18933;0;3050;FALSO;VERDADERO;212;;;
19145;18933;0;3051;FALSO;VERDADERO;212;;;
19181;18953;0;3052;FALSO;VERDADERO;228;;;
19181;18953;0;3053;FALSO;VERDADERO;228;;;
19181;18973;1;3054;FALSO;VERDADERO;208;;;
19181;18973;0;3055;FALSO;VERDADERO;208;;;
19181;18973;0;3056;FALSO;VERDADERO;208;;;
19213;18993;0;3057;FALSO;VERDADERO;220;;;
19213;18993;0;3058;FALSO;VERDADERO;220;;;
19213;19013;0;3059;FALSO;VERDADERO;200;;;
19213;19013;0;3060;FALSO;VERDADERO;200;;;
19213;19033;0;3061;FALSO;VERDADERO;180;;;
19213;19033;0;3062;FALSO;VERDADERO;180;;;
19249;19033;0;3063;FALSO;VERDADERO;216;;;
19249;19053;0;3064;FALSO;VERDADERO;196;;;
19249;19053;0;3065;FALSO;VERDADERO;196;;;
19249;19073;0;3066;FALSO;VERDADERO;176;;;
19249;19073;0;3067;FALSO;VERDADERO;176;;;
19281;19073;0;3068;FALSO;VERDADERO;208;;;
19281;19093;0;3069;FALSO;VERDADERO;188;;;
19281;19093;0;3070;FALSO;VERDADERO;188;;;
19281;19113;1;3071;FALSO;VERDADERO;168;;;
19281;19113;0;3072;FALSO;VERDADERO;168;;;
19317;19113;0;3073;FALSO;VERDADERO;204;;;
19317;19133;0;3074;FALSO;VERDADERO;184;;;
19317;19133;0;3075;FALSO;VERDADERO;184;;;
19317;19153;0;3076;FALSO;VERDADERO;164;;;
19317;19153;0;3077;FALSO;VERDADERO;164;;;
19349;19173;0;3078;FALSO;VERDADERO;176;;;
19349;19173;0;3079;FALSO;VERDADERO;176;;;
19349;19173;0;3080;FALSO;VERDADERO;176;;;
19349;19193;0;3081;FALSO;VERDADERO;156;;;
19349;19193;0;3082;FALSO;VERDADERO;156;;;
19349;19213;0;3083;FALSO;VERDADERO;136;;;
19385;19213;0;3084;FALSO;VERDADERO;172;;;
19385;19233;0;3085;FALSO;VERDADERO;152;;;
19385;19233;0;3086;FALSO;VERDADERO;152;;;
19385;19233;0;3087;FALSO;VERDADERO;152;;;
19385;19254;0;3088;FALSO;VERDADERO;131;;;
19417;19254;0;3089;FALSO;VERDADERO;163;;;
19417;19274;0;3090;FALSO;VERDADERO;143;;;
19417;19274;0;3091;FALSO;VERDADERO;143;;;
19417;19274;0;3092;FALSO;VERDADERO;143;;;
19417;19294;0;3093;FALSO;VERDADERO;123;;;
19453;19294;0;3094;FALSO;VERDADERO;159;;;
19453;19314;0;3095;FALSO;VERDADERO;139;;;
19453;19314;0;3096;FALSO;VERDADERO;139;;;
19453;19314;0;3097;FALSO;VERDADERO;139;;;
19453;19334;0;3098;FALSO;VERDADERO;119;;;
19485;19334;0;3099;FALSO;VERDADERO;151;;;
19485;19354;0;3100;FALSO;VERDADERO;131;;;
19485;19354;0;3101;FALSO;VERDADERO;131;;;
19485;19354;0;3102;FALSO;VERDADERO;131;;;
19485;19374;0;3103;FALSO;VERDADERO;111;;;
19516;19374;0;3104;FALSO;VERDADERO;142;;;
19516;19394;0;3105;FALSO;VERDADERO;122;;;
19516;19394;0;3106;FALSO;VERDADERO;122;;;
19516;19394;0;3107;FALSO;VERDADERO;122;;;
19516;19414;0;3108;FALSO;VERDADERO;102;;;
19516;19414;0;3109;FALSO;VERDADERO;102;;;
19553;19434;0;3110;FALSO;VERDADERO;119;;;
19553;19434;0;3111;FALSO;VERDADERO;119;;;
19553;19434;0;3112;FALSO;VERDADERO;119;;;
19553;19454;1;3113;FALSO;VERDADERO;99;;;
19553;19454;0;3114;FALSO;VERDADERO;99;;;
19586;19474;0;3115;FALSO;VERDADERO;112;;;
19586;19474;0;3116;FALSO;VERDADERO;112;;;
19586;19474;0;3117;FALSO;VERDADERO;112;;;
19586;19494;0;3118;FALSO;VERDADERO;92;;;
19586;19494;0;3119;FALSO;VERDADERO;92;;;
19617;19514;0;3120;FALSO;VERDADERO;103;;;
19617;19514;0;3121;FALSO;VERDADERO;103;;;
19617;19514;0;3122;FALSO;VERDADERO;103;;;
19617;19534;0;3123;FALSO;VERDADERO;83;;;
19617;19534;0;3124;FALSO;VERDADERO;83;;;
19617;19554;0;3125;FALSO;VERDADERO;63;;;
19653;19554;0;3126;FALSO;VERDADERO;99;;;
19653;19554;0;3127;FALSO;VERDADERO;99;;;
19653;19574;0;3128;FALSO;VERDADERO;79;;;
19653;19574;0;3129;FALSO;VERDADERO;79;;;
19653;19594;0;3130;FALSO;VERDADERO;59;;;
19685;19594;0;3131;FALSO;VERDADERO;91;;;
19685;19594;0;3132;FALSO;VERDADERO;91;;;
19685;19614;0;3133;FALSO;VERDADERO;71;;;
19685;19614;0;3134;FALSO;VERDADERO;71;;;
19685;19634;0;3135;FALSO;VERDADERO;51;;;
19721;19634;0;3136;FALSO;VERDADERO;87;;;
19721;19634;0;3137;FALSO;VERDADERO;87;;;
19721;19654;0;3138;FALSO;VERDADERO;67;;;
19721;19654;0;3139;FALSO;VERDADERO;67;;;
19721;19674;0;3140;VERDADERO;VERDADERO;47;;;
19752;19674;0;3141;FALSO;VERDADERO;78;;;
19752;19674;0;3142;FALSO;VERDADERO;78;;;
19752;19694;0;3143;FALSO;VERDADERO;58;;;
19752;19694;0;3144;FALSO;VERDADERO;58;;;
19752;19714;0;3145;VERDADERO;VERDADERO;38;;;
19752;19714;0;3146;VERDADERO;VERDADERO;38;;;
19785;19714;0;3147;FALSO;VERDADERO;71;;;
19785;19734;0;3148;FALSO;VERDADERO;51;;;
19785;19734;0;3149;FALSO;VERDADERO;51;;;
19785;19754;0;3150;VERDADERO;VERDADERO;31;;;
19785;19754;0;3151;VERDADERO;VERDADERO;31;;;
19821;19754;0;3152;FALSO;VERDADERO;67;;;
19821;19774;0;3153;VERDADERO;VERDADERO;47;;;
19821;19774;0;3154;VERDADERO;VERDADERO;47;;;
19821;19794;0;3155;VERDADERO;VERDADERO;27;;;
19821;19794;0;3156;VERDADERO;VERDADERO;27;;;
19853;19794;0;3157;FALSO;VERDADERO;59;;;
19853;19814;0;3158;VERDADERO;VERDADERO;39;;;
19853;19814;0;3159;VERDADERO;VERDADERO;39;;;
19853;19834;0;3160;VERDADERO;VERDADERO;19;;;
19853;19834;0;3161;VERDADERO;VERDADERO;19;;;
19885;19834;0;3162;FALSO;VERDADERO;51;;;
19885;19854;0;3163;VERDADERO;VERDADERO;31;;;
19885;19854;0;3164;VERDADERO;VERDADERO;31;;;
19885;19874;0;3165;VERDADERO;VERDADERO;11;;;
19885;19874;0;3166;VERDADERO;VERDADERO;11;;;
19917;19874;0;3167;VERDADERO;VERDADERO;43;;;
19917;19894;0;3168;VERDADERO;VERDADERO;23;;;
19917;19894;0;3169;VERDADERO;VERDADERO;23;;;
19917;19914;0;3170;VERDADERO;VERDADERO;3;;;
19917;19914;0;3171;VERDADERO;VERDADERO;3;;;
19949;19914;0;3172;VERDADERO;VERDADERO;35;;;
19949;19934;0;3173;VERDADERO;VERDADERO;15;;;
19949;19934;0;3174;VERDADERO;VERDADERO;15;;;
19949;19954;0;3175;VERDADERO;VERDADERO;-5;;;
19949;19954;0;3176;VERDADERO;VERDADERO;-5;;;
19949;19954;0;3177;VERDADERO;VERDADERO;-5;;;
19985;19974;0;3178;VERDADERO;VERDADERO;11;;;
19985;19974;0;3179;VERDADERO;VERDADERO;11;;;
19985;19994;0;3180;VERDADERO;VERDADERO;-9;;;
19985;19994;0;3181;VERDADERO;VERDADERO;-9;;;
19985;19994;0;3182;VERDADERO;VERDADERO;-9;;;
20017;20014;1;3183;VERDADERO;VERDADERO;3;;;
20017;20014;0;3184;VERDADERO;VERDADERO;3;;;
20017;20034;0;3185;VERDADERO;VERDADERO;-17;;;
20017;20034;0;3186;VERDADERO;VERDADERO;-17;;;
20017;20054;0;3187;VERDADERO;VERDADERO;-37;;;
20049;20054;0;3188;VERDADERO;VERDADERO;-5;;;
20049;20054;0;3189;VERDADERO;VERDADERO;-5;;;
20049;20074;0;3190;VERDADERO;VERDADERO;-25;;;
20049;20074;0;3191;VERDADERO;VERDADERO;-25;;;
20049;20074;0;3192;VERDADERO;VERDADERO;-25;;;
20085;20074;0;3193;VERDADERO;VERDADERO;11;;;
20085;20074;0;3194;VERDADERO;VERDADERO;11;;;
20085;20094;1;3195;VERDADERO;VERDADERO;-9;;;
20085;20094;0;3196;VERDADERO;VERDADERO;-9;;;
20085;20094;0;3197;VERDADERO;VERDADERO;-9;;;
20085;20114;0;3198;VERDADERO;VERDADERO;-29;;;
20117;20114;0;3199;VERDADERO;VERDADERO;3;;;
20117;20134;0;3200;VERDADERO;VERDADERO;-17;;;
20117;20134;0;3201;VERDADERO;VERDADERO;-17;;;
20117;20134;0;3202;VERDADERO;VERDADERO;-17;;;
20117;20134;0;3203;VERDADERO;VERDADERO;-17;;;
20149;20134;0;3204;VERDADERO;VERDADERO;15;;;
20149;20154;0;3205;VERDADERO;VERDADERO;-5;;;
20149;20154;0;3206;VERDADERO;VERDADERO;-5;;;
20149;20154;0;3207;VERDADERO;VERDADERO;-5;;;
20149;20174;0;3208;VERDADERO;VERDADERO;-25;;;
20185;20174;0;3209;VERDADERO;VERDADERO;11;;;
20185;20194;0;3210;VERDADERO;VERDADERO;-9;;;
20185;20194;0;3211;VERDADERO;VERDADERO;-9;;;
20185;20214;0;3212;VERDADERO;VERDADERO;-29;;;
20185;20214;0;3213;VERDADERO;VERDADERO;-29;;;
20217;20214;0;3214;VERDADERO;VERDADERO;3;;;
20217;20234;0;3215;VERDADERO;VERDADERO;-17;;;
20217;20234;0;3216;VERDADERO;VERDADERO;-17;;;
20217;20254;1;3217;VERDADERO;VERDADERO;-37;;;
20217;20254;0;3218;VERDADERO;VERDADERO;-37;;;
20249;20254;0;3219;VERDADERO;VERDADERO;-5;;;
20249;20274;0;3220;VERDADERO;VERDADERO;-25;;;
20249;20274;0;3221;VERDADERO;VERDADERO;-25;;;
20249;20274;0;3222;VERDADERO;VERDADERO;-25;;;
20249;20294;0;3223;VERDADERO;VERDADERO;-45;;;
20249;20294;0;3224;VERDADERO;VERDADERO;-45;;;
20285;20294;0;3225;VERDADERO;VERDADERO;-9;;;
20285;20294;0;3226;VERDADERO;VERDADERO;-9;;;
20285;20314;1;3227;VERDADERO;VERDADERO;-29;;;
20285;20314;0;3228;VERDADERO;VERDADERO;-29;;;
20285;20314;0;3229;VERDADERO;VERDADERO;-29;;;
20317;20334;1;3230;VERDADERO;VERDADERO;-17;;;
20317;20334;0;3231;VERDADERO;VERDADERO;-17;;;
20317;20354;1;3232;VERDADERO;VERDADERO;-37;;;
20317;20354;0;3233;VERDADERO;VERDADERO;-37;;;
20317;20354;0;3234;VERDADERO;VERDADERO;-37;;;
20349;20374;0;3235;VERDADERO;VERDADERO;-25;;;
20349;20374;0;3236;VERDADERO;VERDADERO;-25;;;
20349;20374;0;3237;VERDADERO;VERDADERO;-25;;;
20349;20394;1;3238;VERDADERO;VERDADERO;-45;;;
20349;20394;0;3239;VERDADERO;VERDADERO;-45;;;
20381;20394;0;3240;VERDADERO;VERDADERO;-13;;;
20381;20394;0;3241;VERDADERO;VERDADERO;-13;;;
20381;20394;0;3242;VERDADERO;VERDADERO;-13;;;
20381;20414;0;3243;VERDADERO;VERDADERO;-33;;;
20381;20414;0;3244;VERDADERO;VERDADERO;-33;;;
20413;20414;0;3245;VERDADERO;VERDADERO;-1;;;
20413;20434;0;3246;VERDADERO;VERDADERO;-21;;;
20413;20434;0;3247;VERDADERO;VERDADERO;-21;;;
20413;20454;1;3248;VERDADERO;VERDADERO;-41;;;
20413;20454;0;3249;VERDADERO;VERDADERO;-41;;;
20413;20454;0;3250;VERDADERO;VERDADERO;-41;;;
20449;20474;0;3251;VERDADERO;VERDADERO;-25;;;
20449;20474;0;3252;VERDADERO;VERDADERO;-25;;;
20449;20494;0;3253;VERDADERO;VERDADERO;-45;;;
20449;20494;0;3254;VERDADERO;VERDADERO;-45;;;
20449;20494;0;3255;VERDADERO;VERDADERO;-45;;;
20481;20494;0;3256;VERDADERO;VERDADERO;-13;;;
20481;20494;0;3257;VERDADERO;VERDADERO;-13;;;
20481;20494;0;3258;VERDADERO;VERDADERO;-13;;;
20481;20514;0;3259;VERDADERO;VERDADERO;-33;;;
20481;20514;0;3260;VERDADERO;VERDADERO;-33;;;
20513;20534;0;3261;VERDADERO;VERDADERO;-21;;;
20513;20534;0;3262;VERDADERO;VERDADERO;-21;;;
20513;20534;0;3263;VERDADERO;VERDADERO;-21;;;
20513;20534;0;3264;VERDADERO;VERDADERO;-21;;;
20513;20534;0;3265;VERDADERO;VERDADERO;-21;;;
20513;20534;0;3266;VERDADERO;VERDADERO;-21;;;
20549;20534;0;3267;VERDADERO;VERDADERO;15;;;
20549;20554;1;3268;VERDADERO;VERDADERO;-5;;;
20549;20554;0;3269;VERDADERO;VERDADERO;-5;;;
20549;20574;1;3270;VERDADERO;VERDADERO;-25;;;
20549;20574;0;3271;VERDADERO;VERDADERO;-25;;;
20581;20574;0;3272;VERDADERO;VERDADERO;7;;;
20581;20594;0;3273;VERDADERO;VERDADERO;-13;;;
20581;20594;0;3274;VERDADERO;VERDADERO;-13;;;
20581;20614;0;3275;VERDADERO;VERDADERO;-33;;;
20581;20614;0;3276;VERDADERO;VERDADERO;-33;;;
20613;20634;0;3277;VERDADERO;VERDADERO;-21;;;
20613;20634;0;3278;VERDADERO;VERDADERO;-21;;;
20613;20634;0;3279;VERDADERO;VERDADERO;-21;;;
20613;20654;0;3280;VERDADERO;VERDADERO;-41;;;
20613;20654;0;3281;VERDADERO;VERDADERO;-41;;;
20613;20674;0;3282;VERDADERO;FALSO;-61;;;
20649;20674;0;3283;VERDADERO;VERDADERO;-25;;;
20649;20674;0;3284;VERDADERO;VERDADERO;-25;;;
20649;20694;1;3285;VERDADERO;VERDADERO;-45;;;
20649;20694;0;3286;VERDADERO;VERDADERO;-45;;;
20649;20694;0;3287;VERDADERO;VERDADERO;-45;;;
20681;20714;0;3288;VERDADERO;VERDADERO;-33;;;
20681;20714;0;3289;VERDADERO;VERDADERO;-33;;;
20681;20714;0;3290;VERDADERO;VERDADERO;-33;;;
20681;20734;0;3291;VERDADERO;FALSO;-53;;;
20681;20734;0;3292;VERDADERO;FALSO;-53;;;
20713;20734;0;3293;VERDADERO;VERDADERO;-21;;;
20713;20734;0;3294;VERDADERO;VERDADERO;-21;;;
20713;20734;0;3295;VERDADERO;VERDADERO;-21;;;
20713;20734;0;3296;VERDADERO;VERDADERO;-21;;;
20713;20734;0;3297;VERDADERO;VERDADERO;-21;;;
20713;20754;0;3298;VERDADERO;VERDADERO;-41;;;
20749;20754;0;3299;VERDADERO;VERDADERO;-5;;;
20749;20774;0;3300;VERDADERO;VERDADERO;-25;;;
20749;20774;0;3301;VERDADERO;VERDADERO;-25;;;
20749;20774;0;3302;VERDADERO;VERDADERO;-25;;;
20749;20774;0;3303;VERDADERO;VERDADERO;-25;;;
20781;20774;0;3304;VERDADERO;VERDADERO;7;;;
20781;20774;0;3305;VERDADERO;VERDADERO;7;;;
20781;20794;1;3306;VERDADERO;VERDADERO;-13;;;
20781;20794;0;3307;VERDADERO;VERDADERO;-13;;;
20781;20814;0;3308;VERDADERO;VERDADERO;-33;;;
20812;20814;0;3309;VERDADERO;VERDADERO;-2;;;
20812;20834;1;3310;VERDADERO;VERDADERO;-22;;;
20812;20834;0;3311;VERDADERO;VERDADERO;-22;;;
20812;20834;0;3312;VERDADERO;VERDADERO;-22;;;
20812;20834;0;3313;VERDADERO;VERDADERO;-22;;;
20812;20834;0;3314;VERDADERO;VERDADERO;-22;;;
20849;20834;0;3315;VERDADERO;VERDADERO;15;;;
20849;20834;0;3316;VERDADERO;VERDADERO;15;;;
20849;20834;0;3317;VERDADERO;VERDADERO;15;;;
20849;20834;0;3318;VERDADERO;VERDADERO;15;;;
20849;20834;0;3319;VERDADERO;VERDADERO;15;;;
20881;20834;0;3320;VERDADERO;VERDADERO;47;;;
20881;20834;0;3321;VERDADERO;VERDADERO;47;;;
20881;20854;0;3322;VERDADERO;VERDADERO;27;;;
20881;20854;0;3323;VERDADERO;VERDADERO;27;;;
20881;20854;0;3324;VERDADERO;VERDADERO;27;;;
20913;20874;0;3325;VERDADERO;VERDADERO;39;;;
20913;20874;0;3326;VERDADERO;VERDADERO;39;;;
20913;20894;0;3327;VERDADERO;VERDADERO;19;;;
20913;20894;0;3328;VERDADERO;VERDADERO;19;;;
20913;20894;0;3329;VERDADERO;VERDADERO;19;;;
20913;20894;0;3330;VERDADERO;VERDADERO;19;;;
20949;20894;0;3331;FALSO;VERDADERO;55;;;
20949;20894;0;3332;FALSO;VERDADERO;55;;;
20949;20914;0;3333;VERDADERO;VERDADERO;35;;;
20949;20914;0;3334;VERDADERO;VERDADERO;35;;;
20949;20914;0;3335;VERDADERO;VERDADERO;35;;;
20981;20934;0;3336;VERDADERO;VERDADERO;47;;;
20981;20934;0;3337;VERDADERO;VERDADERO;47;;;
20981;20954;0;3338;VERDADERO;VERDADERO;27;;;
20981;20954;0;3339;VERDADERO;VERDADERO;27;;;
20981;20954;0;3340;VERDADERO;VERDADERO;27;;;
21013;20974;0;3341;VERDADERO;VERDADERO;39;;;
21013;20974;0;3342;VERDADERO;VERDADERO;39;;;
21013;20994;0;3343;VERDADERO;VERDADERO;19;;;
21013;20994;0;3344;VERDADERO;VERDADERO;19;;;
21045;21014;0;3345;VERDADERO;VERDADERO;31;;;
21045;21014;0;3346;VERDADERO;VERDADERO;31;;;
21045;21014;0;3347;VERDADERO;VERDADERO;31;;;
21045;21034;0;3348;VERDADERO;VERDADERO;11;;;
21045;21034;0;3349;VERDADERO;VERDADERO;11;;;
21077;21054;1;3350;VERDADERO;VERDADERO;23;;;
21077;21054;0;3351;VERDADERO;VERDADERO;23;;;
21077;21054;0;3352;VERDADERO;VERDADERO;23;;;
21077;21074;1;3353;VERDADERO;VERDADERO;3;;;
21077;21074;0;3354;VERDADERO;VERDADERO;3;;;
21077;21094;0;3355;VERDADERO;VERDADERO;-17;;;
21113;21094;0;3356;VERDADERO;VERDADERO;19;;;
21113;21094;0;3357;VERDADERO;VERDADERO;19;;;
21113;21114;0;3358;VERDADERO;VERDADERO;-1;;;
21113;21114;0;3359;VERDADERO;VERDADERO;-1;;;
21113;21134;0;3360;VERDADERO;VERDADERO;-21;;;
21145;21134;0;3361;VERDADERO;VERDADERO;11;;;
21145;21134;0;3362;VERDADERO;VERDADERO;11;;;
21145;21154;0;3363;VERDADERO;VERDADERO;-9;;;
21145;21154;0;3364;VERDADERO;VERDADERO;-9;;;
21145;21174;0;3365;VERDADERO;VERDADERO;-29;;;
21177;21174;0;3366;VERDADERO;VERDADERO;3;;;
21177;21195;1;3367;VERDADERO;VERDADERO;-18;;;
21177;21195;0;3368;VERDADERO;VERDADERO;-18;;;
21177;21195;0;3369;VERDADERO;VERDADERO;-18;;;
21177;21215;0;3370;VERDADERO;VERDADERO;-38;;;
21209;21215;0;3371;VERDADERO;VERDADERO;-6;;;
21209;21215;0;3372;VERDADERO;VERDADERO;-6;;;
21209;21235;0;3373;VERDADERO;VERDADERO;-26;;;
21209;21235;0;3374;VERDADERO;VERDADERO;-26;;;
21209;21255;0;3375;VERDADERO;VERDADERO;-46;;;
21242;21255;0;3376;VERDADERO;VERDADERO;-13;;;
21242;21255;0;3377;VERDADERO;VERDADERO;-13;;;
21242;21275;0;3378;VERDADERO;VERDADERO;-33;;;
21242;21275;0;3379;VERDADERO;VERDADERO;-33;;;
21242;21275;0;3380;VERDADERO;VERDADERO;-33;;;
21242;21295;0;3381;VERDADERO;FALSO;-53;;;
21277;21295;0;3382;VERDADERO;VERDADERO;-18;;;
21277;21315;0;3383;VERDADERO;VERDADERO;-38;;;
21277;21315;0;3384;VERDADERO;VERDADERO;-38;;;
21277;21315;0;3385;VERDADERO;VERDADERO;-38;;;
21277;21315;0;3386;VERDADERO;VERDADERO;-38;;;
21309;21315;0;3387;VERDADERO;VERDADERO;-6;;;
21309;21335;0;3388;VERDADERO;VERDADERO;-26;;;
21309;21335;0;3389;VERDADERO;VERDADERO;-26;;;
21309;21335;0;3390;VERDADERO;VERDADERO;-26;;;
21309;21355;0;3391;VERDADERO;VERDADERO;-46;;;
21345;21355;0;3392;VERDADERO;VERDADERO;-10;;;
21345;21355;0;3393;VERDADERO;VERDADERO;-10;;;
21345;21375;0;3394;VERDADERO;VERDADERO;-30;;;
21345;21375;0;3395;VERDADERO;VERDADERO;-30;;;
21345;21375;0;3396;VERDADERO;VERDADERO;-30;;;
21345;21395;0;3397;VERDADERO;FALSO;-50;;;
21377;21395;0;3398;VERDADERO;VERDADERO;-18;;;
21377;21395;0;3399;VERDADERO;VERDADERO;-18;;;
21377;21415;0;3400;VERDADERO;VERDADERO;-38;;;
21377;21415;0;3401;VERDADERO;VERDADERO;-38;;;
21377;21415;0;3402;VERDADERO;VERDADERO;-38;;;
21413;21415;0;3403;VERDADERO;VERDADERO;-2;;;
21413;21415;0;3404;VERDADERO;VERDADERO;-2;;;
21413;21435;0;3405;VERDADERO;VERDADERO;-22;;;
21413;21435;0;3406;VERDADERO;VERDADERO;-22;;;
21413;21455;0;3407;VERDADERO;VERDADERO;-42;;;
21446;21455;0;3408;VERDADERO;VERDADERO;-9;;;
21446;21455;0;3409;VERDADERO;VERDADERO;-9;;;
21446;21475;0;3410;VERDADERO;VERDADERO;-29;;;
21446;21475;0;3411;VERDADERO;VERDADERO;-29;;;
21446;21475;0;3412;VERDADERO;VERDADERO;-29;;;
21446;21495;0;3413;VERDADERO;VERDADERO;-49;;;
21481;21495;0;3414;VERDADERO;VERDADERO;-14;;;
21481;21515;0;3415;VERDADERO;VERDADERO;-34;;;
21481;21515;0;3416;VERDADERO;VERDADERO;-34;;;
21481;21515;0;3417;VERDADERO;VERDADERO;-34;;;
21481;21515;0;3418;VERDADERO;VERDADERO;-34;;;
21513;21515;0;3419;VERDADERO;VERDADERO;-2;;;
21513;21535;0;3420;VERDADERO;VERDADERO;-22;;;
21513;21535;0;3421;VERDADERO;VERDADERO;-22;;;
21513;21535;0;3422;VERDADERO;VERDADERO;-22;;;
21513;21555;0;3423;VERDADERO;VERDADERO;-42;;;
21549;21555;0;3424;VERDADERO;VERDADERO;-6;;;
21549;21575;0;3425;VERDADERO;VERDADERO;-26;;;
21549;21575;0;3426;VERDADERO;VERDADERO;-26;;;
21549;21575;0;3427;VERDADERO;VERDADERO;-26;;;
21549;21595;1;3428;VERDADERO;VERDADERO;-46;;;
21549;21595;0;3429;VERDADERO;VERDADERO;-46;;;
21586;21615;0;3430;VERDADERO;VERDADERO;-29;;;
21586;21615;0;3431;VERDADERO;VERDADERO;-29;;;
21586;21615;0;3432;VERDADERO;VERDADERO;-29;;;
21586;21615;0;3433;VERDADERO;VERDADERO;-29;;;
21586;21615;0;3434;VERDADERO;VERDADERO;-29;;;
21617;21615;0;3435;VERDADERO;VERDADERO;2;;;
21617;21615;0;3436;VERDADERO;VERDADERO;2;;;
21617;21635;0;3437;VERDADERO;VERDADERO;-18;;;
21617;21635;0;3438;VERDADERO;VERDADERO;-18;;;
21617;21655;0;3439;VERDADERO;VERDADERO;-38;;;
21649;21655;0;3440;VERDADERO;VERDADERO;-6;;;
21649;21655;0;3441;VERDADERO;VERDADERO;-6;;;
21649;21675;0;3442;VERDADERO;VERDADERO;-26;;;
21649;21675;0;3443;VERDADERO;VERDADERO;-26;;;
21649;21675;0;3444;VERDADERO;VERDADERO;-26;;;
21681;21695;0;3445;VERDADERO;VERDADERO;-14;;;
21681;21695;0;3446;VERDADERO;VERDADERO;-14;;;
21681;21715;0;3447;VERDADERO;VERDADERO;-34;;;
21681;21715;0;3448;VERDADERO;VERDADERO;-34;;;
21681;21715;0;3449;VERDADERO;VERDADERO;-34;;;
21681;21715;0;3450;VERDADERO;VERDADERO;-34;;;
21715;21715;0;3451;VERDADERO;VERDADERO;0;;;
21715;21735;0;3452;VERDADERO;VERDADERO;-20;;;
21715;21735;0;3453;VERDADERO;VERDADERO;-20;;;
21715;21735;0;3454;VERDADERO;VERDADERO;-20;;;
21715;21755;0;3455;VERDADERO;VERDADERO;-40;;;
21745;21755;0;3456;VERDADERO;VERDADERO;-10;;;
21745;21775;0;3457;VERDADERO;VERDADERO;-30;;;
21745;21775;0;3458;VERDADERO;VERDADERO;-30;;;
21745;21795;0;3459;VERDADERO;FALSO;-50;;;
21745;21795;0;3460;VERDADERO;FALSO;-50;;;
21781;21795;0;3461;VERDADERO;VERDADERO;-14;;;
21781;21815;0;3462;VERDADERO;VERDADERO;-34;;;
21781;21815;0;3463;VERDADERO;VERDADERO;-34;;;
21781;21815;0;3464;VERDADERO;VERDADERO;-34;;;
21781;21815;0;3465;VERDADERO;VERDADERO;-34;;;
21813;21815;0;3466;VERDADERO;VERDADERO;-2;;;
21813;21815;0;3467;VERDADERO;VERDADERO;-2;;;
21813;21835;0;3468;VERDADERO;VERDADERO;-22;;;
21813;21835;0;3469;VERDADERO;VERDADERO;-22;;;
21813;21855;0;3470;VERDADERO;VERDADERO;-42;;;
21813;21855;0;3471;VERDADERO;VERDADERO;-42;;;
21850;21855;0;3472;VERDADERO;VERDADERO;-5;;;
21850;21855;0;3473;VERDADERO;VERDADERO;-5;;;
21850;21855;0;3474;VERDADERO;VERDADERO;-5;;;
21850;21875;0;3475;VERDADERO;VERDADERO;-25;;;
21877;21875;0;3476;VERDADERO;VERDADERO;2;;;
21877;21895;0;3477;VERDADERO;VERDADERO;-18;;;
21877;21895;0;3478;VERDADERO;VERDADERO;-18;;;
21877;21895;0;3479;VERDADERO;VERDADERO;-18;;;
21877;21915;0;3480;VERDADERO;VERDADERO;-38;;;
21909;21915;0;3481;VERDADERO;VERDADERO;-6;;;
21909;21915;0;3482;VERDADERO;VERDADERO;-6;;;
21909;21915;0;3483;VERDADERO;VERDADERO;-6;;;
21909;21935;0;3484;VERDADERO;VERDADERO;-26;;;
21909;21935;0;3485;VERDADERO;VERDADERO;-26;;;
21941;21955;1;3486;VERDADERO;VERDADERO;-14;;;
21941;21955;0;3487;VERDADERO;VERDADERO;-14;;;
21941;21955;0;3488;VERDADERO;VERDADERO;-14;;;
21941;21975;0;3489;VERDADERO;VERDADERO;-34;;;
21941;21975;0;3490;VERDADERO;VERDADERO;-34;;;
21973;21995;0;3491;VERDADERO;VERDADERO;-22;;;
21973;21995;0;3492;VERDADERO;VERDADERO;-22;;;
21973;22015;0;3493;VERDADERO;VERDADERO;-42;;;
21973;22015;0;3494;VERDADERO;VERDADERO;-42;;;
21973;22015;0;3495;VERDADERO;VERDADERO;-42;;;
21973;22015;0;3496;VERDADERO;VERDADERO;-42;;;
22009;22015;0;3497;VERDADERO;VERDADERO;-6;;;
22009;22015;0;3498;VERDADERO;VERDADERO;-6;;;
22009;22035;0;3499;VERDADERO;VERDADERO;-26;;;
22009;22035;0;3500;VERDADERO;VERDADERO;-26;;;
22009;22035;0;3501;VERDADERO;VERDADERO;-26;;;
22041;22055;1;3502;VERDADERO;VERDADERO;-14;;;
22041;22055;0;3503;VERDADERO;VERDADERO;-14;;;
22041;22055;0;3504;VERDADERO;VERDADERO;-14;;;
22041;22055;0;3505;VERDADERO;VERDADERO;-14;;;
22041;22075;0;3506;VERDADERO;VERDADERO;-34;;;
22074;22075;0;3507;VERDADERO;VERDADERO;-1;;;
22074;22075;0;3508;VERDADERO;VERDADERO;-1;;;
22074;22096;0;3509;VERDADERO;VERDADERO;-22;;;
22074;22096;0;3510;VERDADERO;VERDADERO;-22;;;
22074;22116;0;3511;VERDADERO;VERDADERO;-42;;;
22109;22116;0;3512;VERDADERO;VERDADERO;-7;;;
22109;22116;0;3513;VERDADERO;VERDADERO;-7;;;
22109;22116;0;3514;VERDADERO;VERDADERO;-7;;;
22109;22136;0;3515;VERDADERO;VERDADERO;-27;;;
22109;22136;0;3516;VERDADERO;VERDADERO;-27;;;
22109;22156;0;3517;VERDADERO;VERDADERO;-47;;;
22141;22156;0;3518;VERDADERO;VERDADERO;-15;;;
22141;22156;0;3519;VERDADERO;VERDADERO;-15;;;
22141;22176;0;3520;VERDADERO;VERDADERO;-35;;;
22141;22176;0;3521;VERDADERO;VERDADERO;-35;;;
22141;22196;0;3522;VERDADERO;FALSO;-55;;;
22177;22196;0;3523;VERDADERO;VERDADERO;-19;;;
22177;22216;0;3524;VERDADERO;VERDADERO;-39;;;
22177;22216;0;3525;VERDADERO;VERDADERO;-39;;;
22177;22216;0;3526;VERDADERO;VERDADERO;-39;;;
22177;22216;0;3527;VERDADERO;VERDADERO;-39;;;
22209;22216;0;3528;VERDADERO;VERDADERO;-7;;;
22209;22216;0;3529;VERDADERO;VERDADERO;-7;;;
22209;22236;0;3530;VERDADERO;VERDADERO;-27;;;
22209;22236;0;3531;VERDADERO;VERDADERO;-27;;;
22209;22236;0;3532;VERDADERO;VERDADERO;-27;;;
22209;22256;0;3533;VERDADERO;VERDADERO;-47;;;
22245;22256;0;3534;VERDADERO;VERDADERO;-11;;;
22245;22256;0;3535;VERDADERO;VERDADERO;-11;;;
22245;22256;0;3536;VERDADERO;VERDADERO;-11;;;
22245;22256;0;3537;VERDADERO;VERDADERO;-11;;;
22245;22276;0;3538;VERDADERO;VERDADERO;-31;;;
22279;22276;0;3539;VERDADERO;VERDADERO;3;;;
22279;22276;0;3540;VERDADERO;VERDADERO;3;;;
22279;22297;0;3541;VERDADERO;VERDADERO;-18;;;
22279;22297;0;3542;VERDADERO;VERDADERO;-18;;;
22279;22317;0;3543;VERDADERO;VERDADERO;-38;;;
22309;22317;0;3544;VERDADERO;VERDADERO;-8;;;
22309;22317;0;3545;VERDADERO;VERDADERO;-8;;;
22309;22337;0;3546;VERDADERO;VERDADERO;-28;;;
22309;22337;0;3547;VERDADERO;VERDADERO;-28;;;
22309;22337;0;3548;VERDADERO;VERDADERO;-28;;;
22309;22357;0;3549;VERDADERO;VERDADERO;-48;;;
22345;22357;0;3550;VERDADERO;VERDADERO;-12;;;
22345;22377;0;3551;VERDADERO;VERDADERO;-32;;;
22345;22377;0;3552;VERDADERO;VERDADERO;-32;;;
22345;22377;0;3553;VERDADERO;VERDADERO;-32;;;
22377;22397;0;3554;VERDADERO;VERDADERO;-20;;;
22377;22397;0;3555;VERDADERO;VERDADERO;-20;;;
22377;22417;0;3556;VERDADERO;VERDADERO;-40;;;
22377;22417;0;3557;VERDADERO;VERDADERO;-40;;;
22377;22417;0;3558;VERDADERO;VERDADERO;-40;;;
22377;22417;0;3559;VERDADERO;VERDADERO;-40;;;
22413;22417;0;3560;VERDADERO;VERDADERO;-4;;;
22413;22417;0;3561;VERDADERO;VERDADERO;-4;;;
22413;22437;1;3562;VERDADERO;VERDADERO;-24;;;
22413;22437;0;3563;VERDADERO;VERDADERO;-24;;;
22413;22457;0;3564;VERDADERO;VERDADERO;-44;;;
22446;22457;0;3565;VERDADERO;VERDADERO;-11;;;
22446;22457;0;3566;VERDADERO;VERDADERO;-11;;;
22446;22457;0;3567;VERDADERO;VERDADERO;-11;;;
22446;22457;0;3568;VERDADERO;VERDADERO;-11;;;
22446;22457;0;3569;VERDADERO;VERDADERO;-11;;;
22446;22477;0;3570;VERDADERO;VERDADERO;-31;;;
22481;22477;0;3571;VERDADERO;VERDADERO;4;;;
22481;22497;0;3572;VERDADERO;VERDADERO;-16;;;
22481;22497;0;3573;VERDADERO;VERDADERO;-16;;;
22481;22497;0;3574;VERDADERO;VERDADERO;-16;;;
22481;22517;0;3575;VERDADERO;VERDADERO;-36;;;
22513;22517;0;3576;VERDADERO;VERDADERO;-4;;;
22513;22517;0;3577;VERDADERO;VERDADERO;-4;;;
22513;22517;0;3578;VERDADERO;VERDADERO;-4;;;
22513;22537;1;3579;VERDADERO;VERDADERO;-24;;;
22513;22537;0;3580;VERDADERO;VERDADERO;-24;;;
22513;22557;1;3581;VERDADERO;VERDADERO;-44;;;
22549;22557;0;3582;VERDADERO;VERDADERO;-8;;;
22549;22557;0;3583;VERDADERO;VERDADERO;-8;;;
22549;22577;0;3584;VERDADERO;VERDADERO;-28;;;
22549;22577;0;3585;VERDADERO;VERDADERO;-28;;;
22549;22577;0;3586;VERDADERO;VERDADERO;-28;;;
22583;22597;0;3587;VERDADERO;VERDADERO;-14;;;
22583;22597;0;3588;VERDADERO;VERDADERO;-14;;;
22583;22597;0;3589;VERDADERO;VERDADERO;-14;;;
22583;22617;0;3590;VERDADERO;VERDADERO;-34;;;
22583;22617;0;3591;VERDADERO;VERDADERO;-34;;;
22617;22637;0;3592;VERDADERO;VERDADERO;-20;;;
22617;22637;0;3593;VERDADERO;VERDADERO;-20;;;
22617;22637;0;3594;VERDADERO;VERDADERO;-20;;;
22617;22637;0;3595;VERDADERO;VERDADERO;-20;;;
22617;22657;0;3596;VERDADERO;VERDADERO;-40;;;
22649;22657;0;3597;VERDADERO;VERDADERO;-8;;;
22649;22677;0;3598;VERDADERO;VERDADERO;-28;;;
22649;22677;0;3599;VERDADERO;VERDADERO;-28;;;
22649;22677;0;3600;VERDADERO;VERDADERO;-28;;;
22649;22677;0;3601;VERDADERO;VERDADERO;-28;;;
22681;22677;0;3602;VERDADERO;VERDADERO;4;;;
22681;22697;0;3603;VERDADERO;VERDADERO;-16;;;
22681;22697;0;3604;VERDADERO;VERDADERO;-16;;;
22681;22697;0;3605;VERDADERO;VERDADERO;-16;;;
22681;22717;0;3606;VERDADERO;VERDADERO;-36;;;
22681;22717;0;3607;VERDADERO;VERDADERO;-36;;;
22719;22737;1;3608;VERDADERO;VERDADERO;-18;;;
22719;22737;0;3609;VERDADERO;VERDADERO;-18;;;
22719;22737;0;3610;VERDADERO;VERDADERO;-18;;;
22719;22737;0;3611;VERDADERO;VERDADERO;-18;;;
22745;22737;0;3612;VERDADERO;VERDADERO;8;;;
22745;22757;0;3613;VERDADERO;VERDADERO;-12;;;
22745;22757;0;3614;VERDADERO;VERDADERO;-12;;;
22745;22777;0;3615;VERDADERO;VERDADERO;-32;;;
22745;22777;0;3616;VERDADERO;VERDADERO;-32;;;
22745;22777;0;3617;VERDADERO;VERDADERO;-32;;;
22781;22797;0;3618;VERDADERO;VERDADERO;-16;;;
22813;22797;0;3619;VERDADERO;VERDADERO;16;;;
22813;22797;0;3620;VERDADERO;VERDADERO;16;;;
22813;22817;0;3621;VERDADERO;VERDADERO;-4;;;
22813;22817;0;3622;VERDADERO;VERDADERO;-4;;;
22813;22837;1;3623;VERDADERO;VERDADERO;-24;;;
22813;22837;0;3624;VERDADERO;VERDADERO;-24;;;
22846;22837;0;3625;VERDADERO;VERDADERO;9;;;
22846;22837;0;3626;VERDADERO;VERDADERO;9;;;
22846;22837;0;3627;VERDADERO;VERDADERO;9;;;
22846;22857;0;3628;VERDADERO;VERDADERO;-11;;;
22876;22857;0;3629;VERDADERO;VERDADERO;19;;;
22876;22857;0;3630;VERDADERO;VERDADERO;19;;;
22876;22877;0;3631;VERDADERO;VERDADERO;-1;;;
22876;22877;0;3632;VERDADERO;VERDADERO;-1;;;
22876;22897;0;3633;VERDADERO;VERDADERO;-21;;;
22909;22897;0;3634;VERDADERO;VERDADERO;12;;;
22909;22897;0;3635;VERDADERO;VERDADERO;12;;;
22909;22917;0;3636;VERDADERO;VERDADERO;-8;;;
22909;22917;0;3637;VERDADERO;VERDADERO;-8;;;
22909;22937;0;3638;VERDADERO;VERDADERO;-28;;;
22940;22937;0;3639;VERDADERO;VERDADERO;3;;;
22940;22957;1;3640;VERDADERO;VERDADERO;-17;;;
22940;22957;0;3641;VERDADERO;VERDADERO;-17;;;
22940;22957;0;3642;VERDADERO;VERDADERO;-17;;;
22940;22977;0;3643;VERDADERO;VERDADERO;-37;;;
22973;22977;0;3644;VERDADERO;VERDADERO;-4;;;
22973;22977;0;3645;VERDADERO;VERDADERO;-4;;;
22973;22997;0;3646;VERDADERO;VERDADERO;-24;;;
22973;22997;0;3647;VERDADERO;VERDADERO;-24;;;
22973;23017;0;3648;VERDADERO;VERDADERO;-44;;;
22973;23017;0;3649;VERDADERO;VERDADERO;-44;;;
23009;23037;1;3650;VERDADERO;VERDADERO;-28;;;
23009;23037;0;3651;VERDADERO;VERDADERO;-28;;;
23009;23037;0;3652;VERDADERO;VERDADERO;-28;;;
23009;23057;1;3653;VERDADERO;VERDADERO;-48;;;
23009;23057;0;3654;VERDADERO;VERDADERO;-48;;;
23042;23057;0;3655;VERDADERO;VERDADERO;-15;;;
23042;23057;0;3656;VERDADERO;VERDADERO;-15;;;
23042;23057;0;3657;VERDADERO;VERDADERO;-15;;;
23042;23077;0;3658;VERDADERO;VERDADERO;-35;;;
23042;23077;0;3659;VERDADERO;VERDADERO;-35;;;
23073;23097;1;3660;VERDADERO;VERDADERO;-24;;;
23073;23097;0;3661;VERDADERO;VERDADERO;-24;;;
23073;23097;0;3662;VERDADERO;VERDADERO;-24;;;
23073;23097;0;3663;VERDADERO;VERDADERO;-24;;;
23073;23097;0;3664;VERDADERO;VERDADERO;-24;;;
23073;23117;0;3665;VERDADERO;VERDADERO;-44;;;
23109;23117;0;3666;VERDADERO;VERDADERO;-8;;;
23109;23137;0;3667;VERDADERO;VERDADERO;-28;;;
23109;23137;0;3668;VERDADERO;VERDADERO;-28;;;
23109;23137;0;3669;VERDADERO;VERDADERO;-28;;;
23109;23157;0;3670;VERDADERO;VERDADERO;-48;;;
23141;23157;0;3671;VERDADERO;VERDADERO;-16;;;
23141;23177;0;3672;VERDADERO;VERDADERO;-36;;;
23141;23177;0;3673;VERDADERO;VERDADERO;-36;;;
23141;23177;0;3674;VERDADERO;VERDADERO;-36;;;
23141;23197;1;3675;VERDADERO;FALSO;-56;;;
23177;23197;0;3676;VERDADERO;VERDADERO;-20;;;
23177;23197;0;3677;VERDADERO;VERDADERO;-20;;;
23177;23197;0;3678;VERDADERO;VERDADERO;-20;;;
23177;23197;0;3679;VERDADERO;VERDADERO;-20;;;
23177;23217;1;3680;VERDADERO;VERDADERO;-40;;;
23208;23217;0;3681;VERDADERO;VERDADERO;-9;;;
23208;23237;0;3682;VERDADERO;VERDADERO;-29;;;
23208;23237;0;3683;VERDADERO;VERDADERO;-29;;;
23208;23237;0;3684;VERDADERO;VERDADERO;-29;;;
23208;23237;0;3685;VERDADERO;VERDADERO;-29;;;
23208;23237;0;3686;VERDADERO;VERDADERO;-29;;;
23208;23237;0;3687;VERDADERO;VERDADERO;-29;;;
23248;23257;1;3688;VERDADERO;VERDADERO;-9;;;
23248;23257;0;3689;VERDADERO;VERDADERO;-9;;;
23248;23257;0;3690;VERDADERO;VERDADERO;-9;;;
23248;23278;0;3691;VERDADERO;VERDADERO;-30;;;
23277;23278;0;3692;VERDADERO;VERDADERO;-1;;;
23277;23298;0;3693;VERDADERO;VERDADERO;-21;;;
23277;23298;0;3694;VERDADERO;VERDADERO;-21;;;
23277;23298;0;3695;VERDADERO;VERDADERO;-21;;;
23277;23318;0;3696;VERDADERO;VERDADERO;-41;;;
23309;23318;0;3697;VERDADERO;VERDADERO;-9;;;
23309;23338;0;3698;VERDADERO;VERDADERO;-29;;;
23309;23338;0;3699;VERDADERO;VERDADERO;-29;;;
23309;23338;0;3700;VERDADERO;VERDADERO;-29;;;
23309;23338;0;3701;VERDADERO;VERDADERO;-29;;;
23309;23338;0;3702;VERDADERO;VERDADERO;-29;;;
23345;23338;0;3703;VERDADERO;VERDADERO;7;;;
23345;23358;0;3704;VERDADERO;VERDADERO;-13;;;
23345;23358;0;3705;VERDADERO;VERDADERO;-13;;;
23345;23378;0;3706;VERDADERO;VERDADERO;-33;;;
23345;23378;0;3707;VERDADERO;VERDADERO;-33;;;
23345;23378;0;3708;VERDADERO;VERDADERO;-33;;;
23381;23398;0;3709;VERDADERO;VERDADERO;-17;;;
23381;23398;0;3710;VERDADERO;VERDADERO;-17;;;
23381;23418;0;3711;VERDADERO;VERDADERO;-37;;;
23381;23418;0;3712;VERDADERO;VERDADERO;-37;;;
23381;23418;0;3713;VERDADERO;VERDADERO;-37;;;
23413;23438;0;3714;VERDADERO;VERDADERO;-25;;;
23413;23438;0;3715;VERDADERO;VERDADERO;-25;;;
23413;23438;0;3716;VERDADERO;VERDADERO;-25;;;
23413;23438;0;3717;VERDADERO;VERDADERO;-25;;;
23413;23458;0;3718;VERDADERO;VERDADERO;-45;;;
23413;23458;0;3719;VERDADERO;VERDADERO;-45;;;
23449;23478;0;3720;VERDADERO;VERDADERO;-29;;;
23449;23478;0;3721;VERDADERO;VERDADERO;-29;;;
23449;23478;0;3722;VERDADERO;VERDADERO;-29;;;
23449;23478;0;3723;VERDADERO;VERDADERO;-29;;;
23449;23478;0;3724;VERDADERO;VERDADERO;-29;;;
23480;23498;0;3725;VERDADERO;VERDADERO;-18;;;
23480;23498;0;3726;VERDADERO;VERDADERO;-18;;;
23480;23498;0;3727;VERDADERO;VERDADERO;-18;;;
23480;23518;0;3728;VERDADERO;VERDADERO;-38;;;
23480;23518;0;3729;VERDADERO;VERDADERO;-38;;;
23480;23518;0;3730;VERDADERO;VERDADERO;-38;;;
23516;23518;0;3731;VERDADERO;VERDADERO;-2;;;
23516;23538;0;3732;VERDADERO;VERDADERO;-22;;;
23516;23538;0;3733;VERDADERO;VERDADERO;-22;;;
23516;23538;0;3734;VERDADERO;VERDADERO;-22;;;
23516;23559;0;3735;VERDADERO;VERDADERO;-43;;;
23548;23559;0;3736;VERDADERO;VERDADERO;-11;;;
23548;23579;0;3737;VERDADERO;VERDADERO;-31;;;
23548;23579;0;3738;VERDADERO;VERDADERO;-31;;;
23548;23579;0;3739;VERDADERO;VERDADERO;-31;;;
23548;23599;0;3740;VERDADERO;FALSO;-51;;;
23548;23599;0;3741;VERDADERO;FALSO;-51;;;
23585;23599;0;3742;VERDADERO;VERDADERO;-14;;;
23585;23619;0;3743;VERDADERO;VERDADERO;-34;;;
23585;23619;0;3744;VERDADERO;VERDADERO;-34;;;
23585;23619;0;3745;VERDADERO;VERDADERO;-34;;;
23585;23619;0;3746;VERDADERO;VERDADERO;-34;;;
23617;23639;0;3747;VERDADERO;VERDADERO;-22;;;
23617;23639;0;3748;VERDADERO;VERDADERO;-22;;;
23617;23639;0;3749;VERDADERO;VERDADERO;-22;;;
23617;23659;0;3750;VERDADERO;VERDADERO;-42;;;
23617;23659;0;3751;VERDADERO;VERDADERO;-42;;;
23649;23659;0;3752;VERDADERO;VERDADERO;-10;;;
23649;23659;0;3753;VERDADERO;VERDADERO;-10;;;
23649;23659;0;3754;VERDADERO;VERDADERO;-10;;;
23649;23659;0;3755;VERDADERO;VERDADERO;-10;;;
23649;23679;1;3756;VERDADERO;VERDADERO;-30;;;
23681;23679;0;3757;VERDADERO;VERDADERO;2;;;
23681;23700;0;3758;VERDADERO;VERDADERO;-19;;;
23681;23700;0;3759;VERDADERO;VERDADERO;-19;;;
23681;23700;0;3760;VERDADERO;VERDADERO;-19;;;
23681;23720;0;3761;VERDADERO;VERDADERO;-39;;;
23713;23720;0;3762;VERDADERO;VERDADERO;-7;;;
23713;23720;0;3763;VERDADERO;VERDADERO;-7;;;
23713;23740;0;3764;VERDADERO;VERDADERO;-27;;;
23713;23740;0;3765;VERDADERO;VERDADERO;-27;;;
23713;23740;0;3766;VERDADERO;VERDADERO;-27;;;
23745;23760;1;3767;VERDADERO;VERDADERO;-15;;;
23745;23760;0;3768;VERDADERO;VERDADERO;-15;;;
23745;23780;0;3769;VERDADERO;VERDADERO;-35;;;
23745;23780;0;3770;VERDADERO;VERDADERO;-35;;;
23745;23780;0;3771;VERDADERO;VERDADERO;-35;;;
23776;23780;0;3772;VERDADERO;VERDADERO;-4;;;
23776;23780;0;3773;VERDADERO;VERDADERO;-4;;;
23776;23780;0;3774;VERDADERO;VERDADERO;-4;;;
23776;23780;0;3775;VERDADERO;VERDADERO;-4;;;
23776;23780;0;3776;VERDADERO;VERDADERO;-4;;;
23776;23780;0;3777;VERDADERO;VERDADERO;-4;;;
23813;23780;0;3778;VERDADERO;VERDADERO;33;;;
23813;23780;0;3779;VERDADERO;VERDADERO;33;;;
23813;23780;0;3780;VERDADERO;VERDADERO;33;;;
23813;23800;0;3781;VERDADERO;VERDADERO;13;;;
23813;23800;0;3782;VERDADERO;VERDADERO;13;;;
23845;23800;0;3783;VERDADERO;VERDADERO;45;;;
23845;23820;0;3784;VERDADERO;VERDADERO;25;;;
23845;23820;0;3785;VERDADERO;VERDADERO;25;;;
23845;23840;0;3786;VERDADERO;VERDADERO;5;;;
23845;23840;0;3787;VERDADERO;VERDADERO;5;;;
23876;23860;0;3788;VERDADERO;VERDADERO;16;;;
23876;23860;0;3789;VERDADERO;VERDADERO;16;;;
23876;23860;0;3790;VERDADERO;VERDADERO;16;;;
23876;23880;0;3791;VERDADERO;VERDADERO;-4;;;
23876;23880;0;3792;VERDADERO;VERDADERO;-4;;;
23913;23900;0;3793;VERDADERO;VERDADERO;13;;;
23913;23900;0;3794;VERDADERO;VERDADERO;13;;;
23913;23900;0;3795;VERDADERO;VERDADERO;13;;;
23913;23920;0;3796;VERDADERO;VERDADERO;-7;;;
23913;23920;0;3797;VERDADERO;VERDADERO;-7;;;
23945;23940;0;3798;VERDADERO;VERDADERO;5;;;
23945;23940;0;3799;VERDADERO;VERDADERO;5;;;
23945;23940;0;3800;VERDADERO;VERDADERO;5;;;
23945;23960;0;3801;VERDADERO;VERDADERO;-15;;;
23945;23960;0;3802;VERDADERO;VERDADERO;-15;;;
23977;23980;0;3803;VERDADERO;VERDADERO;-3;;;
23977;23980;0;3804;VERDADERO;VERDADERO;-3;;;
23977;24000;0;3805;VERDADERO;VERDADERO;-23;;;
23977;24000;0;3806;VERDADERO;VERDADERO;-23;;;
23977;24000;0;3807;VERDADERO;VERDADERO;-23;;;
23977;24020;0;3808;VERDADERO;VERDADERO;-43;;;
24013;24020;0;3809;VERDADERO;VERDADERO;-7;;;
24013;24040;0;3810;VERDADERO;VERDADERO;-27;;;
24013;24040;0;3811;VERDADERO;VERDADERO;-27;;;
24013;24040;0;3812;VERDADERO;VERDADERO;-27;;;
24013;24060;0;3813;VERDADERO;VERDADERO;-47;;;
24045;24060;0;3814;VERDADERO;VERDADERO;-15;;;
24045;24060;0;3815;VERDADERO;VERDADERO;-15;;;
24045;24080;0;3816;VERDADERO;VERDADERO;-35;;;
24045;24080;0;3817;VERDADERO;VERDADERO;-35;;;
24045;24080;0;3818;VERDADERO;VERDADERO;-35;;;
24076;24080;0;3819;VERDADERO;VERDADERO;-4;;;
24076;24080;0;3820;VERDADERO;VERDADERO;-4;;;
24076;24080;0;3821;VERDADERO;VERDADERO;-4;;;
24076;24080;0;3822;VERDADERO;VERDADERO;-4;;;
24076;24080;0;3823;VERDADERO;VERDADERO;-4;;;
24076;24080;0;3824;VERDADERO;VERDADERO;-4;;;
24113;24080;0;3825;VERDADERO;VERDADERO;33;;;
24113;24080;0;3826;VERDADERO;VERDADERO;33;;;
24113;24080;0;3827;VERDADERO;VERDADERO;33;;;
24113;24080;0;3828;VERDADERO;VERDADERO;33;;;
24113;24100;0;3829;VERDADERO;VERDADERO;13;;;
24145;24100;0;3830;VERDADERO;VERDADERO;45;;;
24145;24120;0;3831;VERDADERO;VERDADERO;25;;;
24145;24120;0;3832;VERDADERO;VERDADERO;25;;;
24145;24120;0;3833;VERDADERO;VERDADERO;25;;;
24145;24140;0;3834;VERDADERO;VERDADERO;5;;;
24177;24140;0;3835;VERDADERO;VERDADERO;37;;;
24177;24160;0;3836;VERDADERO;VERDADERO;17;;;
24177;24160;0;3837;VERDADERO;VERDADERO;17;;;
24177;24160;0;3838;VERDADERO;VERDADERO;17;;;
24177;24180;0;3839;VERDADERO;VERDADERO;-3;;;
24177;24180;0;3840;VERDADERO;VERDADERO;-3;;;
24212;24200;0;3841;VERDADERO;VERDADERO;12;;;
24212;24200;0;3842;VERDADERO;VERDADERO;12;;;
24212;24200;0;3843;VERDADERO;VERDADERO;12;;;
24212;24220;0;3844;VERDADERO;VERDADERO;-8;;;
24212;24220;0;3845;VERDADERO;VERDADERO;-8;;;
24245;24240;0;3846;VERDADERO;VERDADERO;5;;;
24245;24240;0;3847;VERDADERO;VERDADERO;5;;;
24245;24260;0;3848;VERDADERO;VERDADERO;-15;;;
24245;24260;0;3849;VERDADERO;VERDADERO;-15;;;
24245;24260;0;3850;VERDADERO;VERDADERO;-15;;;
24276;24280;1;3851;VERDADERO;VERDADERO;-4;;;
24276;24280;0;3852;VERDADERO;VERDADERO;-4;;;
24276;24300;0;3853;VERDADERO;VERDADERO;-24;;;
24276;24300;0;3854;VERDADERO;VERDADERO;-24;;;
24276;24300;0;3855;VERDADERO;VERDADERO;-24;;;
24309;24320;1;3856;VERDADERO;VERDADERO;-11;;;
24309;24320;0;3857;VERDADERO;VERDADERO;-11;;;
24309;24340;0;3858;VERDADERO;VERDADERO;-31;;;
24309;24340;0;3859;VERDADERO;VERDADERO;-31;;;
24309;24340;0;3860;VERDADERO;VERDADERO;-31;;;
24341;24340;0;3861;VERDADERO;VERDADERO;1;;;
24341;24360;0;3862;VERDADERO;VERDADERO;-19;;;
24341;24360;0;3863;VERDADERO;VERDADERO;-19;;;
24341;24360;0;3864;VERDADERO;VERDADERO;-19;;;
24341;24380;0;3865;VERDADERO;VERDADERO;-39;;;
24377;24380;0;3866;VERDADERO;VERDADERO;-3;;;
24377;24380;0;3867;VERDADERO;VERDADERO;-3;;;
24377;24400;0;3868;VERDADERO;VERDADERO;-23;;;
24377;24400;0;3869;VERDADERO;VERDADERO;-23;;;
24377;24420;0;3870;VERDADERO;VERDADERO;-43;;;
24409;24420;0;3871;VERDADERO;VERDADERO;-11;;;
24409;24420;0;3872;VERDADERO;VERDADERO;-11;;;
24409;24440;0;3873;VERDADERO;VERDADERO;-31;;;
24409;24440;0;3874;VERDADERO;VERDADERO;-31;;;
24409;24460;0;3875;VERDADERO;FALSO;-51;;;
24441;24460;0;3876;VERDADERO;VERDADERO;-19;;;
24441;24460;0;3877;VERDADERO;VERDADERO;-19;;;
24441;24480;0;3878;VERDADERO;VERDADERO;-39;;;
24441;24480;0;3879;VERDADERO;VERDADERO;-39;;;
24441;24500;0;3880;VERDADERO;FALSO;-59;;;
24441;24500;0;3881;VERDADERO;FALSO;-59;;;
24479;24500;0;3882;VERDADERO;VERDADERO;-21;;;
24479;24500;0;3883;VERDADERO;VERDADERO;-21;;;
24479;24500;0;3884;VERDADERO;VERDADERO;-21;;;
24479;24500;0;3885;VERDADERO;VERDADERO;-21;;;
24479;24500;0;3886;VERDADERO;VERDADERO;-21;;;
24506;24500;0;3887;VERDADERO;VERDADERO;6;;;
24506;24500;0;3888;VERDADERO;VERDADERO;6;;;
24506;24520;0;3889;VERDADERO;VERDADERO;-14;;;
24506;24520;0;3890;VERDADERO;VERDADERO;-14;;;
24506;24540;0;3891;VERDADERO;VERDADERO;-34;;;
24541;24540;0;3892;VERDADERO;VERDADERO;1;;;
24541;24560;0;3893;VERDADERO;VERDADERO;-19;;;
24541;24560;0;3894;VERDADERO;VERDADERO;-19;;;
24541;24560;0;3895;VERDADERO;VERDADERO;-19;;;
24541;24560;0;3896;VERDADERO;VERDADERO;-19;;;
24573;24560;0;3897;VERDADERO;VERDADERO;13;;;
24573;24580;0;3898;VERDADERO;VERDADERO;-7;;;
24573;24580;0;3899;VERDADERO;VERDADERO;-7;;;
24573;24600;0;3900;VERDADERO;VERDADERO;-27;;;
24573;24600;0;3901;VERDADERO;VERDADERO;-27;;;
24573;24600;0;3902;VERDADERO;VERDADERO;-27;;;
24609;24620;0;3903;VERDADERO;VERDADERO;-11;;;
24609;24620;0;3904;VERDADERO;VERDADERO;-11;;;
24609;24640;0;3905;VERDADERO;VERDADERO;-31;;;
24609;24640;0;3906;VERDADERO;VERDADERO;-31;;;
24609;24640;0;3907;VERDADERO;VERDADERO;-31;;;
24641;24660;0;3908;VERDADERO;VERDADERO;-19;;;
24641;24660;0;3909;VERDADERO;VERDADERO;-19;;;
24641;24660;0;3910;VERDADERO;VERDADERO;-19;;;
24641;24660;0;3911;VERDADERO;VERDADERO;-19;;;
24641;24680;0;3912;VERDADERO;VERDADERO;-39;;;
24641;24680;0;3913;VERDADERO;VERDADERO;-39;;;
24641;24700;0;3914;VERDADERO;FALSO;-59;;;
24686;24700;0;3915;VERDADERO;VERDADERO;-14;;;
24686;24700;0;3916;VERDADERO;VERDADERO;-14;;;
24686;24720;0;3917;VERDADERO;VERDADERO;-34;;;
24686;24720;0;3918;VERDADERO;VERDADERO;-34;;;
24713;24740;0;3919;VERDADERO;VERDADERO;-27;;;
24713;24740;0;3920;VERDADERO;VERDADERO;-27;;;
24713;24740;0;3921;VERDADERO;VERDADERO;-27;;;
24713;24760;0;3922;VERDADERO;VERDADERO;-47;;;
24741;24760;0;3923;VERDADERO;VERDADERO;-19;;;
24741;24760;0;3924;VERDADERO;VERDADERO;-19;;;
24741;24760;0;3925;VERDADERO;VERDADERO;-19;;;
24741;24780;0;3926;VERDADERO;VERDADERO;-39;;;
24741;24780;0;3927;VERDADERO;VERDADERO;-39;;;
24741;24800;0;3928;VERDADERO;FALSO;-59;;;
24777;24800;0;3929;VERDADERO;VERDADERO;-23;;;
24777;24800;0;3930;VERDADERO;VERDADERO;-23;;;
24777;24800;0;3931;VERDADERO;VERDADERO;-23;;;
24777;24800;0;3932;VERDADERO;VERDADERO;-23;;;
24777;24820;0;3933;VERDADERO;VERDADERO;-43;;;
24777;24820;0;3934;VERDADERO;VERDADERO;-43;;;
24815;24840;0;3935;VERDADERO;VERDADERO;-25;;;
24815;24840;0;3936;VERDADERO;VERDADERO;-25;;;
24815;24840;0;3937;VERDADERO;VERDADERO;-25;;;
24815;24860;1;3938;VERDADERO;VERDADERO;-45;;;
24815;24860;0;3939;VERDADERO;VERDADERO;-45;;;
24845;24860;0;3940;VERDADERO;VERDADERO;-15;;;
24845;24880;0;3941;VERDADERO;VERDADERO;-35;;;
24845;24880;0;3942;VERDADERO;VERDADERO;-35;;;
24845;24900;0;3943;VERDADERO;FALSO;-55;;;
24845;24900;0;3944;VERDADERO;FALSO;-55;;;
24877;24900;0;3945;VERDADERO;VERDADERO;-23;;;
24877;24900;0;3946;VERDADERO;VERDADERO;-23;;;
24877;24900;0;3947;VERDADERO;VERDADERO;-23;;;
24877;24920;0;3948;VERDADERO;VERDADERO;-43;;;
24877;24920;0;3949;VERDADERO;VERDADERO;-43;;;
24909;24920;0;3950;VERDADERO;VERDADERO;-11;;;
24909;24940;0;3951;VERDADERO;VERDADERO;-31;;;
24909;24940;0;3952;VERDADERO;VERDADERO;-31;;;
24909;24940;0;3953;VERDADERO;VERDADERO;-31;;;
24909;24940;0;3954;VERDADERO;VERDADERO;-31;;;
24909;24960;0;3955;VERDADERO;FALSO;-51;;;
24942;24960;0;3956;VERDADERO;VERDADERO;-18;;;
24942;24960;0;3957;VERDADERO;VERDADERO;-18;;;
24942;24980;0;3958;VERDADERO;VERDADERO;-38;;;
24942;24980;0;3959;VERDADERO;VERDADERO;-38;;;
24942;25000;1;3960;VERDADERO;FALSO;-58;;;
24977;25000;0;3961;VERDADERO;VERDADERO;-23;;;
24977;25000;0;3962;VERDADERO;VERDADERO;-23;;;
24977;25020;0;3963;VERDADERO;VERDADERO;-43;;;
24977;25020;0;3964;VERDADERO;VERDADERO;-43;;;
24977;25040;0;3965;VERDADERO;FALSO;-63;;;
25009;25040;0;3966;VERDADERO;VERDADERO;-31;;;
25009;25040;0;3967;VERDADERO;VERDADERO;-31;;;
25009;25040;0;3968;VERDADERO;VERDADERO;-31;;;
25009;25040;0;3969;VERDADERO;VERDADERO;-31;;;
25009;25060;0;3970;VERDADERO;FALSO;-51;;;
25041;25060;0;3971;VERDADERO;VERDADERO;-19;;;
25041;25060;0;3972;VERDADERO;VERDADERO;-19;;;
25041;25080;0;3973;VERDADERO;VERDADERO;-39;;;
25041;25080;0;3974;VERDADERO;VERDADERO;-39;;;
25041;25080;0;3975;VERDADERO;VERDADERO;-39;;;
25077;25080;0;3976;VERDADERO;VERDADERO;-3;;;
25077;25080;0;3977;VERDADERO;VERDADERO;-3;;;
25077;25100;0;3978;VERDADERO;VERDADERO;-23;;;
25077;25100;0;3979;VERDADERO;VERDADERO;-23;;;
25077;25100;0;3980;VERDADERO;VERDADERO;-23;;;
25105;25120;0;3981;VERDADERO;VERDADERO;-15;;;
25105;25120;0;3982;VERDADERO;VERDADERO;-15;;;
25105;25140;1;3983;VERDADERO;VERDADERO;-35;;;
25105;25140;0;3984;VERDADERO;VERDADERO;-35;;;
25105;25140;0;3985;VERDADERO;VERDADERO;-35;;;
25141;25160;0;3986;VERDADERO;VERDADERO;-19;;;
25141;25160;0;3987;VERDADERO;VERDADERO;-19;;;
25141;25180;0;3988;VERDADERO;VERDADERO;-39;;;
25141;25180;0;3989;VERDADERO;VERDADERO;-39;;;
25141;25180;0;3990;VERDADERO;VERDADERO;-39;;;
25173;25180;0;3991;VERDADERO;VERDADERO;-7;;;
25173;25200;0;3992;VERDADERO;VERDADERO;-27;;;
25173;25200;0;3993;VERDADERO;VERDADERO;-27;;;
25173;25220;1;3994;VERDADERO;VERDADERO;-47;;;
25173;25220;0;3995;VERDADERO;VERDADERO;-47;;;
25173;25220;0;3996;VERDADERO;VERDADERO;-47;;;
25209;25220;0;3997;VERDADERO;VERDADERO;-11;;;
25209;25220;0;3998;VERDADERO;VERDADERO;-11;;;
25209;25240;0;3999;VERDADERO;VERDADERO;-31;;;
25209;25240;0;4000;VERDADERO;VERDADERO;-31;;;
25209;25260;0;4001;VERDADERO;FALSO;-51;;;
25242;25260;0;4002;VERDADERO;VERDADERO;-18;;;
25242;25260;0;4003;VERDADERO;VERDADERO;-18;;;
25242;25260;0;4004;VERDADERO;VERDADERO;-18;;;
25242;25260;0;4005;VERDADERO;VERDADERO;-18;;;
25242;25260;0;4006;VERDADERO;VERDADERO;-18;;;
25242;25280;1;4007;VERDADERO;VERDADERO;-38;;;
25277;25280;0;4008;VERDADERO;VERDADERO;-3;;;
25277;25300;0;4009;VERDADERO;VERDADERO;-23;;;
25277;25300;0;4010;VERDADERO;VERDADERO;-23;;;
25277;25300;0;4011;VERDADERO;VERDADERO;-23;;;
25277;25320;0;4012;VERDADERO;VERDADERO;-43;;;
25309;25320;0;4013;VERDADERO;VERDADERO;-11;;;
25309;25340;0;4014;VERDADERO;VERDADERO;-31;;;
25309;25340;0;4015;VERDADERO;VERDADERO;-31;;;
25309;25340;0;4016;VERDADERO;VERDADERO;-31;;;
25309;25360;1;4017;VERDADERO;FALSO;-51;;;
25345;25360;0;4018;VERDADERO;VERDADERO;-15;;;
25345;25360;0;4019;VERDADERO;VERDADERO;-15;;;
25345;25360;0;4020;VERDADERO;VERDADERO;-15;;;
25345;25360;0;4021;VERDADERO;VERDADERO;-15;;;
25345;25380;0;4022;VERDADERO;VERDADERO;-35;;;
25345;25380;0;4023;VERDADERO;VERDADERO;-35;;;
25345;25400;0;4024;VERDADERO;FALSO;-55;;;
25387;25400;0;4025;VERDADERO;VERDADERO;-13;;;
25387;25400;0;4026;VERDADERO;VERDADERO;-13;;;
25387;25420;0;4027;VERDADERO;VERDADERO;-33;;;
25387;25420;0;4028;VERDADERO;VERDADERO;-33;;;
25413;25420;0;4029;VERDADERO;VERDADERO;-7;;;
25413;25440;0;4030;VERDADERO;VERDADERO;-27;;;
25413;25440;0;4031;VERDADERO;VERDADERO;-27;;;
25413;25440;0;4032;VERDADERO;VERDADERO;-27;;;
25413;25460;0;4033;VERDADERO;VERDADERO;-47;;;
25445;25460;0;4034;VERDADERO;VERDADERO;-15;;;
25445;25460;0;4035;VERDADERO;VERDADERO;-15;;;
25445;25460;0;4036;VERDADERO;VERDADERO;-15;;;
25445;25460;0;4037;VERDADERO;VERDADERO;-15;;;
25445;25480;1;4038;VERDADERO;VERDADERO;-35;;;
25477;25480;0;4039;VERDADERO;VERDADERO;-3;;;
25477;25480;0;4040;VERDADERO;VERDADERO;-3;;;
25477;25500;0;4041;VERDADERO;VERDADERO;-23;;;
25477;25500;0;4042;VERDADERO;VERDADERO;-23;;;
25477;25520;0;4043;VERDADERO;VERDADERO;-43;;;
25477;25520;0;4044;VERDADERO;VERDADERO;-43;;;
25513;25520;0;4045;VERDADERO;VERDADERO;-7;;;
25513;25540;0;4046;VERDADERO;VERDADERO;-27;;;
25513;25540;0;4047;VERDADERO;VERDADERO;-27;;;
25513;25540;0;4048;VERDADERO;VERDADERO;-27;;;
25513;25560;0;4049;VERDADERO;VERDADERO;-47;;;
25545;25560;0;4050;VERDADERO;VERDADERO;-15;;;
25545;25560;0;4051;VERDADERO;VERDADERO;-15;;;
25545;25560;0;4052;VERDADERO;VERDADERO;-15;;;
25545;25560;0;4053;VERDADERO;VERDADERO;-15;;;
25545;25580;0;4054;VERDADERO;VERDADERO;-35;;;
25576;25580;0;4055;VERDADERO;VERDADERO;-4;;;
25576;25580;0;4056;VERDADERO;VERDADERO;-4;;;
25576;25601;0;4057;VERDADERO;VERDADERO;-25;;;
25576;25601;0;4058;VERDADERO;VERDADERO;-25;;;
25576;25621;0;4059;VERDADERO;VERDADERO;-45;;;
25609;25621;0;4060;VERDADERO;VERDADERO;-12;;;
25609;25621;0;4061;VERDADERO;VERDADERO;-12;;;
25609;25641;0;4062;VERDADERO;VERDADERO;-32;;;
25609;25641;0;4063;VERDADERO;VERDADERO;-32;;;
25609;25661;0;4064;VERDADERO;FALSO;-52;;;
25609;25661;0;4065;VERDADERO;FALSO;-52;;;
25649;25661;0;4066;VERDADERO;VERDADERO;-12;;;
25649;25661;0;4067;VERDADERO;VERDADERO;-12;;;
25649;25661;0;4068;VERDADERO;VERDADERO;-12;;;
25649;25661;0;4069;VERDADERO;VERDADERO;-12;;;
25649;25681;0;4070;VERDADERO;VERDADERO;-32;;;
25675;25681;0;4071;VERDADERO;VERDADERO;-6;;;
25675;25681;0;4072;VERDADERO;VERDADERO;-6;;;
25675;25701;0;4073;VERDADERO;VERDADERO;-26;;;
25675;25701;0;4074;VERDADERO;VERDADERO;-26;;;
25675;25721;0;4075;VERDADERO;VERDADERO;-46;;;
25709;25721;0;4076;VERDADERO;VERDADERO;-12;;;
25709;25721;0;4077;VERDADERO;VERDADERO;-12;;;
25709;25741;1;4078;VERDADERO;VERDADERO;-32;;;
25709;25741;0;4079;VERDADERO;VERDADERO;-32;;;
25709;25761;0;4080;VERDADERO;FALSO;-52;;;
25740;25761;0;4081;VERDADERO;VERDADERO;-21;;;
25740;25761;0;4082;VERDADERO;VERDADERO;-21;;;
25740;25761;0;4083;VERDADERO;VERDADERO;-21;;;
25740;25761;0;4084;VERDADERO;VERDADERO;-21;;;
25740;25761;0;4085;VERDADERO;VERDADERO;-21;;;
25773;25781;1;4086;VERDADERO;VERDADERO;-8;;;
25773;25781;0;4087;VERDADERO;VERDADERO;-8;;;
25773;25801;1;4088;VERDADERO;VERDADERO;-28;;;
25773;25801;0;4089;VERDADERO;VERDADERO;-28;;;
25773;25801;0;4090;VERDADERO;VERDADERO;-28;;;
25807;25821;0;4091;VERDADERO;VERDADERO;-14;;;
25807;25821;0;4092;VERDADERO;VERDADERO;-14;;;
25807;25821;0;4093;VERDADERO;VERDADERO;-14;;;
25807;25841;1;4094;VERDADERO;VERDADERO;-34;;;
25807;25841;0;4095;VERDADERO;VERDADERO;-34;;;
25836;25841;0;4096;VERDADERO;VERDADERO;-5;;;
25836;25861;0;4097;VERDADERO;VERDADERO;-25;;;
25836;25861;0;4098;VERDADERO;VERDADERO;-25;;;
25836;25861;0;4099;VERDADERO;VERDADERO;-25;;;
25836;25861;0;4100;VERDADERO;VERDADERO;-25;;;
25836;25861;0;4101;VERDADERO;VERDADERO;-25;;;
25873;25881;1;4102;VERDADERO;VERDADERO;-8;;;
25873;25881;0;4103;VERDADERO;VERDADERO;-8;;;
25873;25881;0;4104;VERDADERO;VERDADERO;-8;;;
25873;25901;0;4105;VERDADERO;VERDADERO;-28;;;
25873;25901;0;4106;VERDADERO;VERDADERO;-28;;;
25905;25921;1;4107;VERDADERO;VERDADERO;-16;;;
25905;25921;0;4108;VERDADERO;VERDADERO;-16;;;
25905;25921;0;4109;VERDADERO;VERDADERO;-16;;;
25905;25941;0;4110;VERDADERO;VERDADERO;-36;;;
25905;25941;0;4111;VERDADERO;VERDADERO;-36;;;
25941;25961;0;4112;VERDADERO;VERDADERO;-20;;;
25941;25961;0;4113;VERDADERO;VERDADERO;-20;;;
25941;25961;0;4114;VERDADERO;VERDADERO;-20;;;
25941;25961;0;4115;VERDADERO;VERDADERO;-20;;;
25941;25961;0;4116;VERDADERO;VERDADERO;-20;;;
25941;25961;0;4117;VERDADERO;VERDADERO;-20;;;
25973;25961;0;4118;VERDADERO;VERDADERO;12;;;
25973;25981;0;4119;VERDADERO;VERDADERO;-8;;;
25973;25981;0;4120;VERDADERO;VERDADERO;-8;;;
25973;26001;1;4121;VERDADERO;VERDADERO;-28;;;
25973;26001;0;4122;VERDADERO;VERDADERO;-28;;;
26009;26001;0;4123;VERDADERO;VERDADERO;8;;;
26009;26021;0;4124;VERDADERO;VERDADERO;-12;;;
26009;26021;0;4125;VERDADERO;VERDADERO;-12;;;
26009;26021;0;4126;VERDADERO;VERDADERO;-12;;;
26009;26041;0;4127;VERDADERO;VERDADERO;-32;;;
26041;26041;0;4128;VERDADERO;VERDADERO;0;;;
26041;26061;1;4129;VERDADERO;VERDADERO;-20;;;
26041;26061;0;4130;VERDADERO;VERDADERO;-20;;;
26041;26061;0;4131;VERDADERO;VERDADERO;-20;;;
26041;26081;1;4132;VERDADERO;VERDADERO;-40;;;
26041;26081;0;4133;VERDADERO;VERDADERO;-40;;;
26076;26081;0;4134;VERDADERO;VERDADERO;-5;;;
26076;26101;0;4135;VERDADERO;VERDADERO;-25;;;
26076;26101;0;4136;VERDADERO;VERDADERO;-25;;;
26076;26121;1;4137;VERDADERO;VERDADERO;-45;;;
26076;26121;0;4138;VERDADERO;VERDADERO;-45;;;
26109;26121;0;4139;VERDADERO;VERDADERO;-12;;;
26109;26121;0;4140;VERDADERO;VERDADERO;-12;;;
26109;26121;0;4141;VERDADERO;VERDADERO;-12;;;
26109;26121;0;4142;VERDADERO;VERDADERO;-12;;;
26109;26141;0;4143;VERDADERO;VERDADERO;-32;;;
26109;26141;0;4144;VERDADERO;VERDADERO;-32;;;
26145;26141;0;4145;VERDADERO;VERDADERO;4;;;
26145;26161;0;4146;VERDADERO;VERDADERO;-16;;;
26145;26161;0;4147;VERDADERO;VERDADERO;-16;;;
26145;26181;0;4148;VERDADERO;VERDADERO;-36;;;
26145;26181;0;4149;VERDADERO;VERDADERO;-36;;;
26177;26181;0;4150;VERDADERO;VERDADERO;-4;;;
26177;26181;0;4151;VERDADERO;VERDADERO;-4;;;
26177;26181;0;4152;VERDADERO;VERDADERO;-4;;;
26177;26201;1;4153;VERDADERO;VERDADERO;-24;;;
26177;26201;0;4154;VERDADERO;VERDADERO;-24;;;
26209;26221;0;4155;VERDADERO;VERDADERO;-12;;;
26209;26221;0;4156;VERDADERO;VERDADERO;-12;;;
26209;26221;0;4157;VERDADERO;VERDADERO;-12;;;
26209;26241;0;4158;VERDADERO;VERDADERO;-32;;;
26209;26241;0;4159;VERDADERO;VERDADERO;-32;;;
26241;26261;1;4160;VERDADERO;VERDADERO;-20;;;
26241;26261;0;4161;VERDADERO;VERDADERO;-20;;;
26241;26261;0;4162;VERDADERO;VERDADERO;-20;;;
26241;26281;0;4163;VERDADERO;VERDADERO;-40;;;
26241;26281;0;4164;VERDADERO;VERDADERO;-40;;;
26273;26301;0;4165;VERDADERO;VERDADERO;-28;;;
26273;26301;0;4166;VERDADERO;VERDADERO;-28;;;
26273;26301;0;4167;VERDADERO;VERDADERO;-28;;;
26273;26321;0;4168;VERDADERO;VERDADERO;-48;;;
26273;26321;0;4169;VERDADERO;VERDADERO;-48;;;
26309;26341;0;4170;VERDADERO;VERDADERO;-32;;;
26309;26341;0;4171;VERDADERO;VERDADERO;-32;;;
26309;26341;0;4172;VERDADERO;VERDADERO;-32;;;
26309;26341;0;4173;VERDADERO;VERDADERO;-32;;;
26309;26341;0;4174;VERDADERO;VERDADERO;-32;;;
26309;26341;0;4175;VERDADERO;VERDADERO;-32;;;
26341;26361;0;4176;VERDADERO;VERDADERO;-20;;;
26341;26361;0;4177;VERDADERO;VERDADERO;-20;;;
26341;26361;0;4178;VERDADERO;VERDADERO;-20;;;
26341;26381;0;4179;VERDADERO;VERDADERO;-40;;;
26341;26381;0;4180;VERDADERO;VERDADERO;-40;;;
26372;26401;0;4181;VERDADERO;VERDADERO;-29;;;
26372;26401;0;4182;VERDADERO;VERDADERO;-29;;;
26372;26401;0;4183;VERDADERO;VERDADERO;-29;;;
26372;26421;1;4184;VERDADERO;VERDADERO;-49;;;
26372;26421;0;4185;VERDADERO;VERDADERO;-49;;;
26409;26441;0;4186;VERDADERO;VERDADERO;-32;;;
26409;26441;0;4187;VERDADERO;VERDADERO;-32;;;
26409;26441;0;4188;VERDADERO;VERDADERO;-32;;;
26409;26441;0;4189;VERDADERO;VERDADERO;-32;;;
26409;26461;0;4190;VERDADERO;FALSO;-52;;;
26441;26461;0;4191;VERDADERO;VERDADERO;-20;;;
26441;26481;1;4192;VERDADERO;VERDADERO;-40;;;
26441;26481;0;4193;VERDADERO;VERDADERO;-40;;;
26441;26481;0;4194;VERDADERO;VERDADERO;-40;;;
26441;26481;0;4195;VERDADERO;VERDADERO;-40;;;
26441;26481;0;4196;VERDADERO;VERDADERO;-40;;;
26473;26501;0;4197;VERDADERO;VERDADERO;-28;;;
26473;26501;0;4198;VERDADERO;VERDADERO;-28;;;
26473;26501;0;4199;VERDADERO;VERDADERO;-28;;;
26473;26521;0;4200;VERDADERO;VERDADERO;-48;;;
26505;26521;0;4201;VERDADERO;VERDADERO;-16;;;
26505;26521;0;4202;VERDADERO;VERDADERO;-16;;;
26505;26521;0;4203;VERDADERO;VERDADERO;-16;;;
26505;26521;0;4204;VERDADERO;VERDADERO;-16;;;
26505;26541;0;4205;VERDADERO;VERDADERO;-36;;;
26538;26541;0;4206;VERDADERO;VERDADERO;-3;;;
26538;26561;0;4207;VERDADERO;VERDADERO;-23;;;
26538;26561;0;4208;VERDADERO;VERDADERO;-23;;;
26538;26561;0;4209;VERDADERO;VERDADERO;-23;;;
26538;26581;0;4210;VERDADERO;VERDADERO;-43;;;
26538;26581;0;4211;VERDADERO;VERDADERO;-43;;;
26573;26581;0;4212;VERDADERO;VERDADERO;-8;;;
26573;26601;0;4213;VERDADERO;VERDADERO;-28;;;
26573;26601;0;4214;VERDADERO;VERDADERO;-28;;;
26573;26621;1;4215;VERDADERO;VERDADERO;-48;;;
26573;26621;0;4216;VERDADERO;VERDADERO;-48;;;
26605;26621;0;4217;VERDADERO;VERDADERO;-16;;;
26605;26621;0;4218;VERDADERO;VERDADERO;-16;;;
26605;26621;0;4219;VERDADERO;VERDADERO;-16;;;
26605;26641;0;4220;VERDADERO;VERDADERO;-36;;;
26605;26641;0;4221;VERDADERO;VERDADERO;-36;;;
26605;26641;0;4222;VERDADERO;VERDADERO;-36;;;
26641;26661;0;4223;VERDADERO;VERDADERO;-20;;;
26641;26661;0;4224;VERDADERO;VERDADERO;-20;;;
26641;26661;0;4225;VERDADERO;VERDADERO;-20;;;
26641;26661;0;4226;VERDADERO;VERDADERO;-20;;;
26641;26661;0;4227;VERDADERO;VERDADERO;-20;;;
26673;26661;0;4228;VERDADERO;VERDADERO;12;;;
26673;26681;0;4229;VERDADERO;VERDADERO;-8;;;
26673;26681;0;4230;VERDADERO;VERDADERO;-8;;;
26673;26702;0;4231;VERDADERO;VERDADERO;-29;;;
26673;26702;0;4232;VERDADERO;VERDADERO;-29;;;
26673;26702;0;4233;VERDADERO;VERDADERO;-29;;;
26710;26722;0;4234;VERDADERO;VERDADERO;-12;;;
26710;26722;0;4235;VERDADERO;VERDADERO;-12;;;
26710;26722;0;4236;VERDADERO;VERDADERO;-12;;;
26710;26742;0;4237;VERDADERO;VERDADERO;-32;;;
26741;26742;0;4238;VERDADERO;VERDADERO;-1;;;
26741;26762;0;4239;VERDADERO;VERDADERO;-21;;;
26741;26762;0;4240;VERDADERO;VERDADERO;-21;;;
26741;26762;0;4241;VERDADERO;VERDADERO;-21;;;
26741;26762;0;4242;VERDADERO;VERDADERO;-21;;;
26741;26762;0;4243;VERDADERO;VERDADERO;-21;;;
26777;26762;0;4244;VERDADERO;VERDADERO;15;;;
26777;26782;0;4245;VERDADERO;VERDADERO;-5;;;
26777;26782;0;4246;VERDADERO;VERDADERO;-5;;;
26777;26803;0;4247;VERDADERO;VERDADERO;-26;;;
26777;26803;0;4248;VERDADERO;VERDADERO;-26;;;
26809;26803;0;4249;VERDADERO;VERDADERO;6;;;
26809;26823;0;4250;VERDADERO;VERDADERO;-14;;;
26809;26823;0;4251;VERDADERO;VERDADERO;-14;;;
26809;26823;0;4252;VERDADERO;VERDADERO;-14;;;
26809;26843;0;4253;VERDADERO;VERDADERO;-34;;;
26809;26843;0;4254;VERDADERO;VERDADERO;-34;;;
26845;26863;0;4255;VERDADERO;VERDADERO;-18;;;
26845;26863;0;4256;VERDADERO;VERDADERO;-18;;;
26845;26863;0;4257;VERDADERO;VERDADERO;-18;;;
26845;26883;1;4258;VERDADERO;VERDADERO;-38;;;
26845;26883;0;4259;VERDADERO;VERDADERO;-38;;;
26877;26903;0;4260;VERDADERO;VERDADERO;-26;;;
26877;26903;0;4261;VERDADERO;VERDADERO;-26;;;
26877;26903;0;4262;VERDADERO;VERDADERO;-26;;;
26877;26923;0;4263;VERDADERO;VERDADERO;-46;;;
26877;26923;0;4264;VERDADERO;VERDADERO;-46;;;
26909;26923;0;4265;VERDADERO;VERDADERO;-14;;;
26909;26923;0;4266;VERDADERO;VERDADERO;-14;;;
26909;26943;0;4267;VERDADERO;VERDADERO;-34;;;
26909;26943;0;4268;VERDADERO;VERDADERO;-34;;;
26909;26963;0;4269;VERDADERO;FALSO;-54;;;
26909;26963;0;4270;VERDADERO;FALSO;-54;;;
26945;26963;0;4271;VERDADERO;VERDADERO;-18;;;
26945;26963;0;4272;VERDADERO;VERDADERO;-18;;;
26945;26963;0;4273;VERDADERO;VERDADERO;-18;;;
26945;26983;0;4274;VERDADERO;VERDADERO;-38;;;
26945;26983;0;4275;VERDADERO;VERDADERO;-38;;;
26977;26983;0;4276;VERDADERO;VERDADERO;-6;;;
26977;27003;0;4277;VERDADERO;VERDADERO;-26;;;
26977;27003;0;4278;VERDADERO;VERDADERO;-26;;;
26977;27023;0;4279;VERDADERO;VERDADERO;-46;;;
26977;27023;0;4280;VERDADERO;VERDADERO;-46;;;
27009;27023;0;4281;VERDADERO;VERDADERO;-14;;;
27009;27043;0;4282;VERDADERO;VERDADERO;-34;;;
27009;27043;0;4283;VERDADERO;VERDADERO;-34;;;
27009;27063;0;4284;VERDADERO;FALSO;-54;;;
27009;27063;0;4285;VERDADERO;FALSO;-54;;;
27041;27063;0;4286;VERDADERO;VERDADERO;-22;;;
27041;27063;0;4287;VERDADERO;VERDADERO;-22;;;
27041;27063;0;4288;VERDADERO;VERDADERO;-22;;;
27041;27063;0;4289;VERDADERO;VERDADERO;-22;;;
27041;27063;0;4290;VERDADERO;VERDADERO;-22;;;
27073;27083;0;4291;VERDADERO;VERDADERO;-10;;;
27073;27083;0;4292;VERDADERO;VERDADERO;-10;;;
27073;27103;0;4293;VERDADERO;VERDADERO;-30;;;
27073;27103;0;4294;VERDADERO;VERDADERO;-30;;;
27073;27103;0;4295;VERDADERO;VERDADERO;-30;;;
27073;27103;0;4296;VERDADERO;VERDADERO;-30;;;
27109;27103;0;4297;VERDADERO;VERDADERO;6;;;
27109;27123;0;4298;VERDADERO;VERDADERO;-14;;;
27109;27123;0;4299;VERDADERO;VERDADERO;-14;;;
27109;27143;0;4300;VERDADERO;VERDADERO;-34;;;
27109;27143;0;4301;VERDADERO;VERDADERO;-34;;;
27141;27143;0;4302;VERDADERO;VERDADERO;-2;;;
27141;27163;0;4303;VERDADERO;VERDADERO;-22;;;
27141;27163;0;4304;VERDADERO;VERDADERO;-22;;;
27141;27183;0;4305;VERDADERO;VERDADERO;-42;;;
27141;27183;0;4306;VERDADERO;VERDADERO;-42;;;
27173;27183;0;4307;VERDADERO;VERDADERO;-10;;;
27173;27203;0;4308;VERDADERO;VERDADERO;-30;;;
27173;27203;0;4309;VERDADERO;VERDADERO;-30;;;
27173;27203;0;4310;VERDADERO;VERDADERO;-30;;;
27173;27203;0;4311;VERDADERO;VERDADERO;-30;;;
27205;27223;0;4312;VERDADERO;VERDADERO;-18;;;
27205;27223;0;4313;VERDADERO;VERDADERO;-18;;;
27205;27223;0;4314;VERDADERO;VERDADERO;-18;;;
27205;27243;1;4315;VERDADERO;VERDADERO;-38;;;
27205;27243;0;4316;VERDADERO;VERDADERO;-38;;;
27237;27263;1;4317;VERDADERO;VERDADERO;-26;;;
27237;27263;0;4318;VERDADERO;VERDADERO;-26;;;
27237;27263;0;4319;VERDADERO;VERDADERO;-26;;;
27237;27283;0;4320;VERDADERO;VERDADERO;-46;;;
27237;27283;0;4321;VERDADERO;VERDADERO;-46;;;
27237;27283;0;4322;VERDADERO;VERDADERO;-46;;;
27273;27303;0;4323;VERDADERO;VERDADERO;-30;;;
27273;27303;0;4324;VERDADERO;VERDADERO;-30;;;
27273;27303;0;4325;VERDADERO;VERDADERO;-30;;;
27273;27303;0;4326;VERDADERO;VERDADERO;-30;;;
27273;27303;0;4327;VERDADERO;VERDADERO;-30;;;
27305;27303;0;4328;VERDADERO;VERDADERO;2;;;
27305;27323;0;4329;VERDADERO;VERDADERO;-18;;;
27305;27323;0;4330;VERDADERO;VERDADERO;-18;;;
27305;27343;0;4331;VERDADERO;VERDADERO;-38;;;
27305;27343;0;4332;VERDADERO;VERDADERO;-38;;;
27337;27343;0;4333;VERDADERO;VERDADERO;-6;;;
27337;27363;1;4334;VERDADERO;VERDADERO;-26;;;
27337;27363;0;4335;VERDADERO;VERDADERO;-26;;;
27337;27363;0;4336;VERDADERO;VERDADERO;-26;;;
27337;27383;1;4337;VERDADERO;VERDADERO;-46;;;
27337;27383;0;4338;VERDADERO;VERDADERO;-46;;;
27337;27403;0;4339;VERDADERO;FALSO;-66;;;
27378;27403;0;4340;VERDADERO;VERDADERO;-25;;;
27378;27403;0;4341;VERDADERO;VERDADERO;-25;;;
27378;27403;0;4342;VERDADERO;VERDADERO;-25;;;
27378;27423;0;4343;VERDADERO;VERDADERO;-45;;;
27407;27423;0;4344;VERDADERO;VERDADERO;-16;;;
27407;27423;0;4345;VERDADERO;VERDADERO;-16;;;
27407;27443;0;4346;VERDADERO;VERDADERO;-36;;;
27407;27443;0;4347;VERDADERO;VERDADERO;-36;;;
27407;27443;0;4348;VERDADERO;VERDADERO;-36;;;
27441;27443;0;4349;VERDADERO;VERDADERO;-2;;;
27441;27463;0;4350;VERDADERO;VERDADERO;-22;;;
27441;27463;0;4351;VERDADERO;VERDADERO;-22;;;
27441;27463;0;4352;VERDADERO;VERDADERO;-22;;;
27441;27484;0;4353;VERDADERO;VERDADERO;-43;;;
27441;27484;0;4354;VERDADERO;VERDADERO;-43;;;
27473;27484;0;4355;VERDADERO;VERDADERO;-11;;;
27473;27504;0;4356;VERDADERO;VERDADERO;-31;;;
27473;27504;0;4357;VERDADERO;VERDADERO;-31;;;
27473;27524;0;4358;VERDADERO;FALSO;-51;;;
27473;27524;0;4359;VERDADERO;FALSO;-51;;;
27473;27524;0;4360;VERDADERO;FALSO;-51;;;
27514;27544;1;4361;VERDADERO;VERDADERO;-30;;;
27514;27544;0;4362;VERDADERO;VERDADERO;-30;;;
27514;27544;0;4363;VERDADERO;VERDADERO;-30;;;
27514;27544;0;4364;VERDADERO;VERDADERO;-30;;;
27541;27564;0;4365;VERDADERO;VERDADERO;-23;;;
27541;27564;0;4366;VERDADERO;VERDADERO;-23;;;
27541;27584;0;4367;VERDADERO;VERDADERO;-43;;;
27541;27584;0;4368;VERDADERO;VERDADERO;-43;;;
27541;27584;0;4369;VERDADERO;VERDADERO;-43;;;
27541;27584;0;4370;VERDADERO;VERDADERO;-43;;;
27577;27584;0;4371;VERDADERO;VERDADERO;-7;;;
27577;27604;0;4372;VERDADERO;VERDADERO;-27;;;
27577;27604;0;4373;VERDADERO;VERDADERO;-27;;;
27577;27604;0;4374;VERDADERO;VERDADERO;-27;;;
27577;27624;0;4375;VERDADERO;VERDADERO;-47;;;
27609;27624;0;4376;VERDADERO;VERDADERO;-15;;;
27609;27624;0;4377;VERDADERO;VERDADERO;-15;;;
27609;27624;0;4378;VERDADERO;VERDADERO;-15;;;
27609;27644;0;4379;VERDADERO;VERDADERO;-35;;;
27609;27644;0;4380;VERDADERO;VERDADERO;-35;;;
27609;27644;0;4381;VERDADERO;VERDADERO;-35;;;
27643;27664;0;4382;VERDADERO;VERDADERO;-21;;;
27643;27664;0;4383;VERDADERO;VERDADERO;-21;;;
27643;27684;1;4384;VERDADERO;VERDADERO;-41;;;
27643;27684;0;4385;VERDADERO;VERDADERO;-41;;;
27673;27684;0;4386;VERDADERO;VERDADERO;-11;;;
27673;27704;0;4387;VERDADERO;VERDADERO;-31;;;
27673;27704;0;4388;VERDADERO;VERDADERO;-31;;;
27673;27724;0;4389;VERDADERO;FALSO;-51;;;
27673;27724;0;4390;VERDADERO;FALSO;-51;;;
27705;27724;0;4391;VERDADERO;VERDADERO;-19;;;
27705;27724;0;4392;VERDADERO;VERDADERO;-19;;;
27705;27724;0;4393;VERDADERO;VERDADERO;-19;;;
27705;27744;0;4394;VERDADERO;VERDADERO;-39;;;
27705;27744;0;4395;VERDADERO;VERDADERO;-39;;;
27737;27744;0;4396;VERDADERO;VERDADERO;-7;;;
27737;27764;0;4397;VERDADERO;VERDADERO;-27;;;
27737;27764;0;4398;VERDADERO;VERDADERO;-27;;;
27737;27764;0;4399;VERDADERO;VERDADERO;-27;;;
27737;27764;0;4400;VERDADERO;VERDADERO;-27;;;
27769;27764;0;4401;VERDADERO;VERDADERO;5;;;
27769;27784;0;4402;VERDADERO;VERDADERO;-15;;;
27769;27784;0;4403;VERDADERO;VERDADERO;-15;;;
27769;27804;0;4404;VERDADERO;VERDADERO;-35;;;
27769;27804;0;4405;VERDADERO;VERDADERO;-35;;;
27769;27824;1;4406;VERDADERO;FALSO;-55;;;
27769;27824;0;4407;VERDADERO;FALSO;-55;;;
27810;27824;0;4408;VERDADERO;VERDADERO;-14;;;
27810;27824;0;4409;VERDADERO;VERDADERO;-14;;;
27810;27824;0;4410;VERDADERO;VERDADERO;-14;;;
27810;27844;0;4411;VERDADERO;VERDADERO;-34;;;
27837;27844;0;4412;VERDADERO;VERDADERO;-7;;;
27837;27864;0;4413;VERDADERO;VERDADERO;-27;;;
27837;27864;0;4414;VERDADERO;VERDADERO;-27;;;
27837;27864;0;4415;VERDADERO;VERDADERO;-27;;;
27837;27864;0;4416;VERDADERO;VERDADERO;-27;;;
27868;27864;0;4417;VERDADERO;VERDADERO;4;;;
27868;27884;0;4418;VERDADERO;VERDADERO;-16;;;
27868;27884;0;4419;VERDADERO;VERDADERO;-16;;;
27868;27884;0;4420;VERDADERO;VERDADERO;-16;;;
27868;27904;0;4421;VERDADERO;VERDADERO;-36;;;
27868;27904;0;4422;VERDADERO;VERDADERO;-36;;;
27905;27924;0;4423;VERDADERO;VERDADERO;-19;;;
27905;27924;0;4424;VERDADERO;VERDADERO;-19;;;
27905;27924;0;4425;VERDADERO;VERDADERO;-19;;;
27905;27944;0;4426;VERDADERO;VERDADERO;-39;;;
27905;27944;0;4427;VERDADERO;VERDADERO;-39;;;
27905;27944;0;4428;VERDADERO;VERDADERO;-39;;;
27941;27964;0;4429;VERDADERO;VERDADERO;-23;;;
27941;27964;0;4430;VERDADERO;VERDADERO;-23;;;
27941;27964;0;4431;VERDADERO;VERDADERO;-23;;;
27941;27964;0;4432;VERDADERO;VERDADERO;-23;;;
27941;27964;0;4433;VERDADERO;VERDADERO;-23;;;
27941;27964;0;4434;VERDADERO;VERDADERO;-23;;;
27978;27984;0;4435;VERDADERO;VERDADERO;-6;;;
27978;27984;0;4436;VERDADERO;VERDADERO;-6;;;
27978;28004;0;4437;VERDADERO;VERDADERO;-26;;;
27978;28004;0;4438;VERDADERO;VERDADERO;-26;;;
28005;28004;0;4439;VERDADERO;VERDADERO;1;;;
28005;28024;0;4440;VERDADERO;VERDADERO;-19;;;
28005;28024;0;4441;VERDADERO;VERDADERO;-19;;;
28005;28024;0;4442;VERDADERO;VERDADERO;-19;;;
28005;28044;0;4443;VERDADERO;VERDADERO;-39;;;
28041;28044;0;4444;VERDADERO;VERDADERO;-3;;;
28041;28064;0;4445;VERDADERO;VERDADERO;-23;;;
28041;28064;0;4446;VERDADERO;VERDADERO;-23;;;
28041;28064;0;4447;VERDADERO;VERDADERO;-23;;;
28041;28084;0;4448;VERDADERO;VERDADERO;-43;;;
28073;28084;0;4449;VERDADERO;VERDADERO;-11;;;
28073;28104;1;4450;VERDADERO;VERDADERO;-31;;;
28073;28104;0;4451;VERDADERO;VERDADERO;-31;;;
28073;28104;0;4452;VERDADERO;VERDADERO;-31;;;
28073;28124;1;4453;VERDADERO;FALSO;-51;;;
28073;28124;0;4454;VERDADERO;FALSO;-51;;;
28073;28124;0;4455;VERDADERO;FALSO;-51;;;
28113;28124;0;4456;VERDADERO;VERDADERO;-11;;;
28113;28144;0;4457;VERDADERO;VERDADERO;-31;;;
28113;28144;0;4458;VERDADERO;VERDADERO;-31;;;
28113;28164;0;4459;VERDADERO;FALSO;-51;;;
28141;28164;0;4460;VERDADERO;VERDADERO;-23;;;
28141;28164;0;4461;VERDADERO;VERDADERO;-23;;;
28141;28164;0;4462;VERDADERO;VERDADERO;-23;;;
28141;28164;0;4463;VERDADERO;VERDADERO;-23;;;
28141;28184;0;4464;VERDADERO;VERDADERO;-43;;;
28141;28184;0;4465;VERDADERO;VERDADERO;-43;;;
28177;28184;0;4466;VERDADERO;VERDADERO;-7;;;
28177;28204;0;4467;VERDADERO;VERDADERO;-27;;;
28177;28204;0;4468;VERDADERO;VERDADERO;-27;;;
28177;28204;0;4469;VERDADERO;VERDADERO;-27;;;
28177;28204;0;4470;VERDADERO;VERDADERO;-27;;;
28208;28204;0;4471;VERDADERO;VERDADERO;4;;;
28208;28224;0;4472;VERDADERO;VERDADERO;-16;;;
28208;28224;0;4473;VERDADERO;VERDADERO;-16;;;
28208;28244;0;4474;VERDADERO;VERDADERO;-36;;;
28208;28244;0;4475;VERDADERO;VERDADERO;-36;;;
28243;28264;0;4476;VERDADERO;VERDADERO;-21;;;
28243;28264;0;4477;VERDADERO;VERDADERO;-21;;;
28243;28264;0;4478;VERDADERO;VERDADERO;-21;;;
28243;28264;0;4479;VERDADERO;VERDADERO;-21;;;
28243;28284;1;4480;VERDADERO;VERDADERO;-41;;;
28273;28284;0;4481;VERDADERO;VERDADERO;-11;;;
28273;28284;0;4482;VERDADERO;VERDADERO;-11;;;
28273;28304;0;4483;VERDADERO;VERDADERO;-31;;;
28273;28304;0;4484;VERDADERO;VERDADERO;-31;;;
28273;28304;0;4485;VERDADERO;VERDADERO;-31;;;
28305;28304;0;4486;VERDADERO;VERDADERO;1;;;
28305;28304;0;4487;VERDADERO;VERDADERO;1;;;
28305;28324;0;4488;VERDADERO;VERDADERO;-19;;;
28305;28324;0;4489;VERDADERO;VERDADERO;-19;;;
28305;28344;0;4490;VERDADERO;VERDADERO;-39;;;
28336;28344;0;4491;VERDADERO;VERDADERO;-8;;;
28336;28344;0;4492;VERDADERO;VERDADERO;-8;;;
28336;28364;0;4493;VERDADERO;VERDADERO;-28;;;
28336;28364;0;4494;VERDADERO;VERDADERO;-28;;;
28336;28364;0;4495;VERDADERO;VERDADERO;-28;;;
28370;28364;0;4496;VERDADERO;VERDADERO;6;;;
28370;28384;0;4497;VERDADERO;VERDADERO;-14;;;
28370;28384;0;4498;VERDADERO;VERDADERO;-14;;;
28370;28404;0;4499;VERDADERO;VERDADERO;-34;;;
28370;28404;0;4500;VERDADERO;VERDADERO;-34;;;
28370;28404;0;4501;VERDADERO;VERDADERO;-34;;;
28405;28424;0;4502;VERDADERO;VERDADERO;-19;;;
28405;28424;0;4503;VERDADERO;VERDADERO;-19;;;
28405;28444;0;4504;VERDADERO;VERDADERO;-39;;;
28405;28444;0;4505;VERDADERO;VERDADERO;-39;;;
28405;28444;0;4506;VERDADERO;VERDADERO;-39;;;
28437;28464;1;4507;VERDADERO;VERDADERO;-27;;;
28437;28464;0;4508;VERDADERO;VERDADERO;-27;;;
28437;28464;0;4509;VERDADERO;VERDADERO;-27;;;
28437;28464;0;4510;VERDADERO;VERDADERO;-27;;;
28437;28464;0;4511;VERDADERO;VERDADERO;-27;;;
28437;28484;1;4512;VERDADERO;VERDADERO;-47;;;
28437;28484;0;4513;VERDADERO;VERDADERO;-47;;;
28474;28504;1;4514;VERDADERO;VERDADERO;-30;;;
28474;28504;0;4515;VERDADERO;VERDADERO;-30;;;
28474;28504;0;4516;VERDADERO;VERDADERO;-30;;;
28474;28504;0;4517;VERDADERO;VERDADERO;-30;;;
28474;28504;0;4518;VERDADERO;VERDADERO;-30;;;
28511;28524;0;4519;VERDADERO;VERDADERO;-13;;;
28511;28524;0;4520;VERDADERO;VERDADERO;-13;;;
28511;28545;1;4521;VERDADERO;VERDADERO;-34;;;
28511;28545;0;4522;VERDADERO;VERDADERO;-34;;;
28541;28545;0;4523;VERDADERO;VERDADERO;-4;;;
28541;28565;0;4524;VERDADERO;VERDADERO;-24;;;
28541;28565;0;4525;VERDADERO;VERDADERO;-24;;;
28541;28585;0;4526;VERDADERO;VERDADERO;-44;;;
28541;28585;0;4527;VERDADERO;VERDADERO;-44;;;
28573;28585;0;4528;VERDADERO;VERDADERO;-12;;;
28573;28605;0;4529;VERDADERO;VERDADERO;-32;;;
28573;28605;0;4530;VERDADERO;VERDADERO;-32;;;
28573;28605;0;4531;VERDADERO;VERDADERO;-32;;;
28573;28605;0;4532;VERDADERO;VERDADERO;-32;;;
28605;28625;0;4533;VERDADERO;VERDADERO;-20;;;
28605;28625;0;4534;VERDADERO;VERDADERO;-20;;;
28605;28625;0;4535;VERDADERO;VERDADERO;-20;;;
28605;28645;1;4536;VERDADERO;VERDADERO;-40;;;
28605;28645;0;4537;VERDADERO;VERDADERO;-40;;;
28638;28645;0;4538;VERDADERO;VERDADERO;-7;;;
28638;28645;0;4539;VERDADERO;VERDADERO;-7;;;
28638;28665;1;4540;VERDADERO;VERDADERO;-27;;;
28638;28665;0;4541;VERDADERO;VERDADERO;-27;;;
28638;28665;0;4542;VERDADERO;VERDADERO;-27;;;
28669;28685;0;4543;VERDADERO;VERDADERO;-16;;;
28669;28685;0;4544;VERDADERO;VERDADERO;-16;;;
28669;28705;0;4545;VERDADERO;VERDADERO;-36;;;
28669;28705;0;4546;VERDADERO;VERDADERO;-36;;;
28669;28705;0;4547;VERDADERO;VERDADERO;-36;;;
28669;28725;0;4548;VERDADERO;FALSO;-56;;;
28705;28725;0;4549;VERDADERO;VERDADERO;-20;;;
28705;28745;0;4550;VERDADERO;VERDADERO;-40;;;
28705;28745;0;4551;VERDADERO;VERDADERO;-40;;;
28705;28745;0;4552;VERDADERO;VERDADERO;-40;;;
28705;28745;0;4553;VERDADERO;VERDADERO;-40;;;
28737;28745;0;4554;VERDADERO;VERDADERO;-8;;;
28737;28765;0;4555;VERDADERO;VERDADERO;-28;;;
28737;28765;0;4556;VERDADERO;VERDADERO;-28;;;
28737;28765;0;4557;VERDADERO;VERDADERO;-28;;;
28737;28785;0;4558;VERDADERO;VERDADERO;-48;;;
28769;28785;0;4559;VERDADERO;VERDADERO;-16;;;
28769;28785;0;4560;VERDADERO;VERDADERO;-16;;;
28769;28785;0;4561;VERDADERO;VERDADERO;-16;;;
28769;28785;0;4562;VERDADERO;VERDADERO;-16;;;
28769;28805;1;4563;VERDADERO;VERDADERO;-36;;;
28769;28805;0;4564;VERDADERO;VERDADERO;-36;;;
28808;28805;0;4565;VERDADERO;VERDADERO;3;;;
28808;28825;1;4566;VERDADERO;VERDADERO;-17;;;
28808;28825;0;4567;VERDADERO;VERDADERO;-17;;;
28808;28845;0;4568;VERDADERO;VERDADERO;-37;;;
28833;28845;0;4569;VERDADERO;VERDADERO;-12;;;
28833;28845;0;4570;VERDADERO;VERDADERO;-12;;;
28833;28845;0;4571;VERDADERO;VERDADERO;-12;;;
28833;28865;0;4572;VERDADERO;VERDADERO;-32;;;
28833;28865;0;4573;VERDADERO;VERDADERO;-32;;;
28833;28885;1;4574;VERDADERO;FALSO;-52;;;
28869;28885;0;4575;VERDADERO;VERDADERO;-16;;;
28869;28885;0;4576;VERDADERO;VERDADERO;-16;;;
28869;28905;0;4577;VERDADERO;VERDADERO;-36;;;
28869;28905;0;4578;VERDADERO;VERDADERO;-36;;;
28869;28925;0;4579;VERDADERO;FALSO;-56;;;
28901;28925;0;4580;VERDADERO;VERDADERO;-24;;;
28901;28925;0;4581;VERDADERO;VERDADERO;-24;;;
28901;28945;0;4582;VERDADERO;VERDADERO;-44;;;
28901;28945;0;4583;VERDADERO;VERDADERO;-44;;;
28901;28945;0;4584;VERDADERO;VERDADERO;-44;;;
28937;28945;0;4585;VERDADERO;VERDADERO;-8;;;
28937;28945;0;4586;VERDADERO;VERDADERO;-8;;;
28937;28965;0;4587;VERDADERO;VERDADERO;-28;;;
28937;28965;0;4588;VERDADERO;VERDADERO;-28;;;
28937;28965;0;4589;VERDADERO;VERDADERO;-28;;;
28969;28985;0;4590;VERDADERO;VERDADERO;-16;;;
28969;28985;0;4591;VERDADERO;VERDADERO;-16;;;
28969;28985;0;4592;VERDADERO;VERDADERO;-16;;;
28969;28985;0;4593;VERDADERO;VERDADERO;-16;;;
28969;28985;0;4594;VERDADERO;VERDADERO;-16;;;
28969;29005;0;4595;VERDADERO;VERDADERO;-36;;;
28969;29005;0;4596;VERDADERO;VERDADERO;-36;;;
29011;29025;0;4597;VERDADERO;VERDADERO;-14;;;
29011;29025;0;4598;VERDADERO;VERDADERO;-14;;;
29011;29025;0;4599;VERDADERO;VERDADERO;-14;;;
29011;29045;0;4600;VERDADERO;VERDADERO;-34;;;
29037;29045;0;4601;VERDADERO;VERDADERO;-8;;;
29037;29065;0;4602;VERDADERO;VERDADERO;-28;;;
29037;29065;0;4603;VERDADERO;VERDADERO;-28;;;
29037;29065;0;4604;VERDADERO;VERDADERO;-28;;;
29037;29085;0;4605;VERDADERO;VERDADERO;-48;;;
29069;29085;0;4606;VERDADERO;VERDADERO;-16;;;
29069;29085;0;4607;VERDADERO;VERDADERO;-16;;;
29069;29085;0;4608;VERDADERO;VERDADERO;-16;;;
29069;29105;1;4609;VERDADERO;VERDADERO;-36;;;
29069;29105;0;4610;VERDADERO;VERDADERO;-36;;;
29069;29105;0;4611;VERDADERO;VERDADERO;-36;;;
29105;29125;0;4612;VERDADERO;VERDADERO;-20;;;
29105;29125;0;4613;VERDADERO;VERDADERO;-20;;;
29105;29145;0;4614;VERDADERO;VERDADERO;-40;;;
29105;29145;0;4615;VERDADERO;VERDADERO;-40;;;
29105;29145;0;4616;VERDADERO;VERDADERO;-40;;;
29105;29165;0;4617;VERDADERO;FALSO;-60;;;
29105;29165;0;4618;VERDADERO;FALSO;-60;;;
29147;29165;0;4619;VERDADERO;VERDADERO;-18;;;
29147;29185;0;4620;VERDADERO;VERDADERO;-38;;;
29147;29185;0;4621;VERDADERO;VERDADERO;-38;;;
29147;29185;0;4622;VERDADERO;VERDADERO;-38;;;
29173;29185;0;4623;VERDADERO;VERDADERO;-12;;;
29173;29185;0;4624;VERDADERO;VERDADERO;-12;;;
29173;29185;0;4625;VERDADERO;VERDADERO;-12;;;
29173;29185;0;4626;VERDADERO;VERDADERO;-12;;;
29173;29205;0;4627;VERDADERO;VERDADERO;-32;;;
29205;29205;0;4628;VERDADERO;VERDADERO;0;;;
29205;29225;0;4629;VERDADERO;VERDADERO;-20;;;
29205;29225;0;4630;VERDADERO;VERDADERO;-20;;;
29205;29225;0;4631;VERDADERO;VERDADERO;-20;;;
29205;29225;0;4632;VERDADERO;VERDADERO;-20;;;
29237;29225;0;4633;VERDADERO;VERDADERO;12;;;
29237;29245;0;4634;VERDADERO;VERDADERO;-8;;;
29237;29245;0;4635;VERDADERO;VERDADERO;-8;;;
29237;29265;0;4636;VERDADERO;VERDADERO;-28;;;
29237;29265;0;4637;VERDADERO;VERDADERO;-28;;;
29237;29265;0;4638;VERDADERO;VERDADERO;-28;;;
29270;29285;1;4639;VERDADERO;VERDADERO;-15;;;
29270;29285;0;4640;VERDADERO;VERDADERO;-15;;;
29270;29285;0;4641;VERDADERO;VERDADERO;-15;;;
29270;29305;0;4642;VERDADERO;VERDADERO;-35;;;
29270;29305;0;4643;VERDADERO;VERDADERO;-35;;;
29305;29325;1;4644;VERDADERO;VERDADERO;-20;;;
29305;29325;0;4645;VERDADERO;VERDADERO;-20;;;
29305;29325;0;4646;VERDADERO;VERDADERO;-20;;;
29305;29325;0;4647;VERDADERO;VERDADERO;-20;;;
29305;29325;0;4648;VERDADERO;VERDADERO;-20;;;
29337;29345;0;4649;VERDADERO;VERDADERO;-8;;;
29337;29345;0;4650;VERDADERO;VERDADERO;-8;;;
29337;29345;0;4651;VERDADERO;VERDADERO;-8;;;
29337;29365;0;4652;VERDADERO;VERDADERO;-28;;;
29337;29365;0;4653;VERDADERO;VERDADERO;-28;;;
29369;29385;0;4654;VERDADERO;VERDADERO;-16;;;
29369;29385;0;4655;VERDADERO;VERDADERO;-16;;;
29369;29385;0;4656;VERDADERO;VERDADERO;-16;;;
29369;29405;0;4657;VERDADERO;VERDADERO;-36;;;
29369;29405;0;4658;VERDADERO;VERDADERO;-36;;;
29401;29425;0;4659;VERDADERO;VERDADERO;-24;;;
29401;29425;0;4660;VERDADERO;VERDADERO;-24;;;
29401;29425;0;4661;VERDADERO;VERDADERO;-24;;;
29401;29425;0;4662;VERDADERO;VERDADERO;-24;;;
29401;29445;0;4663;VERDADERO;VERDADERO;-44;;;
29434;29445;0;4664;VERDADERO;VERDADERO;-11;;;
29434;29445;0;4665;VERDADERO;VERDADERO;-11;;;
29434;29465;0;4666;VERDADERO;VERDADERO;-31;;;
29434;29465;0;4667;VERDADERO;VERDADERO;-31;;;
29434;29465;0;4668;VERDADERO;VERDADERO;-31;;;
29434;29465;0;4669;VERDADERO;VERDADERO;-31;;;
29469;29465;0;4670;VERDADERO;VERDADERO;4;;;
29469;29485;0;4671;VERDADERO;VERDADERO;-16;;;
29469;29485;0;4672;VERDADERO;VERDADERO;-16;;;
29469;29505;1;4673;VERDADERO;VERDADERO;-36;;;
29469;29505;0;4674;VERDADERO;VERDADERO;-36;;;
29501;29505;0;4675;VERDADERO;VERDADERO;-4;;;
29501;29525;0;4676;VERDADERO;VERDADERO;-24;;;
29501;29525;0;4677;VERDADERO;VERDADERO;-24;;;
29501;29525;0;4678;VERDADERO;VERDADERO;-24;;;
29501;29545;0;4679;VERDADERO;VERDADERO;-44;;;
29501;29545;0;4680;VERDADERO;VERDADERO;-44;;;
29537;29565;0;4681;VERDADERO;VERDADERO;-28;;;
29537;29565;0;4682;VERDADERO;VERDADERO;-28;;;
29537;29565;0;4683;VERDADERO;VERDADERO;-28;;;
29537;29565;0;4684;VERDADERO;VERDADERO;-28;;;
29537;29565;0;4685;VERDADERO;VERDADERO;-28;;;
29569;29585;0;4686;VERDADERO;VERDADERO;-16;;;
29569;29585;0;4687;VERDADERO;VERDADERO;-16;;;
29569;29585;0;4688;VERDADERO;VERDADERO;-16;;;
29569;29605;1;4689;VERDADERO;VERDADERO;-36;;;
29569;29605;0;4690;VERDADERO;VERDADERO;-36;;;
29569;29625;1;4691;VERDADERO;FALSO;-56;;;
29605;29625;0;4692;VERDADERO;VERDADERO;-20;;;
29605;29625;0;4693;VERDADERO;VERDADERO;-20;;;
29605;29645;1;4694;VERDADERO;VERDADERO;-40;;;
29605;29645;0;4695;VERDADERO;VERDADERO;-40;;;
29605;29665;0;4696;VERDADERO;FALSO;-60;;;
29637;29665;0;4697;VERDADERO;VERDADERO;-28;;;
29637;29665;0;4698;VERDADERO;VERDADERO;-28;;;
29637;29665;0;4699;VERDADERO;VERDADERO;-28;;;
29637;29665;0;4700;VERDADERO;VERDADERO;-28;;;
29637;29685;0;4701;VERDADERO;VERDADERO;-48;;;
29673;29685;0;4702;VERDADERO;VERDADERO;-12;;;
29673;29685;0;4703;VERDADERO;VERDADERO;-12;;;
29673;29705;0;4704;VERDADERO;VERDADERO;-32;;;
29673;29705;0;4705;VERDADERO;VERDADERO;-32;;;
29673;29725;0;4706;VERDADERO;FALSO;-52;;;
29705;29725;0;4707;VERDADERO;VERDADERO;-20;;;
29705;29725;0;4708;VERDADERO;VERDADERO;-20;;;
29705;29745;0;4709;VERDADERO;VERDADERO;-40;;;
29705;29745;0;4710;VERDADERO;VERDADERO;-40;;;
29705;29765;0;4711;VERDADERO;FALSO;-60;;;
29737;29765;0;4712;VERDADERO;VERDADERO;-28;;;
29737;29765;0;4713;VERDADERO;VERDADERO;-28;;;
29737;29765;0;4714;VERDADERO;VERDADERO;-28;;;
29737;29765;0;4715;VERDADERO;VERDADERO;-28;;;
29737;29785;0;4716;VERDADERO;VERDADERO;-48;;;
29737;29785;0;4717;VERDADERO;VERDADERO;-48;;;
29772;29805;0;4718;VERDADERO;VERDADERO;-33;;;
29772;29805;0;4719;VERDADERO;VERDADERO;-33;;;
29772;29805;0;4720;VERDADERO;VERDADERO;-33;;;
29772;29805;0;4721;VERDADERO;VERDADERO;-33;;;
29772;29805;0;4722;VERDADERO;VERDADERO;-33;;;
29805;29825;0;4723;VERDADERO;VERDADERO;-20;;;
29805;29825;0;4724;VERDADERO;VERDADERO;-20;;;
29805;29825;0;4725;VERDADERO;VERDADERO;-20;;;
29805;29845;0;4726;VERDADERO;VERDADERO;-40;;;
29805;29845;0;4727;VERDADERO;VERDADERO;-40;;;
29836;29865;0;4728;VERDADERO;VERDADERO;-29;;;
29836;29865;0;4729;VERDADERO;VERDADERO;-29;;;
29836;29865;0;4730;VERDADERO;VERDADERO;-29;;;
29836;29885;0;4731;VERDADERO;VERDADERO;-49;;;
29836;29885;0;4732;VERDADERO;VERDADERO;-49;;;
29869;29905;0;4733;VERDADERO;VERDADERO;-36;;;
29869;29905;0;4734;VERDADERO;VERDADERO;-36;;;
29869;29905;0;4735;VERDADERO;VERDADERO;-36;;;
29869;29905;0;4736;VERDADERO;VERDADERO;-36;;;
29869;29905;0;4737;VERDADERO;VERDADERO;-36;;;
29901;29905;0;4738;VERDADERO;VERDADERO;-4;;;
29901;29905;0;4739;VERDADERO;VERDADERO;-4;;;
29901;29925;0;4740;VERDADERO;VERDADERO;-24;;;
29901;29925;0;4741;VERDADERO;VERDADERO;-24;;;
29901;29925;0;4742;VERDADERO;VERDADERO;-24;;;
29933;29945;0;4743;VERDADERO;VERDADERO;-12;;;
29933;29945;0;4744;VERDADERO;VERDADERO;-12;;;
29933;29945;0;4745;VERDADERO;VERDADERO;-12;;;
29933;29945;0;4746;VERDADERO;VERDADERO;-12;;;
29933;29965;0;4747;VERDADERO;VERDADERO;-32;;;
29965;29965;0;4748;VERDADERO;VERDADERO;0;;;
29965;29965;0;4749;VERDADERO;VERDADERO;0;;;
29965;29985;0;4750;VERDADERO;VERDADERO;-20;;;
29965;29985;0;4751;VERDADERO;VERDADERO;-20;;;
29965;30005;0;4752;VERDADERO;VERDADERO;-40;;;
29965;30005;0;4753;VERDADERO;VERDADERO;-40;;;
30001;30005;0;4754;VERDADERO;VERDADERO;-4;;;
30001;30025;0;4755;VERDADERO;VERDADERO;-24;;;
30001;30025;0;4756;VERDADERO;VERDADERO;-24;;;
30001;30045;1;4757;VERDADERO;VERDADERO;-44;;;
30033;30045;0;4758;VERDADERO;VERDADERO;-12;;;
30033;30045;0;4759;VERDADERO;VERDADERO;-12;;;
30033;30045;0;4760;VERDADERO;VERDADERO;-12;;;
30033;30045;0;4761;VERDADERO;VERDADERO;-12;;;
30033;30045;0;4762;VERDADERO;VERDADERO;-12;;;
30033;30065;1;4763;VERDADERO;VERDADERO;-32;;;
30065;30065;0;4764;VERDADERO;VERDADERO;0;;;
30065;30085;0;4765;VERDADERO;VERDADERO;-20;;;
30065;30085;0;4766;VERDADERO;VERDADERO;-20;;;
30065;30105;0;4767;VERDADERO;VERDADERO;-40;;;
30065;30105;0;4768;VERDADERO;VERDADERO;-40;;;
30065;30105;0;4769;VERDADERO;VERDADERO;-40;;;
30065;30105;0;4770;VERDADERO;VERDADERO;-40;;;
30111;30105;0;4771;VERDADERO;VERDADERO;6;;;
30111;30125;1;4772;VERDADERO;VERDADERO;-14;;;
30111;30125;0;4773;VERDADERO;VERDADERO;-14;;;
30111;30145;0;4774;VERDADERO;VERDADERO;-34;;;
30135;30145;0;4775;VERDADERO;VERDADERO;-10;;;
30135;30145;0;4776;VERDADERO;VERDADERO;-10;;;
30135;30165;1;4777;VERDADERO;VERDADERO;-30;;;
30135;30165;0;4778;VERDADERO;VERDADERO;-30;;;
30165;30185;0;4779;VERDADERO;VERDADERO;-20;;;
30165;30185;0;4780;VERDADERO;VERDADERO;-20;;;
30165;30185;0;4781;VERDADERO;VERDADERO;-20;;;
30165;30205;0;4782;VERDADERO;VERDADERO;-40;;;
30165;30205;0;4783;VERDADERO;VERDADERO;-40;;;
30165;30205;0;4784;VERDADERO;VERDADERO;-40;;;
30201;30205;0;4785;VERDADERO;VERDADERO;-4;;;
30201;30205;0;4786;VERDADERO;VERDADERO;-4;;;
30201;30225;0;4787;VERDADERO;VERDADERO;-24;;;
30201;30225;0;4788;VERDADERO;VERDADERO;-24;;;
30201;30245;0;4789;VERDADERO;VERDADERO;-44;;;
30201;30245;0;4790;VERDADERO;VERDADERO;-44;;;
30237;30245;0;4791;VERDADERO;VERDADERO;-8;;;
30237;30245;0;4792;VERDADERO;VERDADERO;-8;;;
30237;30245;0;4793;VERDADERO;VERDADERO;-8;;;
30237;30265;0;4794;VERDADERO;VERDADERO;-28;;;
30237;30265;0;4795;VERDADERO;VERDADERO;-28;;;
30269;30286;0;4796;VERDADERO;VERDADERO;-17;;;
30269;30286;0;4797;VERDADERO;VERDADERO;-17;;;
30269;30286;0;4798;VERDADERO;VERDADERO;-17;;;
30269;30306;0;4799;VERDADERO;VERDADERO;-37;;;
30301;30306;0;4800;VERDADERO;VERDADERO;-5;;;
30301;30306;0;4801;VERDADERO;VERDADERO;-5;;;
30301;30306;0;4802;VERDADERO;VERDADERO;-5;;;
30301;30326;0;4803;VERDADERO;VERDADERO;-25;;;
30301;30326;0;4804;VERDADERO;VERDADERO;-25;;;
30301;30326;0;4805;VERDADERO;VERDADERO;-25;;;
30337;30346;0;4806;VERDADERO;VERDADERO;-9;;;
30337;30346;0;4807;VERDADERO;VERDADERO;-9;;;
30337;30346;0;4808;VERDADERO;VERDADERO;-9;;;
30337;30346;0;4809;VERDADERO;VERDADERO;-9;;;
30337;30346;0;4810;VERDADERO;VERDADERO;-9;;;
30337;30346;0;4811;VERDADERO;VERDADERO;-9;;;
30369;30366;0;4812;VERDADERO;VERDADERO;3;;;
30369;30366;0;4813;VERDADERO;VERDADERO;3;;;
30369;30386;0;4814;VERDADERO;VERDADERO;-17;;;
30369;30386;0;4815;VERDADERO;VERDADERO;-17;;;
30369;30386;0;4816;VERDADERO;VERDADERO;-17;;;
30400;30406;1;4817;VERDADERO;VERDADERO;-6;;;
30400;30406;0;4818;VERDADERO;VERDADERO;-6;;;
30400;30426;0;4819;VERDADERO;VERDADERO;-26;;;
30400;30426;0;4820;VERDADERO;VERDADERO;-26;;;
30400;30446;0;4821;VERDADERO;VERDADERO;-46;;;
30437;30446;0;4822;VERDADERO;VERDADERO;-9;;;
30437;30446;0;4823;VERDADERO;VERDADERO;-9;;;
30437;30466;0;4824;VERDADERO;VERDADERO;-29;;;
30437;30466;0;4825;VERDADERO;VERDADERO;-29;;;
30437;30466;0;4826;VERDADERO;VERDADERO;-29;;;
30469;30486;0;4827;VERDADERO;VERDADERO;-17;;;
30469;30486;0;4828;VERDADERO;VERDADERO;-17;;;
30469;30486;0;4829;VERDADERO;VERDADERO;-17;;;
30469;30506;1;4830;VERDADERO;VERDADERO;-37;;;
30469;30506;0;4831;VERDADERO;VERDADERO;-37;;;
30501;30526;0;4832;VERDADERO;VERDADERO;-25;;;
30501;30526;0;4833;VERDADERO;VERDADERO;-25;;;
30501;30526;0;4834;VERDADERO;VERDADERO;-25;;;
30501;30546;0;4835;VERDADERO;VERDADERO;-45;;;
30501;30546;0;4836;VERDADERO;VERDADERO;-45;;;
30501;30566;0;4837;VERDADERO;FALSO;-65;;;
30537;30566;0;4838;VERDADERO;VERDADERO;-29;;;
30537;30566;0;4839;VERDADERO;VERDADERO;-29;;;
30537;30566;0;4840;VERDADERO;VERDADERO;-29;;;
30537;30566;0;4841;VERDADERO;VERDADERO;-29;;;
30537;30566;0;4842;VERDADERO;VERDADERO;-29;;;
30569;30586;0;4843;VERDADERO;VERDADERO;-17;;;
30569;30586;0;4844;VERDADERO;VERDADERO;-17;;;
30569;30606;0;4845;VERDADERO;VERDADERO;-37;;;
30569;30606;0;4846;VERDADERO;VERDADERO;-37;;;
30569;30606;0;4847;VERDADERO;VERDADERO;-37;;;
30601;30606;0;4848;VERDADERO;VERDADERO;-5;;;
30601;30606;0;4849;VERDADERO;VERDADERO;-5;;;
30601;30606;0;4850;VERDADERO;VERDADERO;-5;;;
30601;30626;0;4851;VERDADERO;VERDADERO;-25;;;
30601;30626;0;4852;VERDADERO;VERDADERO;-25;;;
30601;30626;0;4853;VERDADERO;VERDADERO;-25;;;
30636;30646;1;4854;VERDADERO;VERDADERO;-10;;;
30636;30646;0;4855;VERDADERO;VERDADERO;-10;;;
30636;30666;0;4856;VERDADERO;VERDADERO;-30;;;
30636;30666;0;4857;VERDADERO;VERDADERO;-30;;;
30669;30666;0;4858;VERDADERO;VERDADERO;3;;;
30669;30686;0;4859;VERDADERO;VERDADERO;-17;;;
30669;30686;0;4860;VERDADERO;VERDADERO;-17;;;
30669;30706;0;4861;VERDADERO;VERDADERO;-37;;;
30669;30706;0;4862;VERDADERO;VERDADERO;-37;;;
30669;30706;0;4863;VERDADERO;VERDADERO;-37;;;
30702;30706;0;4864;VERDADERO;VERDADERO;-4;;;
30702;30706;0;4865;VERDADERO;VERDADERO;-4;;;
30702;30706;0;4866;VERDADERO;VERDADERO;-4;;;
30702;30706;0;4867;VERDADERO;VERDADERO;-4;;;
30702;30706;0;4868;VERDADERO;VERDADERO;-4;;;
30737;30726;0;4869;VERDADERO;VERDADERO;11;;;
30737;30726;0;4870;VERDADERO;VERDADERO;11;;;
30737;30726;0;4871;VERDADERO;VERDADERO;11;;;
30737;30747;0;4872;VERDADERO;VERDADERO;-10;;;
30737;30747;0;4873;VERDADERO;VERDADERO;-10;;;
30737;30767;0;4874;VERDADERO;VERDADERO;-30;;;
30769;30767;0;4875;VERDADERO;VERDADERO;2;;;
30769;30767;0;4876;VERDADERO;VERDADERO;2;;;
30769;30787;0;4877;VERDADERO;VERDADERO;-18;;;
30769;30787;0;4878;VERDADERO;VERDADERO;-18;;;
30801;30807;0;4879;VERDADERO;VERDADERO;-6;;;
30801;30807;0;4880;VERDADERO;VERDADERO;-6;;;
30801;30807;0;4881;VERDADERO;VERDADERO;-6;;;
30801;30827;0;4882;VERDADERO;VERDADERO;-26;;;
30801;30827;0;4883;VERDADERO;VERDADERO;-26;;;
30801;30847;0;4884;VERDADERO;VERDADERO;-46;;;
30837;30847;0;4885;VERDADERO;VERDADERO;-10;;;
30837;30847;0;4886;VERDADERO;VERDADERO;-10;;;
30837;30867;0;4887;VERDADERO;VERDADERO;-30;;;
30837;30867;0;4888;VERDADERO;VERDADERO;-30;;;
30837;30867;0;4889;VERDADERO;VERDADERO;-30;;;
30869;30867;0;4890;VERDADERO;VERDADERO;2;;;
30869;30887;0;4891;VERDADERO;VERDADERO;-18;;;
30869;30887;0;4892;VERDADERO;VERDADERO;-18;;;
30869;30887;0;4893;VERDADERO;VERDADERO;-18;;;
30869;30907;0;4894;VERDADERO;VERDADERO;-38;;;
30901;30907;0;4895;VERDADERO;VERDADERO;-6;;;
30901;30927;0;4896;VERDADERO;VERDADERO;-26;;;
30901;30927;0;4897;VERDADERO;VERDADERO;-26;;;
30901;30927;0;4898;VERDADERO;VERDADERO;-26;;;
30901;30927;0;4899;VERDADERO;VERDADERO;-26;;;
30901;30947;0;4900;VERDADERO;VERDADERO;-46;;;
30937;30947;0;4901;VERDADERO;VERDADERO;-10;;;
30937;30967;0;4902;VERDADERO;VERDADERO;-30;;;
30937;30967;0;4903;VERDADERO;VERDADERO;-30;;;
30937;30967;0;4904;VERDADERO;VERDADERO;-30;;;
30937;30967;0;4905;VERDADERO;VERDADERO;-30;;;
30968;30967;0;4906;VERDADERO;VERDADERO;1;;;
30968;30987;0;4907;VERDADERO;VERDADERO;-19;;;
30968;30987;0;4908;VERDADERO;VERDADERO;-19;;;
30968;30987;0;4909;VERDADERO;VERDADERO;-19;;;
30968;31007;0;4910;VERDADERO;VERDADERO;-39;;;
31001;31007;0;4911;VERDADERO;VERDADERO;-6;;;
31001;31027;0;4912;VERDADERO;VERDADERO;-26;;;
31001;31027;0;4913;VERDADERO;VERDADERO;-26;;;
31001;31027;0;4914;VERDADERO;VERDADERO;-26;;;
31001;31047;0;4915;VERDADERO;VERDADERO;-46;;;
31001;31047;0;4916;VERDADERO;VERDADERO;-46;;;
31037;31067;1;4917;VERDADERO;VERDADERO;-30;;;
31037;31067;0;4918;VERDADERO;VERDADERO;-30;;;
31037;31067;0;4919;VERDADERO;VERDADERO;-30;;;
31037;31067;0;4920;VERDADERO;VERDADERO;-30;;;
31037;31067;0;4921;VERDADERO;VERDADERO;-30;;;
31069;31087;1;4922;VERDADERO;VERDADERO;-18;;;
31069;31087;0;4923;VERDADERO;VERDADERO;-18;;;
31069;31107;0;4924;VERDADERO;VERDADERO;-38;;;
31069;31107;0;4925;VERDADERO;VERDADERO;-38;;;
31069;31107;0;4926;VERDADERO;VERDADERO;-38;;;
31105;31107;0;4927;VERDADERO;VERDADERO;-2;;;
31105;31107;0;4928;VERDADERO;VERDADERO;-2;;;
31105;31107;0;4929;VERDADERO;VERDADERO;-2;;;
31105;31127;0;4930;VERDADERO;VERDADERO;-22;;;
31105;31127;0;4931;VERDADERO;VERDADERO;-22;;;
31137;31127;0;4932;VERDADERO;VERDADERO;10;;;
31137;31148;0;4933;VERDADERO;VERDADERO;-11;;;
31137;31148;0;4934;VERDADERO;VERDADERO;-11;;;
31137;31168;0;4935;VERDADERO;VERDADERO;-31;;;
31137;31168;0;4936;VERDADERO;VERDADERO;-31;;;
31169;31168;0;4937;VERDADERO;VERDADERO;1;;;
31169;31188;0;4938;VERDADERO;VERDADERO;-19;;;
31169;31188;0;4939;VERDADERO;VERDADERO;-19;;;
31169;31208;0;4940;VERDADERO;VERDADERO;-39;;;
31169;31208;0;4941;VERDADERO;VERDADERO;-39;;;
31169;31208;0;4942;VERDADERO;VERDADERO;-39;;;
31205;31208;0;4943;VERDADERO;VERDADERO;-3;;;
31205;31228;0;4944;VERDADERO;VERDADERO;-23;;;
31205;31228;0;4945;VERDADERO;VERDADERO;-23;;;
31205;31248;0;4946;VERDADERO;VERDADERO;-43;;;
31205;31248;0;4947;VERDADERO;VERDADERO;-43;;;
31237;31248;0;4948;VERDADERO;VERDADERO;-11;;;
31237;31248;0;4949;VERDADERO;VERDADERO;-11;;;
31237;31248;0;4950;VERDADERO;VERDADERO;-11;;;
31237;31268;0;4951;VERDADERO;VERDADERO;-31;;;
31237;31268;0;4952;VERDADERO;VERDADERO;-31;;;
31269;31268;0;4953;VERDADERO;VERDADERO;1;;;
31269;31289;0;4954;VERDADERO;VERDADERO;-20;;;
31269;31289;0;4955;VERDADERO;VERDADERO;-20;;;
31269;31309;0;4956;VERDADERO;VERDADERO;-40;;;
31269;31309;0;4957;VERDADERO;VERDADERO;-40;;;
31269;31309;0;4958;VERDADERO;VERDADERO;-40;;;
31305;31329;1;4959;VERDADERO;VERDADERO;-24;;;
31305;31329;0;4960;VERDADERO;VERDADERO;-24;;;
31305;31349;0;4961;VERDADERO;VERDADERO;-44;;;
31305;31349;0;4962;VERDADERO;VERDADERO;-44;;;
31305;31349;0;4963;VERDADERO;VERDADERO;-44;;;
31337;31349;0;4964;VERDADERO;VERDADERO;-12;;;
31337;31349;0;4965;VERDADERO;VERDADERO;-12;;;
31337;31369;0;4966;VERDADERO;VERDADERO;-32;;;
31337;31369;0;4967;VERDADERO;VERDADERO;-32;;;
31337;31389;0;4968;VERDADERO;FALSO;-52;;;
31369;31389;0;4969;VERDADERO;VERDADERO;-20;;;
31369;31389;0;4970;VERDADERO;VERDADERO;-20;;;
31369;31389;0;4971;VERDADERO;VERDADERO;-20;;;
31369;31389;0;4972;VERDADERO;VERDADERO;-20;;;
31369;31409;0;4973;VERDADERO;VERDADERO;-40;;;
31369;31409;0;4974;VERDADERO;VERDADERO;-40;;;
31405;31409;0;4975;VERDADERO;VERDADERO;-4;;;
31405;31429;0;4976;VERDADERO;VERDADERO;-24;;;
31405;31429;0;4977;VERDADERO;VERDADERO;-24;;;
31405;31449;0;4978;VERDADERO;VERDADERO;-44;;;
31405;31449;0;4979;VERDADERO;VERDADERO;-44;;;
31437;31449;0;4980;VERDADERO;VERDADERO;-12;;;
31437;31469;0;4981;VERDADERO;VERDADERO;-32;;;
31437;31469;0;4982;VERDADERO;VERDADERO;-32;;;
31437;31489;1;4983;VERDADERO;FALSO;-52;;;
31437;31489;0;4984;VERDADERO;FALSO;-52;;;
31469;31489;0;4985;VERDADERO;VERDADERO;-20;;;
31469;31489;0;4986;VERDADERO;VERDADERO;-20;;;
31469;31509;0;4987;VERDADERO;VERDADERO;-40;;;
31469;31509;0;4988;VERDADERO;VERDADERO;-40;;;
31469;31529;0;4989;VERDADERO;FALSO;-60;;;
31505;31529;0;4990;VERDADERO;VERDADERO;-24;;;
31505;31529;0;4991;VERDADERO;VERDADERO;-24;;;
31505;31529;0;4992;VERDADERO;VERDADERO;-24;;;
31505;31529;0;4993;VERDADERO;VERDADERO;-24;;;
31505;31549;0;4994;VERDADERO;VERDADERO;-44;;;
31537;31549;0;4995;VERDADERO;VERDADERO;-12;;;
31537;31549;0;4996;VERDADERO;VERDADERO;-12;;;
31537;31569;0;4997;VERDADERO;VERDADERO;-32;;;
31537;31569;0;4998;VERDADERO;VERDADERO;-32;;;
31537;31569;0;4999;VERDADERO;VERDADERO;-32;;;
31569;31569;0;5000;VERDADERO;VERDADERO;0;;;
31569;31569;0;5001;VERDADERO;VERDADERO;0;;;
31569;31569;0;5002;VERDADERO;VERDADERO;0;;;
31569;31589;0;5003;VERDADERO;VERDADERO;-20;;;
31569;31589;0;5004;VERDADERO;VERDADERO;-20;;;
31569;31610;0;5005;VERDADERO;VERDADERO;-41;;;
31605;31610;0;5006;VERDADERO;VERDADERO;-5;;;
31605;31610;0;5007;VERDADERO;VERDADERO;-5;;;
31605;31630;0;5008;VERDADERO;VERDADERO;-25;;;
31605;31630;0;5009;VERDADERO;VERDADERO;-25;;;
31605;31630;0;5010;VERDADERO;VERDADERO;-25;;;
31637;31630;0;5011;VERDADERO;VERDADERO;7;;;
31637;31650;0;5012;VERDADERO;VERDADERO;-13;;;
31637;31650;0;5013;VERDADERO;VERDADERO;-13;;;
31637;31670;0;5014;VERDADERO;VERDADERO;-33;;;
31637;31670;0;5015;VERDADERO;VERDADERO;-33;;;
31669;31670;0;5016;VERDADERO;VERDADERO;-1;;;
31669;31690;0;5017;VERDADERO;VERDADERO;-21;;;
31669;31690;0;5018;VERDADERO;VERDADERO;-21;;;
31669;31690;0;5019;VERDADERO;VERDADERO;-21;;;
31669;31690;0;5020;VERDADERO;VERDADERO;-21;;;
31669;31690;0;5021;VERDADERO;VERDADERO;-21;;;
31705;31690;0;5022;VERDADERO;VERDADERO;15;;;
31705;31690;0;5023;VERDADERO;VERDADERO;15;;;
31705;31690;0;5024;VERDADERO;VERDADERO;15;;;
31705;31690;0;5025;VERDADERO;VERDADERO;15;;;
31705;31690;0;5026;VERDADERO;VERDADERO;15;;;
31737;31690;0;5027;VERDADERO;VERDADERO;47;;;
31737;31690;0;5028;VERDADERO;VERDADERO;47;;;
31737;31690;0;5029;VERDADERO;VERDADERO;47;;;
31737;31690;0;5030;VERDADERO;VERDADERO;47;;;
31737;31690;0;5031;VERDADERO;VERDADERO;47;;;
31769;31690;0;5032;FALSO;VERDADERO;79;;;
31769;31690;0;5033;FALSO;VERDADERO;79;;;
31769;31690;0;5034;FALSO;VERDADERO;79;;;
31769;31690;0;5035;FALSO;VERDADERO;79;;;
31769;31690;0;5036;FALSO;VERDADERO;79;;;
31769;31690;0;5037;FALSO;VERDADERO;79;;;
31805;31710;0;5038;FALSO;VERDADERO;95;;;
31805;31710;0;5039;FALSO;VERDADERO;95;;;
31805;31730;1;5040;FALSO;VERDADERO;75;;;
31805;31730;0;5041;FALSO;VERDADERO;75;;;
31805;31730;0;5042;FALSO;VERDADERO;75;;;
31838;31730;0;5043;FALSO;VERDADERO;108;;;
31838;31730;0;5044;FALSO;VERDADERO;108;;;
31838;31730;0;5045;FALSO;VERDADERO;108;;;
31838;31730;0;5046;FALSO;VERDADERO;108;;;
31838;31750;0;5047;FALSO;VERDADERO;88;;;
31868;31750;0;5048;FALSO;VERDADERO;118;;;
31868;31750;0;5049;FALSO;VERDADERO;118;;;
31868;31770;0;5050;FALSO;VERDADERO;98;;;
31868;31770;0;5051;FALSO;VERDADERO;98;;;
31868;31790;0;5052;FALSO;VERDADERO;78;;;
31868;31790;0;5053;FALSO;VERDADERO;78;;;
31908;31790;0;5054;FALSO;VERDADERO;118;;;
31908;31810;0;5055;FALSO;VERDADERO;98;;;
31908;31810;0;5056;FALSO;VERDADERO;98;;;
31908;31830;0;5057;FALSO;VERDADERO;78;;;
31908;31830;0;5058;FALSO;VERDADERO;78;;;
31937;31830;0;5059;FALSO;VERDADERO;107;;;
31937;31850;1;5060;FALSO;VERDADERO;87;;;
31937;31850;0;5061;FALSO;VERDADERO;87;;;
31937;31870;0;5062;FALSO;VERDADERO;67;;;
31937;31870;0;5063;FALSO;VERDADERO;67;;;
31969;31870;0;5064;FALSO;VERDADERO;99;;;
31969;31890;0;5065;FALSO;VERDADERO;79;;;
31969;31890;0;5066;FALSO;VERDADERO;79;;;
31969;31890;0;5067;FALSO;VERDADERO;79;;;
31969;31890;0;5068;FALSO;VERDADERO;79;;;
31969;31890;0;5069;FALSO;VERDADERO;79;;;
32005;31890;0;5070;FALSO;VERDADERO;115;;;
32005;31890;0;5071;FALSO;VERDADERO;115;;;
32005;31890;0;5072;FALSO;VERDADERO;115;;;
32005;31890;0;5073;FALSO;VERDADERO;115;;;
32005;31890;0;5074;FALSO;VERDADERO;115;;;
32037;31890;0;5075;FALSO;VERDADERO;147;;;
32037;31890;0;5076;FALSO;VERDADERO;147;;;
32037;31890;0;5077;FALSO;VERDADERO;147;;;
32037;31890;0;5078;FALSO;VERDADERO;147;;;
32037;31890;0;5079;FALSO;VERDADERO;147;;;
32069;31890;0;5080;FALSO;VERDADERO;179;;;
32069;31890;0;5081;FALSO;VERDADERO;179;;;
32069;31890;0;5082;FALSO;VERDADERO;179;;;
32069;31890;0;5083;FALSO;VERDADERO;179;;;
32069;31890;0;5084;FALSO;VERDADERO;179;;;
32069;31910;1;5085;FALSO;VERDADERO;159;;;
32105;31910;0;5086;FALSO;VERDADERO;195;;;
32105;31910;0;5087;FALSO;VERDADERO;195;;;
32105;31930;0;5088;FALSO;VERDADERO;175;;;
32105;31930;0;5089;FALSO;VERDADERO;175;;;
32105;31950;0;5090;FALSO;VERDADERO;155;;;
32136;31950;0;5091;FALSO;VERDADERO;186;;;
32136;31950;0;5092;FALSO;VERDADERO;186;;;
32136;31950;0;5093;FALSO;VERDADERO;186;;;
32136;31970;0;5094;FALSO;VERDADERO;166;;;
32136;31970;0;5095;FALSO;VERDADERO;166;;;
32169;31990;0;5096;FALSO;VERDADERO;179;;;
32169;31990;0;5097;FALSO;VERDADERO;179;;;
32169;31990;0;5098;FALSO;VERDADERO;179;;;
32169;32010;0;5099;FALSO;VERDADERO;159;;;
32169;32010;0;5100;FALSO;VERDADERO;159;;;
32205;32210;0;5101;VERDADERO;VERDADERO;-5;;;
32237;32250;1;5102;VERDADERO;VERDADERO;-13;;;
32269;32270;1;5103;VERDADERO;VERDADERO;-1;;;
32305;32310;1;5104;VERDADERO;VERDADERO;-5;;;
32337;32350;0;5105;VERDADERO;VERDADERO;-13;;;
32369;32370;0;5106;VERDADERO;VERDADERO;-1;;;
32401;32410;1;5107;VERDADERO;VERDADERO;-9;;;
32437;32450;1;5108;VERDADERO;VERDADERO;-13;;;
32469;32470;0;5109;VERDADERO;VERDADERO;-1;;;
32501;32510;1;5110;VERDADERO;VERDADERO;-9;;;
32533;32550;0;5111;VERDADERO;VERDADERO;-17;;;
32565;32570;1;5112;VERDADERO;VERDADERO;-5;;;
32601;32611;1;5113;VERDADERO;VERDADERO;-10;;;
32633;32651;1;5114;VERDADERO;VERDADERO;-18;;;
32664;32671;1;5115;VERDADERO;VERDADERO;-7;;;
32701;32711;0;5116;VERDADERO;VERDADERO;-10;;;
32733;32751;1;5117;VERDADERO;VERDADERO;-18;;;
32765;32771;1;5118;VERDADERO;VERDADERO;-6;;;
32797;32811;1;5119;VERDADERO;VERDADERO;-14;;;
32830;32831;1;5120;VERDADERO;VERDADERO;-1;;;
32865;32871;0;5121;VERDADERO;VERDADERO;-6;;;
32897;32911;1;5122;VERDADERO;VERDADERO;-14;;;
32933;32951;1;5123;VERDADERO;VERDADERO;-18;;;
32964;32971;0;5124;VERDADERO;VERDADERO;-7;;;
33001;33011;0;5125;VERDADERO;VERDADERO;-10;;;
33033;33051;1;5126;VERDADERO;VERDADERO;-18;;;
33065;33071;1;5127;VERDADERO;VERDADERO;-6;;;
33065;33091;0;5128;VERDADERO;VERDADERO;-26;;;
33101;33111;0;5129;VERDADERO;VERDADERO;-10;;;
33101;33131;0;5130;VERDADERO;VERDADERO;-30;;;
33101;33131;0;5131;VERDADERO;VERDADERO;-30;;;
33101;33131;0;5132;VERDADERO;VERDADERO;-30;;;
33101;33151;0;5133;VERDADERO;FALSO;-50;;;
33133;33151;0;5134;VERDADERO;VERDADERO;-18;;;
33133;33171;0;5135;VERDADERO;VERDADERO;-38;;;
33133;33171;0;5136;VERDADERO;VERDADERO;-38;;;
33133;33171;0;5137;VERDADERO;VERDADERO;-38;;;
33133;33171;0;5138;VERDADERO;VERDADERO;-38;;;
33165;33171;0;5139;VERDADERO;VERDADERO;-6;;;
33165;33191;0;5140;VERDADERO;VERDADERO;-26;;;
33165;33191;0;5141;VERDADERO;VERDADERO;-26;;;
33165;33211;0;5142;VERDADERO;VERDADERO;-46;;;
33165;33211;0;5143;VERDADERO;VERDADERO;-46;;;
33197;33211;0;5144;VERDADERO;VERDADERO;-14;;;
33197;33211;0;5145;VERDADERO;VERDADERO;-14;;;
33197;33211;0;5146;VERDADERO;VERDADERO;-14;;;
33197;33231;0;5147;VERDADERO;VERDADERO;-34;;;
33197;33231;0;5148;VERDADERO;VERDADERO;-34;;;
33229;33231;0;5149;VERDADERO;VERDADERO;-2;;;
33229;33251;1;5150;VERDADERO;VERDADERO;-22;;;
33229;33251;0;5151;VERDADERO;VERDADERO;-22;;;
33229;33271;0;5152;VERDADERO;VERDADERO;-42;;;
33229;33271;0;5153;VERDADERO;VERDADERO;-42;;;
33229;33271;0;5154;VERDADERO;VERDADERO;-42;;;
33265;33291;0;5155;VERDADERO;VERDADERO;-26;;;
33265;33291;0;5156;VERDADERO;VERDADERO;-26;;;
33265;33311;0;5157;VERDADERO;VERDADERO;-46;;;
33265;33311;0;5158;VERDADERO;VERDADERO;-46;;;
33265;33311;0;5159;VERDADERO;VERDADERO;-46;;;
33297;33311;0;5160;VERDADERO;VERDADERO;-14;;;
33297;33311;0;5161;VERDADERO;VERDADERO;-14;;;
33297;33331;0;5162;VERDADERO;VERDADERO;-34;;;
33297;33331;0;5163;VERDADERO;VERDADERO;-34;;;
33297;33331;0;5164;VERDADERO;VERDADERO;-34;;;
33329;33351;1;5165;VERDADERO;VERDADERO;-22;;;
33329;33351;0;5166;VERDADERO;VERDADERO;-22;;;
33329;33351;0;5167;VERDADERO;VERDADERO;-22;;;
33329;33351;0;5168;VERDADERO;VERDADERO;-22;;;
33329;33371;0;5169;VERDADERO;VERDADERO;-42;;;
33329;33371;0;5170;VERDADERO;VERDADERO;-42;;;
33365;33391;0;5171;VERDADERO;VERDADERO;-26;;;
33365;33391;0;5172;VERDADERO;VERDADERO;-26;;;
33365;33391;0;5173;VERDADERO;VERDADERO;-26;;;
33365;33411;0;5174;VERDADERO;VERDADERO;-46;;;
33365;33411;0;5175;VERDADERO;VERDADERO;-46;;;
33397;33411;0;5176;VERDADERO;VERDADERO;-14;;;
33397;33431;0;5177;VERDADERO;VERDADERO;-34;;;
33397;33431;0;5178;VERDADERO;VERDADERO;-34;;;
33397;33451;0;5179;VERDADERO;FALSO;-54;;;
33397;33451;0;5180;VERDADERO;FALSO;-54;;;
33433;33451;0;5181;VERDADERO;VERDADERO;-18;;;
33433;33451;0;5182;VERDADERO;VERDADERO;-18;;;
33433;33451;0;5183;VERDADERO;VERDADERO;-18;;;
33433;33451;0;5184;VERDADERO;VERDADERO;-18;;;
33433;33471;0;5185;VERDADERO;VERDADERO;-38;;;
33433;33471;0;5186;VERDADERO;VERDADERO;-38;;;
33466;33491;0;5187;VERDADERO;VERDADERO;-25;;;
33466;33491;0;5188;VERDADERO;VERDADERO;-25;;;
33466;33491;0;5189;VERDADERO;VERDADERO;-25;;;
33466;33491;0;5190;VERDADERO;VERDADERO;-25;;;
33466;33491;0;5191;VERDADERO;VERDADERO;-25;;;
33501;33491;0;5192;VERDADERO;VERDADERO;10;;;
33501;33511;0;5193;VERDADERO;VERDADERO;-10;;;
33501;33511;0;5194;VERDADERO;VERDADERO;-10;;;
33501;33531;0;5195;VERDADERO;VERDADERO;-30;;;
33501;33531;0;5196;VERDADERO;VERDADERO;-30;;;
33533;33531;0;5197;VERDADERO;VERDADERO;2;;;
33533;33551;0;5198;VERDADERO;VERDADERO;-18;;;
33533;33551;0;5199;VERDADERO;VERDADERO;-18;;;
33533;33551;0;5200;VERDADERO;VERDADERO;-18;;;
33533;33571;0;5201;VERDADERO;VERDADERO;-38;;;
33533;33571;0;5202;VERDADERO;VERDADERO;-38;;;
33570;33571;0;5203;VERDADERO;VERDADERO;-1;;;
33570;33591;0;5204;VERDADERO;VERDADERO;-21;;;
33570;33591;0;5205;VERDADERO;VERDADERO;-21;;;
33570;33611;0;5206;VERDADERO;VERDADERO;-41;;;
33570;33611;0;5207;VERDADERO;VERDADERO;-41;;;
33602;33611;0;5208;VERDADERO;VERDADERO;-9;;;
33602;33611;0;5209;VERDADERO;VERDADERO;-9;;;
33602;33631;0;5210;VERDADERO;VERDADERO;-29;;;
33602;33631;0;5211;VERDADERO;VERDADERO;-29;;;
33602;33651;0;5212;VERDADERO;VERDADERO;-49;;;
33637;33651;0;5213;VERDADERO;VERDADERO;-14;;;
33637;33651;0;5214;VERDADERO;VERDADERO;-14;;;
33637;33651;0;5215;VERDADERO;VERDADERO;-14;;;
33637;33651;0;5216;VERDADERO;VERDADERO;-14;;;
33637;33671;0;5217;VERDADERO;VERDADERO;-34;;;
33668;33671;0;5218;VERDADERO;VERDADERO;-3;;;
33668;33671;0;5219;VERDADERO;VERDADERO;-3;;;
33668;33692;0;5220;VERDADERO;VERDADERO;-24;;;
33668;33692;0;5221;VERDADERO;VERDADERO;-24;;;
33668;33712;0;5222;VERDADERO;VERDADERO;-44;;;
33700;33712;0;5223;VERDADERO;VERDADERO;-12;;;
33700;33712;0;5224;VERDADERO;VERDADERO;-12;;;
33700;33732;0;5225;VERDADERO;VERDADERO;-32;;;
33700;33732;0;5226;VERDADERO;VERDADERO;-32;;;
33700;33732;0;5227;VERDADERO;VERDADERO;-32;;;
33700;33752;0;5228;VERDADERO;FALSO;-52;;;
33735;33752;0;5229;VERDADERO;VERDADERO;-17;;;
33735;33752;0;5230;VERDADERO;VERDADERO;-17;;;
33735;33752;0;5231;VERDADERO;VERDADERO;-17;;;
33735;33752;0;5232;VERDADERO;VERDADERO;-17;;;
33735;33772;0;5233;VERDADERO;VERDADERO;-37;;;
33764;33772;0;5234;VERDADERO;VERDADERO;-8;;;
33764;33772;0;5235;VERDADERO;VERDADERO;-8;;;
33764;33792;0;5236;VERDADERO;VERDADERO;-28;;;
33764;33792;0;5237;VERDADERO;VERDADERO;-28;;;
33764;33812;0;5238;VERDADERO;VERDADERO;-48;;;
33801;33812;0;5239;VERDADERO;VERDADERO;-11;;;
33801;33812;0;5240;VERDADERO;VERDADERO;-11;;;
33801;33812;0;5241;VERDADERO;VERDADERO;-11;;;
33801;33832;0;5242;VERDADERO;VERDADERO;-31;;;
33801;33832;0;5243;VERDADERO;VERDADERO;-31;;;
33833;33832;0;5244;VERDADERO;VERDADERO;1;;;
33833;33852;0;5245;VERDADERO;VERDADERO;-19;;;
33833;33852;0;5246;VERDADERO;VERDADERO;-19;;;
33833;33872;0;5247;VERDADERO;VERDADERO;-39;;;
33833;33872;0;5248;VERDADERO;VERDADERO;-39;;;
33866;33872;0;5249;VERDADERO;VERDADERO;-6;;;
33866;33892;0;5250;VERDADERO;VERDADERO;-26;;;
33866;33892;0;5251;VERDADERO;VERDADERO;-26;;;
33866;33912;0;5252;VERDADERO;VERDADERO;-46;;;
33866;33912;0;5253;VERDADERO;VERDADERO;-46;;;
33897;33912;0;5254;VERDADERO;VERDADERO;-15;;;
33897;33912;0;5255;VERDADERO;VERDADERO;-15;;;
33897;33912;0;5256;VERDADERO;VERDADERO;-15;;;
33897;33932;0;5257;VERDADERO;VERDADERO;-35;;;
33897;33932;0;5258;VERDADERO;VERDADERO;-35;;;
33929;33932;0;5259;VERDADERO;VERDADERO;-3;;;
33929;33952;0;5260;VERDADERO;VERDADERO;-23;;;
33929;33952;0;5261;VERDADERO;VERDADERO;-23;;;
33929;33952;0;5262;VERDADERO;VERDADERO;-23;;;
33929;33972;1;5263;VERDADERO;VERDADERO;-43;;;
33961;33972;0;5264;VERDADERO;VERDADERO;-11;;;
33961;33992;0;5265;VERDADERO;VERDADERO;-31;;;
33961;33992;0;5266;VERDADERO;VERDADERO;-31;;;
33961;33992;0;5267;VERDADERO;VERDADERO;-31;;;
33961;34012;0;5268;VERDADERO;FALSO;-51;;;
33993;34012;0;5269;VERDADERO;VERDADERO;-19;;;
33993;34012;0;5270;VERDADERO;VERDADERO;-19;;;
33993;34012;0;5271;VERDADERO;VERDADERO;-19;;;
33993;34012;0;5272;VERDADERO;VERDADERO;-19;;;
33993;34012;0;5273;VERDADERO;VERDADERO;-19;;;
33993;34032;0;5274;VERDADERO;VERDADERO;-39;;;
34029;34032;0;5275;VERDADERO;VERDADERO;-3;;;
34029;34052;0;5276;VERDADERO;VERDADERO;-23;;;
34029;34052;0;5277;VERDADERO;VERDADERO;-23;;;
34029;34052;0;5278;VERDADERO;VERDADERO;-23;;;
34029;34052;0;5279;VERDADERO;VERDADERO;-23;;;
34062;34052;0;5280;VERDADERO;VERDADERO;10;;;
34062;34052;0;5281;VERDADERO;VERDADERO;10;;;
34062;34072;0;5282;VERDADERO;VERDADERO;-10;;;
34062;34072;0;5283;VERDADERO;VERDADERO;-10;;;
34062;34072;0;5284;VERDADERO;VERDADERO;-10;;;
34093;34092;0;5285;VERDADERO;VERDADERO;1;;;
34093;34092;0;5286;VERDADERO;VERDADERO;1;;;
34093;34112;0;5287;VERDADERO;VERDADERO;-19;;;
34093;34112;0;5288;VERDADERO;VERDADERO;-19;;;
34093;34112;0;5289;VERDADERO;VERDADERO;-19;;;
34093;34132;0;5290;VERDADERO;VERDADERO;-39;;;
34129;34132;0;5291;VERDADERO;VERDADERO;-3;;;
34129;34152;0;5292;VERDADERO;VERDADERO;-23;;;
34129;34152;0;5293;VERDADERO;VERDADERO;-23;;;
34129;34152;0;5294;VERDADERO;VERDADERO;-23;;;
34129;34172;0;5295;VERDADERO;VERDADERO;-43;;;
34161;34172;0;5296;VERDADERO;VERDADERO;-11;;;
34161;34172;0;5297;VERDADERO;VERDADERO;-11;;;
34161;34192;0;5298;VERDADERO;VERDADERO;-31;;;
34161;34192;0;5299;VERDADERO;VERDADERO;-31;;;
34161;34212;0;5300;VERDADERO;FALSO;-51;;;
34161;34212;0;5301;VERDADERO;FALSO;-51;;;
34197;34212;0;5302;VERDADERO;VERDADERO;-15;;;
34197;34212;0;5303;VERDADERO;VERDADERO;-15;;;
34197;34212;0;5304;VERDADERO;VERDADERO;-15;;;
34197;34212;0;5305;VERDADERO;VERDADERO;-15;;;
34197;34232;0;5306;VERDADERO;VERDADERO;-35;;;
34229;34232;0;5307;VERDADERO;VERDADERO;-3;;;
34229;34252;0;5308;VERDADERO;VERDADERO;-23;;;
34229;34252;0;5309;VERDADERO;VERDADERO;-23;;;
34229;34252;0;5310;VERDADERO;VERDADERO;-23;;;
34229;34272;0;5311;VERDADERO;VERDADERO;-43;;;
34229;34272;0;5312;VERDADERO;VERDADERO;-43;;;
34270;34272;0;5313;VERDADERO;VERDADERO;-2;;;
34270;34292;0;5314;VERDADERO;VERDADERO;-22;;;
34270;34292;0;5315;VERDADERO;VERDADERO;-22;;;
34270;34312;0;5316;VERDADERO;VERDADERO;-42;;;
34297;34312;0;5317;VERDADERO;VERDADERO;-15;;;
34297;34312;0;5318;VERDADERO;VERDADERO;-15;;;
34297;34312;0;5319;VERDADERO;VERDADERO;-15;;;
34297;34312;0;5320;VERDADERO;VERDADERO;-15;;;
34297;34312;0;5321;VERDADERO;VERDADERO;-15;;;
34329;34332;1;5322;VERDADERO;VERDADERO;-3;;;
34329;34332;0;5323;VERDADERO;VERDADERO;-3;;;
34329;34352;0;5324;VERDADERO;VERDADERO;-23;;;
34329;34352;0;5325;VERDADERO;VERDADERO;-23;;;
34329;34372;0;5326;VERDADERO;VERDADERO;-43;;;
34329;34372;0;5327;VERDADERO;VERDADERO;-43;;;
34365;34372;0;5328;VERDADERO;VERDADERO;-7;;;
34365;34392;0;5329;VERDADERO;VERDADERO;-27;;;
34365;34392;0;5330;VERDADERO;VERDADERO;-27;;;
34365;34412;0;5331;VERDADERO;VERDADERO;-47;;;
34365;34412;0;5332;VERDADERO;VERDADERO;-47;;;
34365;34412;0;5333;VERDADERO;VERDADERO;-47;;;
34401;34412;0;5334;VERDADERO;VERDADERO;-11;;;
34401;34412;0;5335;VERDADERO;VERDADERO;-11;;;
34401;34412;0;5336;VERDADERO;VERDADERO;-11;;;
34401;34412;0;5337;VERDADERO;VERDADERO;-11;;;
34401;34412;0;5338;VERDADERO;VERDADERO;-11;;;
34433;34412;0;5339;VERDADERO;VERDADERO;21;;;
34433;34412;0;5340;VERDADERO;VERDADERO;21;;;
34433;34412;0;5341;VERDADERO;VERDADERO;21;;;
34433;34412;0;5342;VERDADERO;VERDADERO;21;;;
34433;34432;0;5343;VERDADERO;VERDADERO;1;;;
34433;34432;0;5344;VERDADERO;VERDADERO;1;;;
34469;34432;0;5345;VERDADERO;VERDADERO;37;;;
34469;34452;0;5346;VERDADERO;VERDADERO;17;;;
34469;34452;0;5347;VERDADERO;VERDADERO;17;;;
34469;34452;0;5348;VERDADERO;VERDADERO;17;;;
34469;34452;0;5349;VERDADERO;VERDADERO;17;;;
34501;34452;0;5350;VERDADERO;VERDADERO;49;;;
34501;34452;0;5351;VERDADERO;VERDADERO;49;;;
34501;34452;0;5352;VERDADERO;VERDADERO;49;;;
34501;34472;0;5353;VERDADERO;VERDADERO;29;;;
34501;34472;0;5354;VERDADERO;VERDADERO;29;;;
34501;34492;0;5355;VERDADERO;VERDADERO;9;;;
34537;34492;0;5356;VERDADERO;VERDADERO;45;;;
34537;34492;0;5357;VERDADERO;VERDADERO;45;;;
34537;34512;0;5358;VERDADERO;VERDADERO;25;;;
34537;34512;0;5359;VERDADERO;VERDADERO;25;;;
34537;34532;0;5360;VERDADERO;VERDADERO;5;;;
34569;34532;0;5361;VERDADERO;VERDADERO;37;;;
34569;34532;0;5362;VERDADERO;VERDADERO;37;;;
34569;34552;0;5363;VERDADERO;VERDADERO;17;;;
34569;34552;0;5364;VERDADERO;VERDADERO;17;;;
34569;34572;0;5365;VERDADERO;VERDADERO;-3;;;
34569;34572;0;5366;VERDADERO;VERDADERO;-3;;;
34605;34572;0,00E+00;5367;VERDADERO;VERDADERO;33;;;
34605;34592;0;5368;VERDADERO;VERDADERO;13;;;
34605;34592;0;5369;VERDADERO;VERDADERO;13;;;
34605;34612;0;5370;VERDADERO;VERDADERO;-7;;;
34605;34612;0;5371;VERDADERO;VERDADERO;-7;;;
34637;34612;0;5372;VERDADERO;VERDADERO;25;;;
34637;34632;0;5373;VERDADERO;VERDADERO;5;;;
34637;34632;0;5374;VERDADERO;VERDADERO;5;;;
34637;34652;0;5375;VERDADERO;VERDADERO;-15;;;
34637;34652;0;5376;VERDADERO;VERDADERO;-15;;;
34669;34652;0;5377;VERDADERO;VERDADERO;17;;;
34669;34672;0;5378;VERDADERO;VERDADERO;-3;;;
34669;34672;0;5379;VERDADERO;VERDADERO;-3;;;
34669;34692;0;5380;VERDADERO;VERDADERO;-23;;;
34669;34692;0;5381;VERDADERO;VERDADERO;-23;;;
34701;34692;0;5382;VERDADERO;VERDADERO;9;;;
34701;34712;0;5383;VERDADERO;VERDADERO;-11;;;
34701;34712;0;5384;VERDADERO;VERDADERO;-11;;;
34701;34732;0;5385;VERDADERO;VERDADERO;-31;;;
34733;34732;0;5386;VERDADERO;VERDADERO;1;;;
34733;34752;0;5387;VERDADERO;VERDADERO;-19;;;
34733;34752;0;5388;VERDADERO;VERDADERO;-19;;;
34733;34752;0;5389;VERDADERO;VERDADERO;-19;;;
34733;34772;0;5390;VERDADERO;VERDADERO;-39;;;
34733;34772;0;5391;VERDADERO;VERDADERO;-39;;;
34769;34772;0;5392;VERDADERO;VERDADERO;-3;;;
34769;34772;0;5393;VERDADERO;VERDADERO;-3;;;
34769;34772;0;5394;VERDADERO;VERDADERO;-3;;;
34769;34772;0;5395;VERDADERO;VERDADERO;-3;;;
34769;34792;0;5396;VERDADERO;VERDADERO;-23;;;
34801;34792;0;5397;VERDADERO;VERDADERO;9;;;
34801;34812;0;5398;VERDADERO;VERDADERO;-11;;;
34801;34812;0;5399;VERDADERO;VERDADERO;-11;;;
34801;34812;0;5400;VERDADERO;VERDADERO;-11;;;
34801;34832;1;5401;VERDADERO;VERDADERO;-31;;;
34801;34832;0;5402;VERDADERO;VERDADERO;-31;;;
34834;34832;0;5403;VERDADERO;VERDADERO;2;;;
34834;34852;0;5404;VERDADERO;VERDADERO;-18;;;
34834;34852;0;5405;VERDADERO;VERDADERO;-18;;;
34834;34852;0;5406;VERDADERO;VERDADERO;-18;;;
34834;34872;0;5407;VERDADERO;VERDADERO;-38;;;
34869;34872;0;5408;VERDADERO;VERDADERO;-3;;;
34869;34892;0;5409;VERDADERO;VERDADERO;-23;;;
34869;34892;0;5410;VERDADERO;VERDADERO;-23;;;
34869;34892;0;5411;VERDADERO;VERDADERO;-23;;;
34869;34912;0;5412;VERDADERO;VERDADERO;-43;;;
34901;34912;0;5413;VERDADERO;VERDADERO;-11;;;
34901;34932;0;5414;VERDADERO;VERDADERO;-31;;;
34901;34932;0;5415;VERDADERO;VERDADERO;-31;;;
34901;34932;0;5416;VERDADERO;VERDADERO;-31;;;
34901;34932;0;5417;VERDADERO;VERDADERO;-31;;;
34933;34932;0;5418;VERDADERO;VERDADERO;1;;;
34933;34932;0;5419;VERDADERO;VERDADERO;1;;;
34933;34952;0;5420;VERDADERO;VERDADERO;-19;;;
34933;34952;0;5421;VERDADERO;VERDADERO;-19;;;
34933;34972;0;5422;VERDADERO;VERDADERO;-39;;;
34933;34972;0;5423;VERDADERO;VERDADERO;-39;;;
34969;34972;0;5424;VERDADERO;VERDADERO;-3;;;
34969;34992;0;5425;VERDADERO;VERDADERO;-23;;;
34969;34992;0;5426;VERDADERO;VERDADERO;-23;;;
34969;34992;0;5427;VERDADERO;VERDADERO;-23;;;
34969;35012;0;5428;VERDADERO;VERDADERO;-43;;;
35001;35012;0;5429;VERDADERO;VERDADERO;-11;;;
35001;35032;0;5430;VERDADERO;VERDADERO;-31;;;
35001;35032;0;5431;VERDADERO;VERDADERO;-31;;;
35001;35032;0;5432;VERDADERO;VERDADERO;-31;;;
35001;35032;0;5433;VERDADERO;VERDADERO;-31;;;
35033;35032;0;5434;VERDADERO;VERDADERO;1;;;
35033;35032;0;5435;VERDADERO;VERDADERO;1;;;
35033;35052;0;5436;VERDADERO;VERDADERO;-19;;;
35033;35052;0;5437;VERDADERO;VERDADERO;-19;;;
35033;35072;0;5438;VERDADERO;VERDADERO;-39;;;
35065;35092;1;5439;VERDADERO;VERDADERO;-27;;;
35097;35112;0;5440;VERDADERO;VERDADERO;-15;;;
35133;35152;0;5441;VERDADERO;VERDADERO;-19;;;
35165;35172;1;5442;VERDADERO;VERDADERO;-7;;;
35197;35212;1;5443;VERDADERO;VERDADERO;-15;;;
35233;35252;1;5444;VERDADERO;VERDADERO;-19;;;
35265;35272;0;5445;VERDADERO;VERDADERO;-7;;;
35297;35312;0;5446;VERDADERO;VERDADERO;-15;;;
35333;35352;1;5447;VERDADERO;VERDADERO;-19;;;
35368;35372;0;5448;VERDADERO;VERDADERO;-4;;;
35397;35412;1;5449;VERDADERO;VERDADERO;-15;;;
35433;35452;1;5450;VERDADERO;VERDADERO;-19;;;
35465;35473;0;5451;VERDADERO;VERDADERO;-8;;;
35497;35513;1;5452;VERDADERO;VERDADERO;-16;;;
35533;35533;1;5453;VERDADERO;VERDADERO;0;;;
35565;35573;1;5454;VERDADERO;VERDADERO;-8;;;
35597;35613;0;5455;VERDADERO;VERDADERO;-16;;;
35633;35633;1;5456;VERDADERO;VERDADERO;0;;;
35665;35673;1;5457;VERDADERO;VERDADERO;-8;;;
35697;35713;0;5458;VERDADERO;VERDADERO;-16;;;
35733;35753;0;5459;VERDADERO;VERDADERO;-20;;;
35765;35773;0;5460;VERDADERO;VERDADERO;-8;;;
35797;35814;0;5461;VERDADERO;VERDADERO;-17;;;
35833;35834;1;5462;VERDADERO;VERDADERO;-1;;;
35865;35874;1;5463;VERDADERO;VERDADERO;-9;;;
35901;35914;0;5464;VERDADERO;VERDADERO;-13;;;
35933;35934;0;5465;VERDADERO;VERDADERO;-1;;;
35965;35974;0;5466;VERDADERO;VERDADERO;-9;;;
35997;36014;1;5467;VERDADERO;VERDADERO;-17;;;
36029;36034;0;5468;VERDADERO;VERDADERO;-5;;;
36065;36074;0;5469;VERDADERO;VERDADERO;-9;;;
36097;36114;0;5470;VERDADERO;VERDADERO;-17;;;
36129;36134;1;5471;VERDADERO;VERDADERO;-5;;;
36160;36174;1;5472;VERDADERO;VERDADERO;-14;;;
36193;36194;0;5473;VERDADERO;VERDADERO;-1;;;
36229;36234;0;5474;VERDADERO;VERDADERO;-5;;;
36261;36274;1;5475;VERDADERO;VERDADERO;-13;;;
36293;36294;1;5476;VERDADERO;VERDADERO;-1;;;
36333;36334;1;5477;VERDADERO;VERDADERO;-1;;;
36361;36374;0;5478;VERDADERO;VERDADERO;-13;;;
36394;36394;0;5479;VERDADERO;VERDADERO;0;;;
36394;36414;0;5480;VERDADERO;VERDADERO;-20;;;
36394;36414;0;5481;VERDADERO;VERDADERO;-20;;;
36394;36434;0;5482;VERDADERO;VERDADERO;-40;;;
36429;36434;0;5483;VERDADERO;VERDADERO;-5;;;
36429;36454;0;5484;VERDADERO;VERDADERO;-25;;;
36429;36454;0;5485;VERDADERO;VERDADERO;-25;;;
36429;36454;0;5486;VERDADERO;VERDADERO;-25;;;
36429;36454;0;5487;VERDADERO;VERDADERO;-25;;;
36429;36474;0;5488;VERDADERO;VERDADERO;-45;;;
36465;36474;0;5489;VERDADERO;VERDADERO;-9;;;
36465;36494;0;5490;VERDADERO;VERDADERO;-29;;;
36465;36494;0;5491;VERDADERO;VERDADERO;-29;;;
36465;36494;0;5492;VERDADERO;VERDADERO;-29;;;
36465;36494;0;5493;VERDADERO;VERDADERO;-29;;;
36497;36494;0;5494;VERDADERO;VERDADERO;3;;;
36497;36494;0;5495;VERDADERO;VERDADERO;3;;;
36497;36514;0;5496;VERDADERO;VERDADERO;-17;;;
36497;36514;0;5497;VERDADERO;VERDADERO;-17;;;
36497;36534;0;5498;VERDADERO;VERDADERO;-37;;;
36529;36534;0;5499;VERDADERO;VERDADERO;-5;;;
36529;36534;0;5500;VERDADERO;VERDADERO;-5;;;
36529;36554;0;5501;VERDADERO;VERDADERO;-25;;;
36529;36554;0;5502;VERDADERO;VERDADERO;-25;;;
36529;36554;0;5503;VERDADERO;VERDADERO;-25;;;
36529;36574;0;5504;VERDADERO;VERDADERO;-45;;;
36565;36574;0;5505;VERDADERO;VERDADERO;-9;;;
36565;36574;0;5506;VERDADERO;VERDADERO;-9;;;
36565;36594;0;5507;VERDADERO;VERDADERO;-29;;;
36565;36594;0;5508;VERDADERO;VERDADERO;-29;;;
36565;36594;0;5509;VERDADERO;VERDADERO;-29;;;
36597;36614;0;5510;VERDADERO;VERDADERO;-17;;;
36597;36614;0;5511;VERDADERO;VERDADERO;-17;;;
36597;36634;0;5512;VERDADERO;VERDADERO;-37;;;
36597;36634;0;5513;VERDADERO;VERDADERO;-37;;;
36597;36634;0;5514;VERDADERO;VERDADERO;-37;;;
36629;36654;0;5515;VERDADERO;VERDADERO;-25;;;
36629;36654;0;5516;VERDADERO;VERDADERO;-25;;;
36629;36654;0;5517;VERDADERO;VERDADERO;-25;;;
36629;36654;0;5518;VERDADERO;VERDADERO;-25;;;
36629;36654;0;5519;VERDADERO;VERDADERO;-25;;;
36629;36654;0;5520;VERDADERO;VERDADERO;-25;;;
36665;36654;0;5521;VERDADERO;VERDADERO;11;;;
36665;36654;0;5522;VERDADERO;VERDADERO;11;;;
36665;36654;0;5523;VERDADERO;VERDADERO;11;;;
36665;36654;0;5524;VERDADERO;VERDADERO;11;;;
36665;36674;0;5525;VERDADERO;VERDADERO;-9;;;
36697;36674;0;5526;VERDADERO;VERDADERO;23;;;
36697;36674;0;5527;VERDADERO;VERDADERO;23;;;
36697;36694;0;5528;VERDADERO;VERDADERO;3;;;
36697;36694;0;5529;VERDADERO;VERDADERO;3;;;
36697;36694;0;5530;VERDADERO;VERDADERO;3;;;
36729;36694;0;5531;VERDADERO;VERDADERO;35;;;
36729;36714;0;5532;VERDADERO;VERDADERO;15;;;
36729;36714;0;5533;VERDADERO;VERDADERO;15;;;
36729;36714;0;5534;VERDADERO;VERDADERO;15;;;
36729;36734;0;5535;VERDADERO;VERDADERO;-5;;;
36760;36734;0;5536;VERDADERO;VERDADERO;26;;;
36760;36754;0;5537;VERDADERO;VERDADERO;6;;;
36760;36754;0;5538;VERDADERO;VERDADERO;6;;;
36760;36754;0;5539;VERDADERO;VERDADERO;6;;;
36760;36774;0;5540;VERDADERO;VERDADERO;-14;;;
36793;36774;0;5541;VERDADERO;VERDADERO;19;;;
36793;36794;0;5542;VERDADERO;VERDADERO;-1;;;
36793;36794;0;5543;VERDADERO;VERDADERO;-1;;;
36793;36814;0;5544;VERDADERO;VERDADERO;-21;;;
36793;36814;0;5545;VERDADERO;VERDADERO;-21;;;
36793;36814;0;5546;VERDADERO;VERDADERO;-21;;;
36829;36834;1;5547;VERDADERO;VERDADERO;-5;;;
36829;36834;0;5548;VERDADERO;VERDADERO;-5;;;
36829;36854;0;5549;VERDADERO;VERDADERO;-25;;;
36829;36854;0;5550;VERDADERO;VERDADERO;-25;;;
36829;36854;0;5551;VERDADERO;VERDADERO;-25;;;
36861;36874;0;5552;VERDADERO;VERDADERO;-13;;;
36861;36874;0;5553;VERDADERO;VERDADERO;-13;;;
36861;36874;0;5554;VERDADERO;VERDADERO;-13;;;
36861;36894;0;5555;VERDADERO;VERDADERO;-33;;;
36861;36894;0;5556;VERDADERO;VERDADERO;-33;;;
36892;36894;0;5557;VERDADERO;VERDADERO;-2;;;
36892;36915;0;5558;VERDADERO;VERDADERO;-23;;;
36892;36915;0;5559;VERDADERO;VERDADERO;-23;;;
36892;36935;0;5560;VERDADERO;VERDADERO;-43;;;
36892;36935;0;5561;VERDADERO;VERDADERO;-43;;;
36929;36935;0;5562;VERDADERO;VERDADERO;-6;;;
36929;36955;0;5563;VERDADERO;VERDADERO;-26;;;
36929;36955;0;5564;VERDADERO;VERDADERO;-26;;;
36929;36955;0;5565;VERDADERO;VERDADERO;-26;;;
36929;36975;0;5566;VERDADERO;VERDADERO;-46;;;
36961;36975;0;5567;VERDADERO;VERDADERO;-14;;;
36961;36975;0;5568;VERDADERO;VERDADERO;-14;;;
36961;36975;0;5569;VERDADERO;VERDADERO;-14;;;
36961;36995;0;5570;VERDADERO;VERDADERO;-34;;;
36961;36995;0;5571;VERDADERO;VERDADERO;-34;;;
36993;36995;0;5572;VERDADERO;VERDADERO;-2;;;
36993;37015;0;5573;VERDADERO;VERDADERO;-22;;;
36993;37015;0;5574;VERDADERO;VERDADERO;-22;;;
36993;37035;1;5575;VERDADERO;VERDADERO;-42;;;
36993;37035;0;5576;VERDADERO;VERDADERO;-42;;;
36993;37035;0;5577;VERDADERO;VERDADERO;-42;;;
37029;37055;0;5578;VERDADERO;VERDADERO;-26;;;
37029;37055;0;5579;VERDADERO;VERDADERO;-26;;;
37029;37075;0;5580;VERDADERO;VERDADERO;-46;;;
37029;37075;0;5581;VERDADERO;VERDADERO;-46;;;
37029;37075;0;5582;VERDADERO;VERDADERO;-46;;;
37061;37075;0;5583;VERDADERO;VERDADERO;-14;;;
37061;37075;0;5584;VERDADERO;VERDADERO;-14;;;
37061;37075;0;5585;VERDADERO;VERDADERO;-14;;;
37061;37095;0;5586;VERDADERO;VERDADERO;-34;;;
37061;37095;0;5587;VERDADERO;VERDADERO;-34;;;
37093;37115;1;5588;VERDADERO;VERDADERO;-22;;;
37093;37115;0;5589;VERDADERO;VERDADERO;-22;;;
37093;37115;0;5590;VERDADERO;VERDADERO;-22;;;
37093;37115;0;5591;VERDADERO;VERDADERO;-22;;;
37093;37115;0;5592;VERDADERO;VERDADERO;-22;;;
37125;37135;1;5593;VERDADERO;VERDADERO;-10;;;
37125;37135;0;5594;VERDADERO;VERDADERO;-10;;;
37125;37155;1;5595;VERDADERO;VERDADERO;-30;;;
37125;37155;0;5596;VERDADERO;VERDADERO;-30;;;
37125;37175;1;5597;VERDADERO;FALSO;-50;;;
37158;37175;0;5598;VERDADERO;VERDADERO;-17;;;
37158;37175;0;5599;VERDADERO;VERDADERO;-17;;;
37158;37175;0;5600;VERDADERO;VERDADERO;-17;;;
37158;37195;0;5601;VERDADERO;VERDADERO;-37;;;
37158;37195;0;5602;VERDADERO;VERDADERO;-37;;;
37158;37215;0;5603;VERDADERO;FALSO;-57;;;
37193;37215;0;5604;VERDADERO;VERDADERO;-22;;;
37193;37215;0;5605;VERDADERO;VERDADERO;-22;;;
37193;37215;0;5606;VERDADERO;VERDADERO;-22;;;
37193;37215;0;5607;VERDADERO;VERDADERO;-22;;;
37193;37235;0;5608;VERDADERO;VERDADERO;-42;;;
37225;37235;0;5609;VERDADERO;VERDADERO;-10;;;
37225;37235;0;5610;VERDADERO;VERDADERO;-10;;;
37225;37255;1;5611;VERDADERO;VERDADERO;-30;;;
37225;37255;0;5612;VERDADERO;VERDADERO;-30;;;
37225;37275;1;5613;VERDADERO;FALSO;-50;;;
37261;37275;0;5614;VERDADERO;VERDADERO;-14;;;
37261;37275;0;5615;VERDADERO;VERDADERO;-14;;;
37261;37275;0;5616;VERDADERO;VERDADERO;-14;;;
37261;37275;0;5617;VERDADERO;VERDADERO;-14;;;
37261;37295;0;5618;VERDADERO;VERDADERO;-34;;;
37293;37295;0;5619;VERDADERO;VERDADERO;-2;;;
37293;37295;0;5620;VERDADERO;VERDADERO;-2;;;
37293;37315;0;5621;VERDADERO;VERDADERO;-22;;;
37293;37315;0;5622;VERDADERO;VERDADERO;-22;;;
37293;37315;0;5623;VERDADERO;VERDADERO;-22;;;
37293;37315;0;5624;VERDADERO;VERDADERO;-22;;;
37329;37335;0;5625;VERDADERO;VERDADERO;-6;;;
37329;37335;0;5626;VERDADERO;VERDADERO;-6;;;
37329;37335;0;5627;VERDADERO;VERDADERO;-6;;;
37329;37355;0;5628;VERDADERO;VERDADERO;-26;;;
37329;37355;0;5629;VERDADERO;VERDADERO;-26;;;
37361;37375;1;5630;VERDADERO;VERDADERO;-14;;;
37361;37375;0;5631;VERDADERO;VERDADERO;-14;;;
37361;37375;0;5632;VERDADERO;VERDADERO;-14;;;
37361;37395;0;5633;VERDADERO;VERDADERO;-34;;;
37361;37395;0;5634;VERDADERO;VERDADERO;-34;;;
37361;37395;0;5635;VERDADERO;VERDADERO;-34;;;
37397;37415;0;5636;VERDADERO;VERDADERO;-18;;;
37397;37415;0;5637;VERDADERO;VERDADERO;-18;;;
37397;37435;0;5638;VERDADERO;VERDADERO;-38;;;
37397;37435;0;5639;VERDADERO;VERDADERO;-38;;;
37397;37435;0;5640;VERDADERO;VERDADERO;-38;;;
37429;37455;1;5641;VERDADERO;VERDADERO;-26;;;
37429;37455;0;5642;VERDADERO;VERDADERO;-26;;;
37429;37475;0;5643;VERDADERO;VERDADERO;-46;;;
37429;37475;0;5644;VERDADERO;VERDADERO;-46;;;
37429;37475;0;5645;VERDADERO;VERDADERO;-46;;;
37465;37475;0;5646;VERDADERO;VERDADERO;-10;;;
37465;37475;0;5647;VERDADERO;VERDADERO;-10;;;
37465;37475;0;5648;VERDADERO;VERDADERO;-10;;;
37465;37495;0;5649;VERDADERO;VERDADERO;-30;;;
37465;37495;0;5650;VERDADERO;VERDADERO;-30;;;
37497;37515;0;5651;VERDADERO;VERDADERO;-18;;;
37497;37515;0;5652;VERDADERO;VERDADERO;-18;;;
37497;37515;0;5653;VERDADERO;VERDADERO;-18;;;
37497;37515;0;5654;VERDADERO;VERDADERO;-18;;;
37497;37515;0;5655;VERDADERO;VERDADERO;-18;;;
37497;37535;0;5656;VERDADERO;VERDADERO;-38;;;
37529;37535;0;5657;VERDADERO;VERDADERO;-6;;;
37529;37555;0;5658;VERDADERO;VERDADERO;-26;;;
37529;37555;0;5659;VERDADERO;VERDADERO;-26;;;
37529;37555;0;5660;VERDADERO;VERDADERO;-26;;;
37529;37575;0;5661;VERDADERO;VERDADERO;-46;;;
37561;37575;0;5662;VERDADERO;VERDADERO;-14;;;
37561;37595;0;5663;VERDADERO;VERDADERO;-34;;;
37561;37595;0;5664;VERDADERO;VERDADERO;-34;;;
37561;37595;0;5665;VERDADERO;VERDADERO;-34;;;
37561;37615;0;5666;VERDADERO;FALSO;-54;;;
37594;37615;0;5667;VERDADERO;VERDADERO;-21;;;
37594;37615;0;5668;VERDADERO;VERDADERO;-21;;;
37594;37635;0;5669;VERDADERO;VERDADERO;-41;;;
37594;37635;0;5670;VERDADERO;VERDADERO;-41;;;
37594;37635;0;5671;VERDADERO;VERDADERO;-41;;;
37594;37655;0;5672;VERDADERO;FALSO;-61;;;
37628;37655;0;5673;VERDADERO;VERDADERO;-27;;;
37628;37655;0;5674;VERDADERO;VERDADERO;-27;;;
37628;37655;0;5675;VERDADERO;VERDADERO;-27;;;
37628;37655;0;5676;VERDADERO;VERDADERO;-27;;;
37660;37675;1;5677;VERDADERO;VERDADERO;-15;;;
37660;37675;0;5678;VERDADERO;VERDADERO;-15;;;
37660;37695;0;5679;VERDADERO;VERDADERO;-35;;;
37660;37695;0;5680;VERDADERO;VERDADERO;-35;;;
37660;37695;0;5681;VERDADERO;VERDADERO;-35;;;
37693;37695;0;5682;VERDADERO;VERDADERO;-2;;;
37693;37695;0;5683;VERDADERO;VERDADERO;-2;;;
37693;37695;0;5684;VERDADERO;VERDADERO;-2;;;
37693;37695;0;5685;VERDADERO;VERDADERO;-2;;;
37693;37715;0;5686;VERDADERO;VERDADERO;-22;;;
37693;37715;0;5687;VERDADERO;VERDADERO;-22;;;
37729;37715;0;5688;VERDADERO;VERDADERO;14;;;
37729;37735;0;5689;VERDADERO;VERDADERO;-6;;;
37729;37735;0;5690;VERDADERO;VERDADERO;-6;;;
37729;37735;0;5691;VERDADERO;VERDADERO;-6;;;
37729;37755;0;5692;VERDADERO;VERDADERO;-26;;;
37761;37755;0;5693;VERDADERO;VERDADERO;6;;;
37761;37775;0;5694;VERDADERO;VERDADERO;-14;;;
37761;37775;0;5695;VERDADERO;VERDADERO;-14;;;
37761;37775;0;5696;VERDADERO;VERDADERO;-14;;;
37761;37795;1;5697;VERDADERO;VERDADERO;-34;;;
37761;37795;0;5698;VERDADERO;VERDADERO;-34;;;
37797;37815;0;5699;VERDADERO;VERDADERO;-18;;;
37797;37815;0;5700;VERDADERO;VERDADERO;-18;;;
37797;37835;0;5701;VERDADERO;VERDADERO;-38;;;
37797;37835;0;5702;VERDADERO;VERDADERO;-38;;;
37797;37835;0;5703;VERDADERO;VERDADERO;-38;;;
37829;37855;1;5704;VERDADERO;VERDADERO;-26;;;
37829;37855;0;5705;VERDADERO;VERDADERO;-26;;;
37829;37855;0;5706;VERDADERO;VERDADERO;-26;;;
37829;37855;0;5707;VERDADERO;VERDADERO;-26;;;
37829;37855;0;5708;VERDADERO;VERDADERO;-26;;;
37861;37875;1;5709;VERDADERO;VERDADERO;-14;;;
37861;37875;0;5710;VERDADERO;VERDADERO;-14;;;
37861;37895;0;5711;VERDADERO;VERDADERO;-34;;;
37861;37895;0;5712;VERDADERO;VERDADERO;-34;;;
37861;37895;0;5713;VERDADERO;VERDADERO;-34;;;
37897;37895;0;5714;VERDADERO;VERDADERO;2;;;
37897;37895;0;5715;VERDADERO;VERDADERO;2;;;
37897;37895;0;5716;VERDADERO;VERDADERO;2;;;
37897;37915;0;5717;VERDADERO;VERDADERO;-18;;;
37897;37915;0;5718;VERDADERO;VERDADERO;-18;;;
37897;37936;0;5719;VERDADERO;VERDADERO;-39;;;
37928;37936;0;5720;VERDADERO;VERDADERO;-8;;;
37928;37956;0;5721;VERDADERO;VERDADERO;-28;;;
37928;37956;0;5722;VERDADERO;VERDADERO;-28;;;
37928;37956;0;5723;VERDADERO;VERDADERO;-28;;;
37928;37956;0;5724;VERDADERO;VERDADERO;-28;;;
37961;37976;0;5725;VERDADERO;VERDADERO;-15;;;
37961;37976;0;5726;VERDADERO;VERDADERO;-15;;;
37961;37976;0;5727;VERDADERO;VERDADERO;-15;;;
37961;37996;0;5728;VERDADERO;VERDADERO;-35;;;
37961;37996;0;5729;VERDADERO;VERDADERO;-35;;;
37997;38016;0;5730;VERDADERO;VERDADERO;-19;;;
37997;38016;0;5731;VERDADERO;VERDADERO;-19;;;
37997;38016;0;5732;VERDADERO;VERDADERO;-19;;;
37997;38036;0;5733;VERDADERO;VERDADERO;-39;;;
37997;38036;0;5734;VERDADERO;VERDADERO;-39;;;
38029;38036;0;5735;VERDADERO;VERDADERO;-7;;;
38029;38056;0;5736;VERDADERO;VERDADERO;-27;;;
38029;38056;0;5737;VERDADERO;VERDADERO;-27;;;
38029;38056;0;5738;VERDADERO;VERDADERO;-27;;;
38029;38056;0;5739;VERDADERO;VERDADERO;-27;;;
38060;38056;0;5740;VERDADERO;VERDADERO;4;;;
38060;38076;1;5741;VERDADERO;VERDADERO;-16;;;
38060;38076;0;5742;VERDADERO;VERDADERO;-16;;;
38060;38096;0;5743;VERDADERO;VERDADERO;-36;;;
38060;38096;0;5744;VERDADERO;VERDADERO;-36;;;
38060;38096;0;5745;VERDADERO;VERDADERO;-36;;;
38097;38116;1;5746;VERDADERO;VERDADERO;-19;;;
38097;38116;0;5747;VERDADERO;VERDADERO;-19;;;
38097;38116;0;5748;VERDADERO;VERDADERO;-19;;;
38097;38136;0;5749;VERDADERO;VERDADERO;-39;;;
38097;38136;0;5750;VERDADERO;VERDADERO;-39;;;
38129;38156;0;5751;VERDADERO;VERDADERO;-27;;;
38129;38156;0;5752;VERDADERO;VERDADERO;-27;;;
38129;38156;0;5753;VERDADERO;VERDADERO;-27;;;
38129;38156;0;5754;VERDADERO;VERDADERO;-27;;;
38129;38156;0;5755;VERDADERO;VERDADERO;-27;;;
38161;38176;1;5756;VERDADERO;VERDADERO;-15;;;
38161;38176;0;5757;VERDADERO;VERDADERO;-15;;;
38161;38176;0;5758;VERDADERO;VERDADERO;-15;;;
38161;38196;0;5759;VERDADERO;VERDADERO;-35;;;
38161;38196;0;5760;VERDADERO;VERDADERO;-35;;;
38193;38216;1;5761;VERDADERO;VERDADERO;-23;;;
38193;38216;0;5762;VERDADERO;VERDADERO;-23;;;
38193;38216;0;5763;VERDADERO;VERDADERO;-23;;;
38193;38216;0;5764;VERDADERO;VERDADERO;-23;;;
38193;38236;0;5765;VERDADERO;VERDADERO;-43;;;
38225;38236;0;5766;VERDADERO;VERDADERO;-11;;;
38225;38256;0;5767;VERDADERO;VERDADERO;-31;;;
38225;38256;0;5768;VERDADERO;VERDADERO;-31;;;
38225;38256;0;5769;VERDADERO;VERDADERO;-31;;;
38225;38256;0;5770;VERDADERO;VERDADERO;-31;;;
38225;38256;0;5771;VERDADERO;VERDADERO;-31;;;
38261;38256;0;5772;VERDADERO;VERDADERO;5;;;
38261;38276;0;5773;VERDADERO;VERDADERO;-15;;;
38261;38276;0;5774;VERDADERO;VERDADERO;-15;;;
38261;38296;0;5775;VERDADERO;VERDADERO;-35;;;
38261;38296;0;5776;VERDADERO;VERDADERO;-35;;;
38293;38296;0;5777;VERDADERO;VERDADERO;-3;;;
38293;38316;0;5778;VERDADERO;VERDADERO;-23;;;
38293;38316;0;5779;VERDADERO;VERDADERO;-23;;;
38293;38316;0;5780;VERDADERO;VERDADERO;-23;;;
38293;38336;0;5781;VERDADERO;VERDADERO;-43;;;
38325;38336;0;5782;VERDADERO;VERDADERO;-11;;;
38325;38336;0;5783;VERDADERO;VERDADERO;-11;;;
38325;38356;0;5784;VERDADERO;VERDADERO;-31;;;
38325;38356;0;5785;VERDADERO;VERDADERO;-31;;;
38325;38376;0;5786;VERDADERO;FALSO;-51;;;
38357;38376;0;5787;VERDADERO;VERDADERO;-19;;;
38357;38396;0;5788;VERDADERO;VERDADERO;-39;;;
38357;38396;0;5789;VERDADERO;VERDADERO;-39;;;
38357;38396;0;5790;VERDADERO;VERDADERO;-39;;;
38357;38416;1;5791;VERDADERO;FALSO;-59;;;
38390;38416;0;5792;VERDADERO;VERDADERO;-26;;;
38390;38416;0;5793;VERDADERO;VERDADERO;-26;;;
38390;38416;0;5794;VERDADERO;VERDADERO;-26;;;
38390;38416;0;5795;VERDADERO;VERDADERO;-26;;;
38390;38416;0;5796;VERDADERO;VERDADERO;-26;;;
38425;38436;1;5797;VERDADERO;VERDADERO;-11;;;
38425;38436;0;5798;VERDADERO;VERDADERO;-11;;;
38425;38436;0;5799;VERDADERO;VERDADERO;-11;;;
38425;38456;0;5800;VERDADERO;VERDADERO;-31;;;
38425;38456;0;5801;VERDADERO;VERDADERO;-31;;;
38456;38476;0;5802;VERDADERO;VERDADERO;-20;;;
38456;38476;0;5803;VERDADERO;VERDADERO;-20;;;
38456;38476;0;5804;VERDADERO;VERDADERO;-20;;;
38456;38496;1;5805;VERDADERO;VERDADERO;-40;;;
38456;38496;0;5806;VERDADERO;VERDADERO;-40;;;
38456;38496;0;5807;VERDADERO;VERDADERO;-40;;;
38493;38516;1;5808;VERDADERO;VERDADERO;-23;;;
38493;38516;0;5809;VERDADERO;VERDADERO;-23;;;
38493;38516;0;5810;VERDADERO;VERDADERO;-23;;;
38493;38516;0;5811;VERDADERO;VERDADERO;-23;;;
38493;38516;0;5812;VERDADERO;VERDADERO;-23;;;
38525;38536;1;5813;VERDADERO;VERDADERO;-11;;;
38525;38536;0;5814;VERDADERO;VERDADERO;-11;;;
38525;38556;0;5815;VERDADERO;VERDADERO;-31;;;
38525;38556;0;5816;VERDADERO;VERDADERO;-31;;;
38525;38556;0;5817;VERDADERO;VERDADERO;-31;;;
38525;38576;0;5818;VERDADERO;FALSO;-51;;;
38561;38576;0;5819;VERDADERO;VERDADERO;-15;;;
38561;38576;0;5820;VERDADERO;VERDADERO;-15;;;
38561;38576;0;5821;VERDADERO;VERDADERO;-15;;;
38561;38596;0;5822;VERDADERO;VERDADERO;-35;;;
38561;38596;0;5823;VERDADERO;VERDADERO;-35;;;
38593;38616;1;5824;VERDADERO;VERDADERO;-23;;;
38593;38616;0;5825;VERDADERO;VERDADERO;-23;;;
38593;38616;0;5826;VERDADERO;VERDADERO;-23;;;
38593;38616;0;5827;VERDADERO;VERDADERO;-23;;;
38593;38616;0;5828;VERDADERO;VERDADERO;-23;;;
38593;38636;0;5829;VERDADERO;VERDADERO;-43;;;
38629;38636;0;5830;VERDADERO;VERDADERO;-7;;;
38629;38636;0;5831;VERDADERO;VERDADERO;-7;;;
38629;38656;0;5832;VERDADERO;VERDADERO;-27;;;
38629;38656;0;5833;VERDADERO;VERDADERO;-27;;;
38629;38676;0;5834;VERDADERO;VERDADERO;-47;;;
38662;38676;0;5835;VERDADERO;VERDADERO;-14;;;
38662;38676;0;5836;VERDADERO;VERDADERO;-14;;;
38662;38696;0;5837;VERDADERO;VERDADERO;-34;;;
38662;38696;0;5838;VERDADERO;VERDADERO;-34;;;
38662;38716;0;5839;VERDADERO;FALSO;-54;;;
38697;38716;0;5840;VERDADERO;VERDADERO;-19;;;
38697;38716;0;5841;VERDADERO;VERDADERO;-19;;;
38697;38716;0;5842;VERDADERO;VERDADERO;-19;;;
38697;38716;0;5843;VERDADERO;VERDADERO;-19;;;
38697;38736;0;5844;VERDADERO;VERDADERO;-39;;;
38729;38736;0;5845;VERDADERO;VERDADERO;-7;;;
38729;38736;0;5846;VERDADERO;VERDADERO;-7;;;
38729;38756;0;5847;VERDADERO;VERDADERO;-27;;;
38729;38756;0;5848;VERDADERO;VERDADERO;-27;;;
38729;38776;0;5849;VERDADERO;VERDADERO;-47;;;
38761;38776;0;5850;VERDADERO;VERDADERO;-15;;;
38761;38776;0;5851;VERDADERO;VERDADERO;-15;;;
38761;38796;0;5852;VERDADERO;VERDADERO;-35;;;
38761;38796;0;5853;VERDADERO;VERDADERO;-35;;;
38761;38816;1;5854;VERDADERO;FALSO;-55;;;
38793;38816;0;5855;VERDADERO;VERDADERO;-23;;;
38793;38816;0;5856;VERDADERO;VERDADERO;-23;;;
38793;38816;0;5857;VERDADERO;VERDADERO;-23;;;
38793;38816;0;5858;VERDADERO;VERDADERO;-23;;;
38793;38816;0;5859;VERDADERO;VERDADERO;-23;;;
38793;38836;0;5860;VERDADERO;VERDADERO;-43;;;
38825;38836;0;5861;VERDADERO;VERDADERO;-11;;;
38825;38836;0;5862;VERDADERO;VERDADERO;-11;;;
38825;38856;0;5863;VERDADERO;VERDADERO;-31;;;
38825;38856;0;5864;VERDADERO;VERDADERO;-31;;;
38825;38856;0;5865;VERDADERO;VERDADERO;-31;;;
38861;38856;0;5866;VERDADERO;VERDADERO;5;;;
38861;38876;0;5867;VERDADERO;VERDADERO;-15;;;
38861;38876;0;5868;VERDADERO;VERDADERO;-15;;;
38861;38896;0;5869;VERDADERO;VERDADERO;-35;;;
38861;38896;0;5870;VERDADERO;VERDADERO;-35;;;
38893;38896;0;5871;VERDADERO;VERDADERO;-3;;;
38893;38916;0;5872;VERDADERO;VERDADERO;-23;;;
38893;38916;0;5873;VERDADERO;VERDADERO;-23;;;
38893;38916;0;5874;VERDADERO;VERDADERO;-23;;;
38893;38936;0;5875;VERDADERO;VERDADERO;-43;;;
38925;38936;0;5876;VERDADERO;VERDADERO;-11;;;
38925;38956;0;5877;VERDADERO;VERDADERO;-31;;;
38925;38956;0;5878;VERDADERO;VERDADERO;-31;;;
38925;38956;0;5879;VERDADERO;VERDADERO;-31;;;
38925;38956;0;5880;VERDADERO;VERDADERO;-31;;;
38925;38956;0;5881;VERDADERO;VERDADERO;-31;;;
38961;38956;0;5882;VERDADERO;VERDADERO;5;;;
38961;38976;0;5883;VERDADERO;VERDADERO;-15;;;
38961;38976;0;5884;VERDADERO;VERDADERO;-15;;;
38961;38996;0;5885;VERDADERO;VERDADERO;-35;;;
38961;38996;0;5886;VERDADERO;VERDADERO;-35;;;
38993;38996;0;5887;VERDADERO;VERDADERO;-3;;;
38993;39016;0;5888;VERDADERO;VERDADERO;-23;;;
38993;39016;0;5889;VERDADERO;VERDADERO;-23;;;
38993;39036;0;5890;VERDADERO;VERDADERO;-43;;;
38993;39036;0;5891;VERDADERO;VERDADERO;-43;;;
39025;39036;0;5892;VERDADERO;VERDADERO;-11;;;
39025;39056;0;5893;VERDADERO;VERDADERO;-31;;;
39025;39056;0;5894;VERDADERO;VERDADERO;-31;;;
39025;39056;0;5895;VERDADERO;VERDADERO;-31;;;
39025;39076;0;5896;VERDADERO;FALSO;-51;;;
39025;39076;0;5897;VERDADERO;FALSO;-51;;;
39061;39076;0;5898;VERDADERO;VERDADERO;-15;;;
39061;39096;0;5899;VERDADERO;VERDADERO;-35;;;
39061;39096;0;5900;VERDADERO;VERDADERO;-35;;;
39061;39096;0;5901;VERDADERO;VERDADERO;-35;;;
39061;39096;0;5902;VERDADERO;VERDADERO;-35;;;
39093;39116;1;5903;VERDADERO;VERDADERO;-23;;;
39093;39116;0;5904;VERDADERO;VERDADERO;-23;;;
39093;39116;0;5905;VERDADERO;VERDADERO;-23;;;
39093;39136;1;5906;VERDADERO;VERDADERO;-43;;;
39093;39136;0;5907;VERDADERO;VERDADERO;-43;;;
39125;39136;0;5908;VERDADERO;VERDADERO;-11;;;
39125;39136;0;5909;VERDADERO;VERDADERO;-11;;;
39125;39156;0;5910;VERDADERO;VERDADERO;-31;;;
39125;39156;0;5911;VERDADERO;VERDADERO;-31;;;
39125;39176;0;5912;VERDADERO;FALSO;-51;;;
39161;39176;0;5913;VERDADERO;VERDADERO;-15;;;
39161;39176;0;5914;VERDADERO;VERDADERO;-15;;;
39161;39176;0;5915;VERDADERO;VERDADERO;-15;;;
39161;39176;0;5916;VERDADERO;VERDADERO;-15;;;
39161;39176;0;5917;VERDADERO;VERDADERO;-15;;;
39161;39196;0;5918;VERDADERO;VERDADERO;-35;;;
39193;39196;0;5919;VERDADERO;VERDADERO;-3;;;
39193;39217;0;5920;VERDADERO;VERDADERO;-24;;;
39193;39217;0;5921;VERDADERO;VERDADERO;-24;;;
39193;39217;0;5922;VERDADERO;VERDADERO;-24;;;
39193;39237;1;5923;VERDADERO;VERDADERO;-44;;;
39227;39237;0;5924;VERDADERO;VERDADERO;-10;;;
39227;39237;0;5925;VERDADERO;VERDADERO;-10;;;
39227;39257;0;5926;VERDADERO;VERDADERO;-30;;;
39227;39257;0;5927;VERDADERO;VERDADERO;-30;;;
39227;39257;0;5928;VERDADERO;VERDADERO;-30;;;
39261;39277;0;5929;VERDADERO;VERDADERO;-16;;;
39261;39277;0;5930;VERDADERO;VERDADERO;-16;;;
39261;39277;0;5931;VERDADERO;VERDADERO;-16;;;
39261;39277;0;5932;VERDADERO;VERDADERO;-16;;;
39261;39277;0;5933;VERDADERO;VERDADERO;-16;;;
39261;39277;0;5934;VERDADERO;VERDADERO;-16;;;
39293;39297;1;5935;VERDADERO;VERDADERO;-4;;;
39293;39297;0;5936;VERDADERO;VERDADERO;-4;;;
39293;39317;1;5937;VERDADERO;VERDADERO;-24;;;
39293;39317;0;5938;VERDADERO;VERDADERO;-24;;;
39293;39317;0;5939;VERDADERO;VERDADERO;-24;;;
39293;39337;0;5940;VERDADERO;VERDADERO;-44;;;
39329;39337;0;5941;VERDADERO;VERDADERO;-8;;;
39329;39357;0;5942;VERDADERO;VERDADERO;-28;;;
39329;39357;0;5943;VERDADERO;VERDADERO;-28;;;
39329;39357;0;5944;VERDADERO;VERDADERO;-28;;;
39361;39377;0;5945;VERDADERO;VERDADERO;-16;;;
39361;39377;0;5946;VERDADERO;VERDADERO;-16;;;
39361;39397;0;5947;VERDADERO;VERDADERO;-36;;;
39361;39397;0;5948;VERDADERO;VERDADERO;-36;;;
39361;39397;0;5949;VERDADERO;VERDADERO;-36;;;
39393;39417;1;5950;VERDADERO;VERDADERO;-24;;;
39393;39417;0;5951;VERDADERO;VERDADERO;-24;;;
39393;39417;0;5952;VERDADERO;VERDADERO;-24;;;
39393;39437;1;5953;VERDADERO;VERDADERO;-44;;;
39393;39437;0;5954;VERDADERO;VERDADERO;-44;;;
39393;39437;0;5955;VERDADERO;VERDADERO;-44;;;
39429;39437;0;5956;VERDADERO;VERDADERO;-8;;;
39429;39437;0;5957;VERDADERO;VERDADERO;-8;;;
39429;39457;1;5958;VERDADERO;VERDADERO;-28;;;
39429;39457;0;5959;VERDADERO;VERDADERO;-28;;;
39429;39477;0;5960;VERDADERO;VERDADERO;-48;;;
39462;39477;0;5961;VERDADERO;VERDADERO;-15;;;
39462;39477;0;5962;VERDADERO;VERDADERO;-15;;;
39462;39477;0;5963;VERDADERO;VERDADERO;-15;;;
39462;39477;0;5964;VERDADERO;VERDADERO;-15;;;
39462;39477;0;5965;VERDADERO;VERDADERO;-15;;;
39493;39477;0;5966;VERDADERO;VERDADERO;16;;;
39493;39477;0;5967;VERDADERO;VERDADERO;16;;;
39493;39497;0;5968;VERDADERO;VERDADERO;-4;;;
39493;39497;0;5969;VERDADERO;VERDADERO;-4;;;
39493;39518;0;5970;VERDADERO;VERDADERO;-25;;;
39493;39518;0;5971;VERDADERO;VERDADERO;-25;;;
39529;39518;0;5972;VERDADERO;VERDADERO;11;;;
39529;39538;0;5973;VERDADERO;VERDADERO;-9;;;
39529;39538;0;5974;VERDADERO;VERDADERO;-9;;;
39529;39538;0;5975;VERDADERO;VERDADERO;-9;;;
39529;39538;0;5976;VERDADERO;VERDADERO;-9;;;
39560;39538;0;5977;VERDADERO;VERDADERO;22;;;
39560;39538;0;5978;VERDADERO;VERDADERO;22;;;
39560;39538;0;5979;VERDADERO;VERDADERO;22;;;
39560;39538;0;5980;VERDADERO;VERDADERO;22;;;
39560;39538;0;5981;VERDADERO;VERDADERO;22;;;
39592;39538;0;5982;FALSO;VERDADERO;54;;;
39592;39538;0;5983;FALSO;VERDADERO;54;;;
39592;39558;0;5984;VERDADERO;VERDADERO;34;;;
39592;39558;0;5985;VERDADERO;VERDADERO;34;;;
39592;39558;0;5986;VERDADERO;VERDADERO;34;;;
39625;39578;1;5987;VERDADERO;VERDADERO;47;;;
39625;39578;0;5988;VERDADERO;VERDADERO;47;;;
39625;39598;0;5989;VERDADERO;VERDADERO;27;;;
39625;39598;0;5990;VERDADERO;VERDADERO;27;;;
39625;39598;0;5991;VERDADERO;VERDADERO;27;;;
39657;39598;0;5992;FALSO;VERDADERO;59;;;
39657;39618;0;5993;VERDADERO;VERDADERO;39;;;
39657;39618;0;5994;VERDADERO;VERDADERO;39;;;
39657;39638;0;5995;VERDADERO;VERDADERO;19;;;
39657;39638;0;5996;VERDADERO;VERDADERO;19;;;
39657;39638;0;5997;VERDADERO;VERDADERO;19;;;
39693;39658;1;5998;VERDADERO;VERDADERO;35;;;
39693;39658;0;5999;VERDADERO;VERDADERO;35;;;
39693;39678;0;6000;VERDADERO;VERDADERO;15;;;
39693;39678;0;6001;VERDADERO;VERDADERO;15;;;
39693;39678;0;6002;VERDADERO;VERDADERO;15;;;
39725;39698;1;6003;VERDADERO;VERDADERO;27;;;
39725;39698;0;6004;VERDADERO;VERDADERO;27;;;
39725;39698;0;6005;VERDADERO;VERDADERO;27;;;
39725;39718;0;6006;VERDADERO;VERDADERO;7;;;
39725;39718;0;6007;VERDADERO;VERDADERO;7;;;
39757;39739;0;6008;VERDADERO;VERDADERO;18;;;
39757;39739;0;6009;VERDADERO;VERDADERO;18;;;
39757;39739;0;6010;VERDADERO;VERDADERO;18;;;
39757;39759;0;6011;VERDADERO;VERDADERO;-2;;;
39757;39759;0;6012;VERDADERO;VERDADERO;-2;;;
39757;39759;0;6013;VERDADERO;VERDADERO;-2;;;
39793;39759;0;6014;VERDADERO;VERDADERO;34;;;
39793;39779;0;6015;VERDADERO;VERDADERO;14;;;
39793;39779;0;6016;VERDADERO;VERDADERO;14;;;
39793;39799;0;6017;VERDADERO;VERDADERO;-6;;;
39793;39799;0;6018;VERDADERO;VERDADERO;-6;;;
39824;39799;0;6019;VERDADERO;VERDADERO;25;;;
39824;39819;0;6020;VERDADERO;VERDADERO;5;;;
39824;39819;0;6021;VERDADERO;VERDADERO;5;;;
39824;39839;0;6022;VERDADERO;VERDADERO;-15;;;
39824;39839;0;6023;VERDADERO;VERDADERO;-15;;;
39857;39839;0;6024;VERDADERO;VERDADERO;18;;;
39857;39859;0;6025;VERDADERO;VERDADERO;-2;;;
39857;39859;0;6026;VERDADERO;VERDADERO;-2;;;
39857;39879;1;6027;VERDADERO;VERDADERO;-22;;;
39857;39879;0;6028;VERDADERO;VERDADERO;-22;;;
39889;39879;0;6029;VERDADERO;VERDADERO;10;;;
39889;39899;0;6030;VERDADERO;VERDADERO;-10;;;
39889;39899;0;6031;VERDADERO;VERDADERO;-10;;;
39889;39919;0;6032;VERDADERO;VERDADERO;-30;;;
39889;39919;0;6033;VERDADERO;VERDADERO;-30;;;
39921;39919;0;6034;VERDADERO;VERDADERO;2;;;
39921;39939;0;6035;VERDADERO;VERDADERO;-18;;;
39921;39939;0;6036;VERDADERO;VERDADERO;-18;;;
39921;39939;0;6037;VERDADERO;VERDADERO;-18;;;
39921;39939;0;6038;VERDADERO;VERDADERO;-18;;;
39921;39939;0;6039;VERDADERO;VERDADERO;-18;;;
39957;39939;0;6040;VERDADERO;VERDADERO;18;;;
39957;39939;0;6041;VERDADERO;VERDADERO;18;;;
39957;39939;0;6042;VERDADERO;VERDADERO;18;;;
39957;39939;0;6043;VERDADERO;VERDADERO;18;;;
39957;39959;0;6044;VERDADERO;VERDADERO;-2;;;
39989;39959;0;6045;VERDADERO;VERDADERO;30;;;
39989;39979;0;6046;VERDADERO;VERDADERO;10;;;
39989;39979;0;6047;VERDADERO;VERDADERO;10;;;
39989;39979;0;6048;VERDADERO;VERDADERO;10;;;
40021;39979;0;6049;VERDADERO;VERDADERO;42;;;
40021;39979;0;6050;VERDADERO;VERDADERO;42;;;
40021;39979;0;6051;VERDADERO;VERDADERO;42;;;
40021;39979;0;6052;VERDADERO;VERDADERO;42;;;
40021;39979;0;6053;VERDADERO;VERDADERO;42;;;
40021;39979;0;6054;VERDADERO;VERDADERO;42;;;
40052;39999;0;6055;FALSO;VERDADERO;53;;;
40052;39999;0;6056;FALSO;VERDADERO;53;;;
40052;40019;0;6057;VERDADERO;VERDADERO;33;;;
40052;40019;0;6058;VERDADERO;VERDADERO;33;;;
40052;40019;0;6059;VERDADERO;VERDADERO;33;;;
40087;40039;1;6060;VERDADERO;VERDADERO;48;;;
40087;40039;0;6061;VERDADERO;VERDADERO;48;;;
40087;40059;0;6062;VERDADERO;VERDADERO;28;;;
40087;40059;0;6063;VERDADERO;VERDADERO;28;;;
40087;40059;0;6064;VERDADERO;VERDADERO;28;;;
40087;40079;0;6065;VERDADERO;VERDADERO;8;;;
40121;40079;0;6066;VERDADERO;VERDADERO;42;;;
40121;40079;0;6067;VERDADERO;VERDADERO;42;;;
40121;40079;0;6068;VERDADERO;VERDADERO;42;;;
40121;40079;0;6069;VERDADERO;VERDADERO;42;;;
40121;40079;0;6070;VERDADERO;VERDADERO;42;;;
40153;40099;0;6071;FALSO;VERDADERO;54;;;
40153;40099;0;6072;FALSO;VERDADERO;54;;;
40153;40119;1;6073;VERDADERO;VERDADERO;34;;;
40153;40119;0;6074;VERDADERO;VERDADERO;34;;;
40153;40119;0;6075;VERDADERO;VERDADERO;34;;;
40153;40139;1;6076;VERDADERO;VERDADERO;14;;;
40189;40139;0;6077;FALSO;VERDADERO;50;;;
40189;40139;0;6078;FALSO;VERDADERO;50;;;
40189;40139;0;6079;FALSO;VERDADERO;50;;;
40189;40139;0;6080;FALSO;VERDADERO;50;;;
40189;40139;0;6081;FALSO;VERDADERO;50;;;
40221;40139;0;6082;FALSO;VERDADERO;82;;;
40221;40139;0;6083;FALSO;VERDADERO;82;;;
40221;40139;0;6084;FALSO;VERDADERO;82;;;
40221;40139;0;6085;FALSO;VERDADERO;82;;;
40221;40139;0;6086;FALSO;VERDADERO;82;;;
40221;40139;0;6087;FALSO;VERDADERO;82;;;
40256;40139;0;6088;FALSO;VERDADERO;117;;;
40256;40139;0;6089;FALSO;VERDADERO;117;;;
40256;40139;0;6090;FALSO;VERDADERO;117;;;
40256;40139;0;6091;FALSO;VERDADERO;117;;;
40256;40139;0;6092;FALSO;VERDADERO;117;;;
40290;40139;0;6093;FALSO;VERDADERO;151;;;
40290;40139;0;6094;FALSO;VERDADERO;151;;;
40290;40139;0;6095;FALSO;VERDADERO;151;;;
40290;40139;0;6096;FALSO;VERDADERO;151;;;
40290;40139;0;6097;FALSO;VERDADERO;151;;;
40321;40139;0;6098;FALSO;VERDADERO;182;;;
40321;40139;0;6099;FALSO;VERDADERO;182;;;
40321;40139;0;6100;FALSO;VERDADERO;182;;;
40321;40139;0;6101;FALSO;VERDADERO;182;;;
40321;40139;0;6102;FALSO;VERDADERO;182;;;
40321;40139;0;6103;FALSO;VERDADERO;182;;;
40357;40159;0;6104;FALSO;VERDADERO;198;;;
40357;40159;0;6105;FALSO;VERDADERO;198;;;
40357;40159;0;6106;FALSO;VERDADERO;198;;;
40357;40179;0;6107;FALSO;VERDADERO;178;;;
40357;40179;0;6108;FALSO;VERDADERO;178;;;
40389;40199;0;6109;FALSO;VERDADERO;190;;;
40389;40199;0;6110;FALSO;VERDADERO;190;;;
40389;40199;0;6111;FALSO;VERDADERO;190;;;
40389;40219;0;6112;FALSO;VERDADERO;170;;;
40389;40219;0;6113;FALSO;VERDADERO;170;;;
40389;40239;0;6114;FALSO;VERDADERO;150;;;
40425;40239;0;6115;FALSO;VERDADERO;186;;;
40425;40239;0;6116;FALSO;VERDADERO;186;;;
40425;40259;1;6117;FALSO;VERDADERO;166;;;
40425;40259;0;6118;FALSO;VERDADERO;166;;;
40425;40279;0;6119;FALSO;VERDADERO;146;;;
40457;40279;0;6120;FALSO;VERDADERO;178;;;
40457;40279;0;6121;FALSO;VERDADERO;178;;;
40457;40299;0;6122;FALSO;VERDADERO;158;;;
40457;40299;0;6123;FALSO;VERDADERO;158;;;
40457;40319;1;6124;FALSO;VERDADERO;138;;;
40493;40319;0;6125;FALSO;VERDADERO;174;;;
40493;40319;0;6126;FALSO;VERDADERO;174;;;
40493;40339;0;6127;FALSO;VERDADERO;154;;;
40493;40339;0;6128;FALSO;VERDADERO;154;;;
40493;40359;0;6129;FALSO;VERDADERO;134;;;
40525;40359;0;6130;FALSO;VERDADERO;166;;;
40525;40359;0;6131;FALSO;VERDADERO;166;;;
40525;40379;0;6132;FALSO;VERDADERO;146;;;
40525;40379;0;6133;FALSO;VERDADERO;146;;;
40525;40399;1;6134;FALSO;VERDADERO;126;;;
40557;40399;0;6135;FALSO;VERDADERO;158;;;
40557;40399;0;6136;FALSO;VERDADERO;158;;;
40557;40419;0;6137;FALSO;VERDADERO;138;;;
40557;40419;0;6138;FALSO;VERDADERO;138;;;
40557;40439;0;6139;FALSO;VERDADERO;118;;;
40589;40439;0;6140;FALSO;VERDADERO;150;;;
40589;40459;0;6141;FALSO;VERDADERO;130;;;
40589;40459;0;6142;FALSO;VERDADERO;130;;;
40589;40459;0;6143;FALSO;VERDADERO;130;;;
40589;40479;0;6144;FALSO;VERDADERO;110;;;
40621;40479;0;6145;FALSO;VERDADERO;142;;;
40621;40499;0,00E+00;6146;FALSO;VERDADERO;122;;;
40621;40499;0;6147;FALSO;VERDADERO;122;;;
40621;40499;0;6148;FALSO;VERDADERO;122;;;
40621;40519;1;6149;FALSO;VERDADERO;102;;;
40621;40519;0;6150;FALSO;VERDADERO;102;;;
40656;40539;0;6151;FALSO;VERDADERO;117;;;
40656;40539;0;6152;FALSO;VERDADERO;117;;;
40656;40539;0;6153;FALSO;VERDADERO;117;;;
40656;40559;0;6154;FALSO;VERDADERO;97;;;
40656;40559;0;6155;FALSO;VERDADERO;97;;;
40689;40579;0;6156;FALSO;VERDADERO;110;;;
40689;40579;0;6157;FALSO;VERDADERO;110;;;
40689;40579;0;6158;FALSO;VERDADERO;110;;;
40689;40599;0;6159;FALSO;VERDADERO;90;;;
40689;40599;0;6160;FALSO;VERDADERO;90;;;
40721;40620;0;6161;FALSO;VERDADERO;101;;;
40721;40620;0;6162;FALSO;VERDADERO;101;;;
40721;40620;0;6163;FALSO;VERDADERO;101;;;
40721;40640;1;6164;FALSO;VERDADERO;81;;;
40721;40640;0;6165;FALSO;VERDADERO;81;;;
40759;40660;0;6166;FALSO;VERDADERO;99;;;
40759;40660;0;6167;FALSO;VERDADERO;99;;;
40759;40680;0;6168;FALSO;VERDADERO;79;;;
40759;40680;0;6169;FALSO;VERDADERO;79;;;
40759;40680;0;6170;FALSO;VERDADERO;79;;;
40789;40700;0;6171;FALSO;VERDADERO;89;;;
40789;40700;0;6172;FALSO;VERDADERO;89;;;
40789;40720;0;6173;FALSO;VERDADERO;69;;;
40789;40720;0;6174;FALSO;VERDADERO;69;;;
40789;40720;0;6175;FALSO;VERDADERO;69;;;
40821;40740;0;6176;FALSO;VERDADERO;81;;;
40821;40740;0;6177;FALSO;VERDADERO;81;;;
40821;40760;0;6178;FALSO;VERDADERO;61;;;
40821;40760;0;6179;FALSO;VERDADERO;61;;;
40821;40760;0;6180;FALSO;VERDADERO;61;;;
40821;40780;0;6181;VERDADERO;VERDADERO;41;;;
40856;40780;0;6182;FALSO;VERDADERO;76;;;
40856;40800;0;6183;FALSO;VERDADERO;56;;;
40856;40800;0;6184;FALSO;VERDADERO;56;;;
40856;40820;1;6185;VERDADERO;VERDADERO;36;;;
40856;40820;0;6186;VERDADERO;VERDADERO;36;;;
40893;40820;0;6187;FALSO;VERDADERO;73;;;
40893;40840;1;6188;FALSO;VERDADERO;53;;;
40893;40840;0;6189;FALSO;VERDADERO;53;;;
40893;40860;0;6190;VERDADERO;VERDADERO;33;;;
40893;40860;0;6191;VERDADERO;VERDADERO;33;;;
40924;40860;0;6192;FALSO;VERDADERO;64;;;
40924;40880;0;6193;VERDADERO;VERDADERO;44;;;
40924;40880;0;6194;VERDADERO;VERDADERO;44;;;
40924;40900;0;6195;VERDADERO;VERDADERO;24;;;
40924;40900;0;6196;VERDADERO;VERDADERO;24;;;
40957;40900;0;6197;FALSO;VERDADERO;57;;;
40957;40920;0;6198;VERDADERO;VERDADERO;37;;;
40957;40920;0;6199;VERDADERO;VERDADERO;37;;;
40957;40940;0;6200;VERDADERO;VERDADERO;17;;;
40957;40940;0;6201;VERDADERO;VERDADERO;17;;;
40957;40940;0;6202;VERDADERO;VERDADERO;17;;;
40993;40960;0;6203;VERDADERO;VERDADERO;33;;;
40993;40960;0;6204;VERDADERO;VERDADERO;33;;;
40993;40980;0;6205;VERDADERO;VERDADERO;13;;;
40993;40980;0;6206;VERDADERO;VERDADERO;13;;;
40993;40980;0;6207;VERDADERO;VERDADERO;13;;;
40993;41000;0;6208;VERDADERO;VERDADERO;-7;;;
41029;41000;0;6209;VERDADERO;VERDADERO;29;;;
41029;41020;0;6210;VERDADERO;VERDADERO;9;;;
41029;41020;0;6211;VERDADERO;VERDADERO;9;;;
41029;41020;0;6212;VERDADERO;VERDADERO;9;;;
41029;41040;0;6213;VERDADERO;VERDADERO;-11;;;
41061;41040;0;6214;VERDADERO;VERDADERO;21;;;
41061;41060;0;6215;VERDADERO;VERDADERO;1;;;
41061;41060;0;6216;VERDADERO;VERDADERO;1;;;
41061;41060;0;6217;VERDADERO;VERDADERO;1;;;
41061;41080;0;6218;VERDADERO;VERDADERO;-19;;;
41097;41080;0;6219;VERDADERO;VERDADERO;17;;;
41097;41100;0;6220;VERDADERO;VERDADERO;-3;;;
41097;41100;0;6221;VERDADERO;VERDADERO;-3;;;
41097;41100;0;6222;VERDADERO;VERDADERO;-3;;;
41097;41120;0;6223;VERDADERO;VERDADERO;-23;;;
41129;41120;0;6224;VERDADERO;VERDADERO;9;;;
41129;41140;0;6225;VERDADERO;VERDADERO;-11;;;
41129;41140;0;6226;VERDADERO;VERDADERO;-11;;;
41129;41140;0;6227;VERDADERO;VERDADERO;-11;;;
41129;41160;0;6228;VERDADERO;VERDADERO;-31;;;
41161;41160;0;6229;VERDADERO;VERDADERO;1;;;
41161;41160;0;6230;VERDADERO;VERDADERO;1;;;
41161;41180;0;6231;VERDADERO;VERDADERO;-19;;;
41161;41180;0;6232;VERDADERO;VERDADERO;-19;;;
41161;41200;0;6233;VERDADERO;VERDADERO;-39;;;
41161;41200;0;6234;VERDADERO;VERDADERO;-39;;;
41196;41200;0;6235;VERDADERO;VERDADERO;-4;;;
41196;41200;0;6236;VERDADERO;VERDADERO;-4;;;
41196;41200;0;6237;VERDADERO;VERDADERO;-4;;;
41196;41200;0;6238;VERDADERO;VERDADERO;-4;;;
41196;41220;0;6239;VERDADERO;VERDADERO;-24;;;
41228;41220;0;6240;VERDADERO;VERDADERO;8;;;
41228;41241;1;6241;VERDADERO;VERDADERO;-13;;;
41228;41241;0;6242;VERDADERO;VERDADERO;-13;;;
41228;41241;0;6243;VERDADERO;VERDADERO;-13;;;
41228;41261;0;6244;VERDADERO;VERDADERO;-33;;;
41261;41261;0;6245;VERDADERO;VERDADERO;0;;;
41261;41261;0;6246;VERDADERO;VERDADERO;0;;;
41261;41281;0;6247;VERDADERO;VERDADERO;-20;;;
41261;41281;0;6248;VERDADERO;VERDADERO;-20;;;
41261;41301;0;6249;VERDADERO;VERDADERO;-40;;;
41292;41301;0;6250;VERDADERO;VERDADERO;-9;;;
41292;41301;0;6251;VERDADERO;VERDADERO;-9;;;
41292;41321;0;6252;VERDADERO;VERDADERO;-29;;;
41292;41321;0;6253;VERDADERO;VERDADERO;-29;;;
41292;41341;0;6254;VERDADERO;VERDADERO;-49;;;
41324;41341;0;6255;VERDADERO;VERDADERO;-17;;;
41324;41361;0;6256;VERDADERO;VERDADERO;-37;;;
41324;41361;0;6257;VERDADERO;VERDADERO;-37;;;
41324;41361;0;6258;VERDADERO;VERDADERO;-37;;;
41324;41361;0;6259;VERDADERO;VERDADERO;-37;;;
41324;41361;0;6260;VERDADERO;VERDADERO;-37;;;
41360;41361;0;6261;VERDADERO;VERDADERO;-1;;;
41360;41361;0;6262;VERDADERO;VERDADERO;-1;;;
41360;41361;0;6263;VERDADERO;VERDADERO;-1;;;
41360;41381;0;6264;VERDADERO;VERDADERO;-21;;;
41360;41381;0;6265;VERDADERO;VERDADERO;-21;;;
41393;41381;0;6266;VERDADERO;VERDADERO;12;;;
41393;41401;0;6267;VERDADERO;VERDADERO;-8;;;
41393;41401;0;6268;VERDADERO;VERDADERO;-8;;;
41393;41401;0;6269;VERDADERO;VERDADERO;-8;;;
41393;41401;0;6270;VERDADERO;VERDADERO;-8;;;
41425;41401;0;6271;VERDADERO;VERDADERO;24;;;
41425;41421;0;6272;VERDADERO;VERDADERO;4;;;
41425;41421;0;6273;VERDADERO;VERDADERO;4;;;
41425;41421;0;6274;VERDADERO;VERDADERO;4;;;
41425;41442;0;6275;VERDADERO;VERDADERO;-17;;;
41457;41442;0;6276;VERDADERO;VERDADERO;15;;;
41457;41462;0;6277;VERDADERO;VERDADERO;-5;;;
41457;41462;0;6278;VERDADERO;VERDADERO;-5;;;
41457;41462;0;6279;VERDADERO;VERDADERO;-5;;;
41457;41482;0;6280;VERDADERO;VERDADERO;-25;;;
41489;41482;0;6281;VERDADERO;VERDADERO;7;;;
41489;41502;0;6282;VERDADERO;VERDADERO;-13;;;
41489;41502;0;6283;VERDADERO;VERDADERO;-13;;;
41489;41502;0;6284;VERDADERO;VERDADERO;-13;;;
41489;41522;0;6285;VERDADERO;VERDADERO;-33;;;
41489;41522;0;6286;VERDADERO;VERDADERO;-33;;;
41525;41542;1;6287;VERDADERO;VERDADERO;-17;;;
41525;41542;0;6288;VERDADERO;VERDADERO;-17;;;
41525;41542;0;6289;VERDADERO;VERDADERO;-17;;;
41525;41562;0;6290;VERDADERO;VERDADERO;-37;;;
41525;41562;0;6291;VERDADERO;VERDADERO;-37;;;
41557;41582;0;6292;VERDADERO;VERDADERO;-25;;;
41557;41582;0;6293;VERDADERO;VERDADERO;-25;;;
41557;41582;0;6294;VERDADERO;VERDADERO;-25;;;
41557;41582;0;6295;VERDADERO;VERDADERO;-25;;;
41557;41602;0;6296;VERDADERO;VERDADERO;-45;;;
41557;41602;0;6297;VERDADERO;VERDADERO;-45;;;
41593;41622;0;6298;VERDADERO;VERDADERO;-29;;;
41593;41622;0;6299;VERDADERO;VERDADERO;-29;;;
41593;41622;0;6300;VERDADERO;VERDADERO;-29;;;
41593;41622;0;6301;VERDADERO;VERDADERO;-29;;;
41625;41622;0;6302;VERDADERO;VERDADERO;3;;;
41625;41642;0;6303;VERDADERO;VERDADERO;-17;;;
41625;41642;0;6304;VERDADERO;VERDADERO;-17;;;
41625;41662;0;6305;VERDADERO;VERDADERO;-37;;;
41625;41662;0;6306;VERDADERO;VERDADERO;-37;;;
41657;41662;0;6307;VERDADERO;VERDADERO;-5;;;
41657;41682;0;6308;VERDADERO;VERDADERO;-25;;;
41657;41682;0;6309;VERDADERO;VERDADERO;-25;;;
41657;41682;0;6310;VERDADERO;VERDADERO;-25;;;
41657;41682;0;6311;VERDADERO;VERDADERO;-25;;;
41657;41702;0;6312;VERDADERO;VERDADERO;-45;;;
41689;41702;0;6313;VERDADERO;VERDADERO;-13;;;
41689;41722;0;6314;VERDADERO;VERDADERO;-33;;;
41689;41722;0;6315;VERDADERO;VERDADERO;-33;;;
41689;41722;0;6316;VERDADERO;VERDADERO;-33;;;
41689;41722;0;6317;VERDADERO;VERDADERO;-33;;;
41726;41722;0;6318;VERDADERO;VERDADERO;4;;;
41726;41742;0;6319;VERDADERO;VERDADERO;-16;;;
41726;41742;0;6320;VERDADERO;VERDADERO;-16;;;
41726;41742;0;6321;VERDADERO;VERDADERO;-16;;;
41726;41762;0;6322;VERDADERO;VERDADERO;-36;;;
41757;41762;0;6323;VERDADERO;VERDADERO;-5;;;
41757;41782;0;6324;VERDADERO;VERDADERO;-25;;;
41757;41782;0;6325;VERDADERO;VERDADERO;-25;;;
41757;41782;0;6326;VERDADERO;VERDADERO;-25;;;
41757;41802;1;6327;VERDADERO;VERDADERO;-45;;;
41789;41802;0;6328;VERDADERO;VERDADERO;-13;;;
41789;41802;0;6329;VERDADERO;VERDADERO;-13;;;
41789;41822;0;6330;VERDADERO;VERDADERO;-33;;;
41789;41822;0;6331;VERDADERO;VERDADERO;-33;;;
41789;41822;0;6332;VERDADERO;VERDADERO;-33;;;
41789;41822;0;6333;VERDADERO;VERDADERO;-33;;;
41825;41842;0;6334;VERDADERO;VERDADERO;-17;;;
41825;41842;0;6335;VERDADERO;VERDADERO;-17;;;
41825;41862;0;6336;VERDADERO;VERDADERO;-37;;;
41825;41862;0;6337;VERDADERO;VERDADERO;-37;;;
41825;41862;0;6338;VERDADERO;VERDADERO;-37;;;
41859;41862;0;6339;VERDADERO;VERDADERO;-3;;;
41859;41862;0;6340;VERDADERO;VERDADERO;-3;;;
41859;41862;0;6341;VERDADERO;VERDADERO;-3;;;
41859;41862;0;6342;VERDADERO;VERDADERO;-3;;;
41859;41862;0;6343;VERDADERO;VERDADERO;-3;;;
41889;41862;0;6344;VERDADERO;VERDADERO;27;;;
41889;41882;1;6345;VERDADERO;VERDADERO;7;;;
41889;41882;0;6346;VERDADERO;VERDADERO;7;;;
41889;41902;0;6347;VERDADERO;VERDADERO;-13;;;
41889;41902;0;6348;VERDADERO;VERDADERO;-13;;;
41889;41902;0;6349;VERDADERO;VERDADERO;-13;;;
41925;41922;1;6350;VERDADERO;VERDADERO;3;;;
41925;41922;0;6351;VERDADERO;VERDADERO;3;;;
41925;41942;0;6352;VERDADERO;VERDADERO;-17;;;
41925;41942;0;6353;VERDADERO;VERDADERO;-17;;;
41925;41942;0;6354;VERDADERO;VERDADERO;-17;;;
41957;41962;0;6355;VERDADERO;VERDADERO;-5;;;
41957;41962;0;6356;VERDADERO;VERDADERO;-5;;;
41957;41982;0;6357;VERDADERO;VERDADERO;-25;;;
41957;41982;0;6358;VERDADERO;VERDADERO;-25;;;
41957;41982;0;6359;VERDADERO;VERDADERO;-25;;;
41989;42002;0;6360;VERDADERO;VERDADERO;-13;;;
41989;42002;0;6361;VERDADERO;VERDADERO;-13;;;
41989;42002;0;6362;VERDADERO;VERDADERO;-13;;;
41989;42022;0;6363;VERDADERO;VERDADERO;-33;;;
41989;42022;0;6364;VERDADERO;VERDADERO;-33;;;
41989;42042;0;6365;VERDADERO;FALSO;-53;;;
42025;42042;0;6366;VERDADERO;VERDADERO;-17;;;
42025;42042;0;6367;VERDADERO;VERDADERO;-17;;;
42025;42062;0;6368;VERDADERO;VERDADERO;-37;;;
42025;42062;0;6369;VERDADERO;VERDADERO;-37;;;
42025;42082;0;6370;VERDADERO;FALSO;-57;;;
42057;42082;0;6371;VERDADERO;VERDADERO;-25;;;
42057;42082;0;6372;VERDADERO;VERDADERO;-25;;;
42057;42082;0;6373;VERDADERO;VERDADERO;-25;;;
42057;42102;0;6374;VERDADERO;VERDADERO;-45;;;
42057;42102;0;6375;VERDADERO;VERDADERO;-45;;;
42089;42122;1;6376;VERDADERO;VERDADERO;-33;;;
42089;42122;0;6377;VERDADERO;VERDADERO;-33;;;
42089;42122;0;6378;VERDADERO;VERDADERO;-33;;;
42089;42122;0;6379;VERDADERO;VERDADERO;-33;;;
42089;42122;0;6380;VERDADERO;VERDADERO;-33;;;
42121;42122;0;6381;VERDADERO;VERDADERO;-1;;;
42121;42142;0;6382;VERDADERO;VERDADERO;-21;;;
42121;42142;0;6383;VERDADERO;VERDADERO;-21;;;
42121;42162;0;6384;VERDADERO;VERDADERO;-41;;;
42121;42162;0;6385;VERDADERO;VERDADERO;-41;;;
42153;42162;0;6386;VERDADERO;VERDADERO;-9;;;
42153;42182;0;6387;VERDADERO;VERDADERO;-29;;;
42153;42182;0;6388;VERDADERO;VERDADERO;-29;;;
42153;42202;0;6389;VERDADERO;VERDADERO;-49;;;
42153;42202;0;6390;VERDADERO;VERDADERO;-49;;;
42153;42222;0;6391;VERDADERO;FALSO;-69;;;
42188;42222;0;6392;VERDADERO;VERDADERO;-34;;;
42188;42222;0;6393;VERDADERO;VERDADERO;-34;;;
42188;42222;0;6394;VERDADERO;VERDADERO;-34;;;
42188;42222;0;6395;VERDADERO;VERDADERO;-34;;;
42188;42242;1;6396;VERDADERO;FALSO;-54;;;
42220;42242;0;6397;VERDADERO;VERDADERO;-22;;;
42220;42262;0;6398;VERDADERO;VERDADERO;-42;;;
42220;42262;0;6399;VERDADERO;VERDADERO;-42;;;
42220;42262;0;6400;VERDADERO;VERDADERO;-42;;;
42220;42262;0;6401;VERDADERO;VERDADERO;-42;;;
42253;42262;0;6402;VERDADERO;VERDADERO;-9;;;
42253;42262;0;6403;VERDADERO;VERDADERO;-9;;;
42253;42282;0;6404;VERDADERO;VERDADERO;-29;;;
42253;42282;0;6405;VERDADERO;VERDADERO;-29;;;
42253;42302;0;6406;VERDADERO;VERDADERO;-49;;;
42289;42302;0;6407;VERDADERO;VERDADERO;-13;;;
42289;42302;0;6408;VERDADERO;VERDADERO;-13;;;
42289;42302;0;6409;VERDADERO;VERDADERO;-13;;;
42289;42302;0;6410;VERDADERO;VERDADERO;-13;;;
42289;42302;0;6411;VERDADERO;VERDADERO;-13;;;
42289;42322;0;6412;VERDADERO;VERDADERO;-33;;;
42321;42322;0;6413;VERDADERO;VERDADERO;-1;;;
42321;42322;0;6414;VERDADERO;VERDADERO;-1;;;
42321;42342;0;6415;VERDADERO;VERDADERO;-21;;;
42321;42342;0;6416;VERDADERO;VERDADERO;-21;;;
42321;42362;0;6417;VERDADERO;VERDADERO;-41;;;
42352;42362;0;6418;VERDADERO;VERDADERO;-10;;;
42352;42362;0;6419;VERDADERO;VERDADERO;-10;;;
42352;42382;0;6420;VERDADERO;VERDADERO;-30;;;
42352;42382;0;6421;VERDADERO;VERDADERO;-30;;;
42352;42382;0;6422;VERDADERO;VERDADERO;-30;;;
42352;42402;1;6423;VERDADERO;FALSO;-50;;;
42389;42402;0;6424;VERDADERO;VERDADERO;-13;;;
42389;42422;0;6425;VERDADERO;VERDADERO;-33;;;
42389;42422;0;6426;VERDADERO;VERDADERO;-33;;;
42389;42422;0;6427;VERDADERO;VERDADERO;-33;;;
42389;42442;0;6428;VERDADERO;FALSO;-53;;;
42421;42442;0;6429;VERDADERO;VERDADERO;-21;;;
42421;42442;0;6430;VERDADERO;VERDADERO;-21;;;
42421;42462;0;6431;VERDADERO;VERDADERO;-41;;;
42421;42462;0;6432;VERDADERO;VERDADERO;-41;;;
42453;42462;0;6433;VERDADERO;VERDADERO;-9;;;
42453;42462;0;6434;VERDADERO;VERDADERO;-9;;;
42453;42482;0;6435;VERDADERO;VERDADERO;-29;;;
42453;42482;0;6436;VERDADERO;VERDADERO;-29;;;
42453;42482;0;6437;VERDADERO;VERDADERO;-29;;;
42453;42502;0;6438;VERDADERO;VERDADERO;-49;;;
42489;42502;0;6439;VERDADERO;VERDADERO;-13;;;
42489;42522;0;6440;VERDADERO;VERDADERO;-33;;;
42489;42522;0;6441;VERDADERO;VERDADERO;-33;;;
42489;42522;0;6442;VERDADERO;VERDADERO;-33;;;
42489;42542;0;6443;VERDADERO;FALSO;-53;;;
42521;42542;0;6444;VERDADERO;VERDADERO;-21;;;
42521;42562;0;6445;VERDADERO;VERDADERO;-41;;;
42521;42562;0;6446;VERDADERO;VERDADERO;-41;;;
42521;42562;0;6447;VERDADERO;VERDADERO;-41;;;
42521;42562;0;6448;VERDADERO;VERDADERO;-41;;;
42552;42582;0;6449;VERDADERO;VERDADERO;-30;;;
42552;42582;0;6450;VERDADERO;VERDADERO;-30;;;
42552;42582;0;6451;VERDADERO;VERDADERO;-30;;;
42552;42602;0;6452;VERDADERO;FALSO;-50;;;
42552;42602;0;6453;VERDADERO;FALSO;-50;;;
42552;42602;0;6454;VERDADERO;FALSO;-50;;;
42589;42602;0;6455;VERDADERO;VERDADERO;-13;;;
42589;42602;0;6456;VERDADERO;VERDADERO;-13;;;
42589;42622;1;6457;VERDADERO;VERDADERO;-33;;;
42589;42622;0;6458;VERDADERO;VERDADERO;-33;;;
42589;42622;0;6459;VERDADERO;VERDADERO;-33;;;
42621;42642;0;6460;VERDADERO;VERDADERO;-21;;;
42621;42642;0;6461;VERDADERO;VERDADERO;-21;;;
42621;42662;0;6462;VERDADERO;VERDADERO;-41;;;
42621;42662;0;6463;VERDADERO;VERDADERO;-41;;;
42621;42662;0;6464;VERDADERO;VERDADERO;-41;;;
42657;42682;0;6465;VERDADERO;VERDADERO;-25;;;
42657;42682;0;6466;VERDADERO;VERDADERO;-25;;;
42657;42682;0;6467;VERDADERO;VERDADERO;-25;;;
42657;42702;0;6468;VERDADERO;VERDADERO;-45;;;
42657;42702;0;6469;VERDADERO;VERDADERO;-45;;;
42689;42702;0;6470;VERDADERO;VERDADERO;-13;;;
42689;42702;0;6471;VERDADERO;VERDADERO;-13;;;
42689;42702;0;6472;VERDADERO;VERDADERO;-13;;;
42689;42722;1;6473;VERDADERO;VERDADERO;-33;;;
42689;42722;0;6474;VERDADERO;VERDADERO;-33;;;
42721;42742;0;6475;VERDADERO;VERDADERO;-21;;;
42721;42742;0;6476;VERDADERO;VERDADERO;-21;;;
42721;42742;0;6477;VERDADERO;VERDADERO;-21;;;
42721;42742;0;6478;VERDADERO;VERDADERO;-21;;;
42721;42742;0;6479;VERDADERO;VERDADERO;-21;;;
42721;42762;0;6480;VERDADERO;VERDADERO;-41;;;
42757;42762;0;6481;VERDADERO;VERDADERO;-5;;;
42757;42762;0;6482;VERDADERO;VERDADERO;-5;;;
42757;42783;0;6483;VERDADERO;VERDADERO;-26;;;
42757;42783;0;6484;VERDADERO;VERDADERO;-26;;;
42757;42803;0;6485;VERDADERO;VERDADERO;-46;;;
42790;42803;0;6486;VERDADERO;VERDADERO;-13;;;
42790;42803;0;6487;VERDADERO;VERDADERO;-13;;;
42790;42823;1;6488;VERDADERO;VERDADERO;-33;;;
42790;42823;0;6489;VERDADERO;VERDADERO;-33;;;
42790;42843;1;6490;VERDADERO;FALSO;-53;;;
42821;42843;0;6491;VERDADERO;VERDADERO;-22;;;
42821;42843;0;6492;VERDADERO;VERDADERO;-22;;;
42821;42843;0;6493;VERDADERO;VERDADERO;-22;;;
42821;42863;1;6494;VERDADERO;VERDADERO;-42;;;
42821;42863;0;6495;VERDADERO;VERDADERO;-42;;;
42821;42863;0;6496;VERDADERO;VERDADERO;-42;;;
42857;42883;0;6497;VERDADERO;VERDADERO;-26;;;
42857;42883;0;6498;VERDADERO;VERDADERO;-26;;;
42857;42883;0;6499;VERDADERO;VERDADERO;-26;;;
42857;42883;0;6500;VERDADERO;VERDADERO;-26;;;
42857;42903;0;6501;VERDADERO;VERDADERO;-46;;;
42889;42903;0;6502;VERDADERO;VERDADERO;-14;;;
42889;42903;0;6503;VERDADERO;VERDADERO;-14;;;
42889;42923;0;6504;VERDADERO;VERDADERO;-34;;;
42889;42923;0;6505;VERDADERO;VERDADERO;-34;;;
42889;42943;0;6506;VERDADERO;FALSO;-54;;;
42921;42943;0;6507;VERDADERO;VERDADERO;-22;;;
42921;42943;0;6508;VERDADERO;VERDADERO;-22;;;
42921;42963;0;6509;VERDADERO;VERDADERO;-42;;;
42921;42963;0;6510;VERDADERO;VERDADERO;-42;;;
42921;42983;1;6511;VERDADERO;FALSO;-62;;;
42952;42983;0;6512;VERDADERO;VERDADERO;-31;;;
42952;42983;0;6513;VERDADERO;VERDADERO;-31;;;
42952;42983;0;6514;VERDADERO;VERDADERO;-31;;;
42952;42983;0;6515;VERDADERO;VERDADERO;-31;;;
42952;42983;0;6516;VERDADERO;VERDADERO;-31;;;
42985;43003;0;6517;VERDADERO;VERDADERO;-18;;;
42985;43003;0;6518;VERDADERO;VERDADERO;-18;;;
42985;43023;0;6519;VERDADERO;VERDADERO;-38;;;
42985;43023;0;6520;VERDADERO;VERDADERO;-38;;;
42985;43023;0;6521;VERDADERO;VERDADERO;-38;;;
43017;43023;0;6522;VERDADERO;VERDADERO;-6;;;
43017;43023;0;6523;VERDADERO;VERDADERO;-6;;;
43017;43043;0;6524;VERDADERO;VERDADERO;-26;;;
43017;43043;0;6525;VERDADERO;VERDADERO;-26;;;
43017;43043;0;6526;VERDADERO;VERDADERO;-26;;;
43049;43063;0;6527;VERDADERO;VERDADERO;-14;;;
43049;43063;0;6528;VERDADERO;VERDADERO;-14;;;
43049;43083;0;6529;VERDADERO;VERDADERO;-34;;;
43049;43083;0;6530;VERDADERO;VERDADERO;-34;;;
43049;43083;0;6531;VERDADERO;VERDADERO;-34;;;
43049;43103;0;6532;VERDADERO;FALSO;-54;;;
43085;43103;0;6533;VERDADERO;VERDADERO;-18;;;
43085;43103;0;6534;VERDADERO;VERDADERO;-18;;;
43085;43123;0;6535;VERDADERO;VERDADERO;-38;;;
43085;43123;0;6536;VERDADERO;VERDADERO;-38;;;
43085;43123;0;6537;VERDADERO;VERDADERO;-38;;;
43117;43123;0;6538;VERDADERO;VERDADERO;-6;;;
43117;43123;0;6539;VERDADERO;VERDADERO;-6;;;
43117;43143;1;6540;VERDADERO;VERDADERO;-26;;;
43117;43143;0;6541;VERDADERO;VERDADERO;-26;;;
43117;43143;0;6542;VERDADERO;VERDADERO;-26;;;
43149;43163;0;6543;VERDADERO;VERDADERO;-14;;;
43149;43163;0;6544;VERDADERO;VERDADERO;-14;;;
43149;43183;0;6545;VERDADERO;VERDADERO;-34;;;
43149;43183;0;6546;VERDADERO;VERDADERO;-34;;;
43149;43183;0;6547;VERDADERO;VERDADERO;-34;;;
43149;43183;0;6548;VERDADERO;VERDADERO;-34;;;
43186;43183;0;6549;VERDADERO;VERDADERO;3;;;
43186;43203;0;6550;VERDADERO;VERDADERO;-17;;;
43186;43203;0;6551;VERDADERO;VERDADERO;-17;;;
43186;43203;0;6552;VERDADERO;VERDADERO;-17;;;
43186;43223;0;6553;VERDADERO;VERDADERO;-37;;;
43217;43223;0;6554;VERDADERO;VERDADERO;-6;;;
43217;43223;0;6555;VERDADERO;VERDADERO;-6;;;
43217;43223;0;6556;VERDADERO;VERDADERO;-6;;;
43217;43243;0;6557;VERDADERO;VERDADERO;-26;;;
43217;43243;0;6558;VERDADERO;VERDADERO;-26;;;
43249;43263;0;6559;VERDADERO;VERDADERO;-14;;;
43249;43263;0;6560;VERDADERO;VERDADERO;-14;;;
43249;43263;0;6561;VERDADERO;VERDADERO;-14;;;
43249;43283;1;6562;VERDADERO;VERDADERO;-34;;;
43249;43283;0;6563;VERDADERO;VERDADERO;-34;;;
43285;43303;0;6564;VERDADERO;VERDADERO;-18;;;
43285;43303;0;6565;VERDADERO;VERDADERO;-18;;;
43285;43303;0;6566;VERDADERO;VERDADERO;-18;;;
43285;43323;0;6567;VERDADERO;VERDADERO;-38;;;
43285;43323;0;6568;VERDADERO;VERDADERO;-38;;;
43285;43343;0;6569;VERDADERO;FALSO;-58;;;
43321;43343;0;6570;VERDADERO;VERDADERO;-22;;;
43321;43343;0;6571;VERDADERO;VERDADERO;-22;;;
43321;43363;0;6572;VERDADERO;VERDADERO;-42;;;
43321;43363;0;6573;VERDADERO;VERDADERO;-42;;;
43321;43383;0;6574;VERDADERO;FALSO;-62;;;
43353;43383;0;6575;VERDADERO;VERDADERO;-30;;;
43353;43383;0;6576;VERDADERO;VERDADERO;-30;;;
43353;43383;0;6577;VERDADERO;VERDADERO;-30;;;
43353;43403;0;6578;VERDADERO;FALSO;-50;;;
43353;43403;0;6579;VERDADERO;FALSO;-50;;;
43385;43403;0;6580;VERDADERO;VERDADERO;-18;;;
43385;43423;0;6581;VERDADERO;VERDADERO;-38;;;
43385;43423;0;6582;VERDADERO;VERDADERO;-38;;;
43385;43423;0;6583;VERDADERO;VERDADERO;-38;;;
43385;43423;0;6584;VERDADERO;VERDADERO;-38;;;
43385;43423;0;6585;VERDADERO;VERDADERO;-38;;;
43421;43443;0;6586;VERDADERO;VERDADERO;-22;;;
43421;43443;0;6587;VERDADERO;VERDADERO;-22;;;
43421;43443;0;6588;VERDADERO;VERDADERO;-22;;;
43421;43463;0;6589;VERDADERO;VERDADERO;-42;;;
43421;43463;0;6590;VERDADERO;VERDADERO;-42;;;
43453;43463;0;6591;VERDADERO;VERDADERO;-10;;;
43453;43463;0;6592;VERDADERO;VERDADERO;-10;;;
43453;43463;0;6593;VERDADERO;VERDADERO;-10;;;
43453;43483;0;6594;VERDADERO;VERDADERO;-30;;;
43453;43483;0;6595;VERDADERO;VERDADERO;-30;;;
43453;43503;0;6596;VERDADERO;FALSO;-50;;;
43489;43503;0;6597;VERDADERO;VERDADERO;-14;;;
43489;43503;0;6598;VERDADERO;VERDADERO;-14;;;
43489;43523;0;6599;VERDADERO;VERDADERO;-34;;;
43489;43523;0;6600;VERDADERO;VERDADERO;-34;;;
43521;43523;0;6601;VERDADERO;VERDADERO;-2;;;
43521;43543;0;6602;VERDADERO;VERDADERO;-22;;;
43521;43543;0;6603;VERDADERO;VERDADERO;-22;;;
43521;43563;0;6604;VERDADERO;VERDADERO;-42;;;
43521;43563;0;6605;VERDADERO;VERDADERO;-42;;;
43521;43563;0;6606;VERDADERO;VERDADERO;-42;;;
43557;43563;0;6607;VERDADERO;VERDADERO;-6;;;
43557;43563;0;6608;VERDADERO;VERDADERO;-6;;;
43557;43563;0;6609;VERDADERO;VERDADERO;-6;;;
43557;43583;0;6610;VERDADERO;VERDADERO;-26;;;
43557;43583;0;6611;VERDADERO;VERDADERO;-26;;;
43589;43603;0;6612;VERDADERO;VERDADERO;-14;;;
43589;43603;0;6613;VERDADERO;VERDADERO;-14;;;
43589;43603;0;6614;VERDADERO;VERDADERO;-14;;;
43589;43623;0;6615;VERDADERO;VERDADERO;-34;;;
43589;43623;0;6616;VERDADERO;VERDADERO;-34;;;
43621;43623;0;6617;VERDADERO;VERDADERO;-2;;;
43621;43643;0;6618;VERDADERO;VERDADERO;-22;;;
43621;43643;0;6619;VERDADERO;VERDADERO;-22;;;
43621;43643;0;6620;VERDADERO;VERDADERO;-22;;;
43621;43663;0;6621;VERDADERO;VERDADERO;-42;;;
43621;43663;0;6622;VERDADERO;VERDADERO;-42;;;
43656;43663;0;6623;VERDADERO;VERDADERO;-7;;;
43656;43663;0;6624;VERDADERO;VERDADERO;-7;;;
43656;43663;0;6625;VERDADERO;VERDADERO;-7;;;
43656;43663;0;6626;VERDADERO;VERDADERO;-7;;;
43656;43683;1;6627;VERDADERO;VERDADERO;-27;;;
43689;43683;0;6628;VERDADERO;VERDADERO;6;;;
43689;43703;1;6629;VERDADERO;VERDADERO;-14;;;
43689;43703;0;6630;VERDADERO;VERDADERO;-14;;;
43689;43703;0;6631;VERDADERO;VERDADERO;-14;;;
43689;43723;0;6632;VERDADERO;VERDADERO;-34;;;
43721;43723;0;6633;VERDADERO;VERDADERO;-2;;;
43721;43723;0;6634;VERDADERO;VERDADERO;-2;;;
43721;43743;0;6635;VERDADERO;VERDADERO;-22;;;
43721;43743;0;6636;VERDADERO;VERDADERO;-22;;;
43721;43763;0;6637;VERDADERO;VERDADERO;-42;;;
43721;43763;0;6638;VERDADERO;VERDADERO;-42;;;
43757;43763;0;6639;VERDADERO;VERDADERO;-6;;;
43757;43783;0;6640;VERDADERO;VERDADERO;-26;;;
43757;43783;0;6641;VERDADERO;VERDADERO;-26;;;
43757;43803;0;6642;VERDADERO;VERDADERO;-46;;;
43757;43803;0;6643;VERDADERO;VERDADERO;-46;;;
43789;43823;0;6644;VERDADERO;VERDADERO;-34;;;
43789;43823;0;6645;VERDADERO;VERDADERO;-34;;;
43789;43823;0;6646;VERDADERO;VERDADERO;-34;;;
43789;43823;0;6647;VERDADERO;VERDADERO;-34;;;
43789;43823;0;6648;VERDADERO;VERDADERO;-34;;;
43821;43823;0;6649;VERDADERO;VERDADERO;-2;;;
43821;43843;0;6650;VERDADERO;VERDADERO;-22;;;
43821;43843;0;6651;VERDADERO;VERDADERO;-22;;;
43821;43843;0;6652;VERDADERO;VERDADERO;-22;;;
43821;43863;0;6653;VERDADERO;VERDADERO;-42;;;
43853;43863;0;6654;VERDADERO;VERDADERO;-10;;;
43853;43863;0;6655;VERDADERO;VERDADERO;-10;;;
43853;43863;0;6656;VERDADERO;VERDADERO;-10;;;
43853;43863;0;6657;VERDADERO;VERDADERO;-10;;;
43853;43883;0;6658;VERDADERO;VERDADERO;-30;;;
43885;43883;0;6659;VERDADERO;VERDADERO;2;;;
43885;43883;0;6660;VERDADERO;VERDADERO;2;;;
43885;43903;0;6661;VERDADERO;VERDADERO;-18;;;
43885;43903;0;6662;VERDADERO;VERDADERO;-18;;;
43885;43923;0;6663;VERDADERO;VERDADERO;-38;;;
43921;43923;0;6664;VERDADERO;VERDADERO;-2;;;
43921;43923;0;6665;VERDADERO;VERDADERO;-2;;;
43921;43923;0;6666;VERDADERO;VERDADERO;-2;;;
43921;43923;0;6667;VERDADERO;VERDADERO;-2;;;
43921;43923;0;6668;VERDADERO;VERDADERO;-2;;;
43921;43923;0;6669;VERDADERO;VERDADERO;-2;;;
43953;43943;1;6670;VERDADERO;VERDADERO;10;;;
43953;43943;0;6671;VERDADERO;VERDADERO;10;;;
43953;43963;1;6672;VERDADERO;VERDADERO;-10;;;
43953;43963;0;6673;VERDADERO;VERDADERO;-10;;;
43953;43983;0;6674;VERDADERO;VERDADERO;-30;;;
43985;43983;0;6675;VERDADERO;VERDADERO;2;;;
43985;43983;0;6676;VERDADERO;VERDADERO;2;;;
43985;44003;0;6677;VERDADERO;VERDADERO;-18;;;
43985;44003;0;6678;VERDADERO;VERDADERO;-18;;;
43985;44003;0;6679;VERDADERO;VERDADERO;-18;;;
44017;44023;0;6680;VERDADERO;VERDADERO;-6;;;
44017;44023;0;6681;VERDADERO;VERDADERO;-6;;;
44017;44043;0;6682;VERDADERO;VERDADERO;-26;;;
44017;44043;0;6683;VERDADERO;VERDADERO;-26;;;
44017;44043;0;6684;VERDADERO;VERDADERO;-26;;;
44049;44063;0;6685;VERDADERO;VERDADERO;-14;;;
44049;44063;0;6686;VERDADERO;VERDADERO;-14;;;
44049;44063;0;6687;VERDADERO;VERDADERO;-14;;;
44049;44083;1;6688;VERDADERO;VERDADERO;-34;;;
44049;44083;0;6689;VERDADERO;VERDADERO;-34;;;
44085;44103;0;6690;VERDADERO;VERDADERO;-18;;;
44085;44103;0;6691;VERDADERO;VERDADERO;-18;;;
44085;44123;0;6692;VERDADERO;VERDADERO;-38;;;
44085;44123;0;6693;VERDADERO;VERDADERO;-38;;;
44085;44123;0;6694;VERDADERO;VERDADERO;-38;;;
44117;44143;0;6695;VERDADERO;VERDADERO;-26;;;
44117;44143;0;6696;VERDADERO;VERDADERO;-26;;;
44117;44143;0;6697;VERDADERO;VERDADERO;-26;;;
44117;44143;0;6698;VERDADERO;VERDADERO;-26;;;
44117;44143;0;6699;VERDADERO;VERDADERO;-26;;;
44117;44163;1;6700;VERDADERO;VERDADERO;-46;;;
44153;44163;0;6701;VERDADERO;VERDADERO;-10;;;
44153;44183;0;6702;VERDADERO;VERDADERO;-30;;;
44153;44183;0;6703;VERDADERO;VERDADERO;-30;;;
44153;44183;0;6704;VERDADERO;VERDADERO;-30;;;
44153;44183;0;6705;VERDADERO;VERDADERO;-30;;;
44185;44183;0;6706;VERDADERO;VERDADERO;2;;;
44185;44203;0;6707;VERDADERO;VERDADERO;-18;;;
44185;44203;0;6708;VERDADERO;VERDADERO;-18;;;
44185;44223;0;6709;VERDADERO;VERDADERO;-38;;;
44185;44223;0;6710;VERDADERO;VERDADERO;-38;;;
44185;44223;0;6711;VERDADERO;VERDADERO;-38;;;
44221;44243;0;6712;VERDADERO;VERDADERO;-22;;;
44221;44243;0;6713;VERDADERO;VERDADERO;-22;;;
44221;44263;0;6714;VERDADERO;VERDADERO;-42;;;
44221;44263;0;6715;VERDADERO;VERDADERO;-42;;;
44253;44263;0;6716;VERDADERO;VERDADERO;-10;;;
44253;44283;0;6717;VERDADERO;VERDADERO;-30;;;
44253;44283;0;6718;VERDADERO;VERDADERO;-30;;;
44253;44283;0;6719;VERDADERO;VERDADERO;-30;;;
44253;44283;0;6720;VERDADERO;VERDADERO;-30;;;
44253;44303;0;6721;VERDADERO;FALSO;-50;;;
44285;44303;0;6722;VERDADERO;VERDADERO;-18;;;
44285;44303;0;6723;VERDADERO;VERDADERO;-18;;;
44285;44323;0;6724;VERDADERO;VERDADERO;-38;;;
44285;44323;0;6725;VERDADERO;VERDADERO;-38;;;
44285;44323;0;6726;VERDADERO;VERDADERO;-38;;;
44321;44323;0;6727;VERDADERO;VERDADERO;-2;;;
44321;44323;0;6728;VERDADERO;VERDADERO;-2;;;
44321;44343;0;6729;VERDADERO;VERDADERO;-22;;;
44321;44343;0;6730;VERDADERO;VERDADERO;-22;;;
44321;44363;1;6731;VERDADERO;VERDADERO;-42;;;
44353;44363;0;6732;VERDADERO;VERDADERO;-10;;;
44353;44363;0;6733;VERDADERO;VERDADERO;-10;;;
44353;44383;0;6734;VERDADERO;VERDADERO;-30;;;
44353;44383;0;6735;VERDADERO;VERDADERO;-30;;;
44353;44403;0;6736;VERDADERO;FALSO;-50;;;
44353;44403;0;6737;VERDADERO;FALSO;-50;;;
44389;44403;0;6738;VERDADERO;VERDADERO;-14;;;
44389;44423;0;6739;VERDADERO;VERDADERO;-34;;;
44389;44423;0;6740;VERDADERO;VERDADERO;-34;;;
44389;44423;0;6741;VERDADERO;VERDADERO;-34;;;
44389;44423;0;6742;VERDADERO;VERDADERO;-34;;;
44421;44443;0;6743;VERDADERO;VERDADERO;-22;;;
44421;44443;0;6744;VERDADERO;VERDADERO;-22;;;
44421;44443;0;6745;VERDADERO;VERDADERO;-22;;;
44421;44463;0;6746;VERDADERO;VERDADERO;-42;;;
44449;44463;0;6747;VERDADERO;VERDADERO;-14;;;
44449;44463;0;6748;VERDADERO;VERDADERO;-14;;;
44449;44463;0;6749;VERDADERO;VERDADERO;-14;;;
44449;44483;0;6750;VERDADERO;VERDADERO;-34;;;
44449;44483;0;6751;VERDADERO;VERDADERO;-34;;;
44449;44483;0;6752;VERDADERO;VERDADERO;-34;;;
44449;44503;0;6753;VERDADERO;FALSO;-54;;;
44487;44503;0;6754;VERDADERO;VERDADERO;-16;;;
44487;44503;0;6755;VERDADERO;VERDADERO;-16;;;
44487;44503;0;6756;VERDADERO;VERDADERO;-16;;;
44487;44503;0;6757;VERDADERO;VERDADERO;-16;;;
44517;44523;0;6758;VERDADERO;VERDADERO;-6;;;
44517;44523;0;6759;VERDADERO;VERDADERO;-6;;;
44517;44523;0;6760;VERDADERO;VERDADERO;-6;;;
44517;44544;1;6761;VERDADERO;VERDADERO;-27;;;
44517;44544;0;6762;VERDADERO;VERDADERO;-27;;;
44517;44564;0;6763;VERDADERO;VERDADERO;-47;;;
44553;44564;0;6764;VERDADERO;VERDADERO;-11;;;
44553;44564;0;6765;VERDADERO;VERDADERO;-11;;;
44553;44584;0;6766;VERDADERO;VERDADERO;-31;;;
44553;44584;0;6767;VERDADERO;VERDADERO;-31;;;
44553;44604;1;6768;VERDADERO;FALSO;-51;;;
44585;44604;0;6769;VERDADERO;VERDADERO;-19;;;
44585;44604;0;6770;VERDADERO;VERDADERO;-19;;;
44585;44604;0;6771;VERDADERO;VERDADERO;-19;;;
44585;44604;0;6772;VERDADERO;VERDADERO;-19;;;
44585;44604;0;6773;VERDADERO;VERDADERO;-19;;;
44585;44624;0;6774;VERDADERO;VERDADERO;-39;;;
44585;44624;0;6775;VERDADERO;VERDADERO;-39;;;
44630;44645;0;6776;VERDADERO;VERDADERO;-15;;;
44630;44645;0;6777;VERDADERO;VERDADERO;-15;;;
44630;44645;0;6778;VERDADERO;VERDADERO;-15;;;
44630;44665;1;6779;VERDADERO;VERDADERO;-35;;;
44655;44665;0;6780;VERDADERO;VERDADERO;-10;;;
44655;44665;0;6781;VERDADERO;VERDADERO;-10;;;
44655;44685;0;6782;VERDADERO;VERDADERO;-30;;;
44655;44685;0;6783;VERDADERO;VERDADERO;-30;;;
44655;44705;0;6784;VERDADERO;FALSO;-50;;;
44689;44705;0;6785;VERDADERO;VERDADERO;-16;;;
44689;44705;0;6786;VERDADERO;VERDADERO;-16;;;
44689;44705;0;6787;VERDADERO;VERDADERO;-16;;;
44689;44705;0;6788;VERDADERO;VERDADERO;-16;;;
44689;44705;0;6789;VERDADERO;VERDADERO;-16;;;
44721;44725;0;6790;VERDADERO;VERDADERO;-4;;;
44721;44725;0;6791;VERDADERO;VERDADERO;-4;;;
44721;44745;0;6792;VERDADERO;VERDADERO;-24;;;
44721;44745;0;6793;VERDADERO;VERDADERO;-24;;;
44721;44745;0;6794;VERDADERO;VERDADERO;-24;;;
44721;44765;0;6795;VERDADERO;VERDADERO;-44;;;
44721;44765;0;6796;VERDADERO;VERDADERO;-44;;;
44761;44765;0;6797;VERDADERO;VERDADERO;-4;;;
44761;44765;0;6798;VERDADERO;VERDADERO;-4;;;
44761;44785;0;6799;VERDADERO;VERDADERO;-24;;;
44761;44785;0;6800;VERDADERO;VERDADERO;-24;;;
44788;44805;0;6801;VERDADERO;VERDADERO;-17;;;
44788;44805;0;6802;VERDADERO;VERDADERO;-17;;;
44788;44805;0;6803;VERDADERO;VERDADERO;-17;;;
44788;44805;0;6804;VERDADERO;VERDADERO;-17;;;
44817;44805;0;6805;VERDADERO;VERDADERO;12;;;
44817;44805;0;6806;VERDADERO;VERDADERO;12;;;
44817;44825;0;6807;VERDADERO;VERDADERO;-8;;;
44817;44825;0;6808;VERDADERO;VERDADERO;-8;;;
44817;44825;0;6809;VERDADERO;VERDADERO;-8;;;
44817;44845;1;6810;VERDADERO;VERDADERO;-28;;;
44849;44845;0;6811;VERDADERO;VERDADERO;4;;;
44849;44865;1;6812;VERDADERO;VERDADERO;-16;;;
44849;44865;0;6813;VERDADERO;VERDADERO;-16;;;
44849;44865;0;6814;VERDADERO;VERDADERO;-16;;;
44849;44865;0;6815;VERDADERO;VERDADERO;-16;;;
44881;44885;0;6816;VERDADERO;VERDADERO;-4;;;
44881;44885;0;6817;VERDADERO;VERDADERO;-4;;;
44881;44905;0;6818;VERDADERO;VERDADERO;-24;;;
44881;44905;0;6819;VERDADERO;VERDADERO;-24;;;
44881;44905;0;6820;VERDADERO;VERDADERO;-24;;;
44881;44925;1;6821;VERDADERO;VERDADERO;-44;;;
44921;44925;0;6822;VERDADERO;VERDADERO;-4;;;
44921;44925;0;6823;VERDADERO;VERDADERO;-4;;;
44921;44945;0;6824;VERDADERO;VERDADERO;-24;;;
44921;44945;0;6825;VERDADERO;VERDADERO;-24;;;
44949;44965;0;6826;VERDADERO;VERDADERO;-16;;;
44949;44965;0;6827;VERDADERO;VERDADERO;-16;;;
44949;44965;0;6828;VERDADERO;VERDADERO;-16;;;
44949;44965;0;6829;VERDADERO;VERDADERO;-16;;;
44949;44985;1;6830;VERDADERO;VERDADERO;-36;;;
44981;44985;0;6831;VERDADERO;VERDADERO;-4;;;
44981;44985;0;6832;VERDADERO;VERDADERO;-4;;;
44981;45006;0;6833;VERDADERO;VERDADERO;-25;;;
44981;45006;0;6834;VERDADERO;VERDADERO;-25;;;
44981;45026;0;6835;VERDADERO;VERDADERO;-45;;;
44981;45026;0;6836;VERDADERO;VERDADERO;-45;;;
45016;45026;0;6837;VERDADERO;VERDADERO;-10;;;
45016;45046;0;6838;VERDADERO;VERDADERO;-30;;;
45016;45046;0;6839;VERDADERO;VERDADERO;-30;;;
45016;45046;0;6840;VERDADERO;VERDADERO;-30;;;
45016;45066;1;6841;VERDADERO;FALSO;-50;;;
45016;45066;0;6842;VERDADERO;FALSO;-50;;;
45052;45066;0;6843;VERDADERO;VERDADERO;-14;;;
45052;45066;0;6844;VERDADERO;VERDADERO;-14;;;
45052;45066;0;6845;VERDADERO;VERDADERO;-14;;;
45052;45086;0;6846;VERDADERO;VERDADERO;-34;;;
45052;45086;0;6847;VERDADERO;VERDADERO;-34;;;
45087;45086;0;6848;VERDADERO;VERDADERO;1;;;
45087;45106;0;6849;VERDADERO;VERDADERO;-19;;;
45087;45106;0;6850;VERDADERO;VERDADERO;-19;;;
45087;45126;1;6851;VERDADERO;VERDADERO;-39;;;
45087;45126;0;6852;VERDADERO;VERDADERO;-39;;;
45117;45126;0;6853;VERDADERO;VERDADERO;-9;;;
45117;45126;0;6854;VERDADERO;VERDADERO;-9;;;
45117;45146;1;6855;VERDADERO;VERDADERO;-29;;;
45117;45146;0;6856;VERDADERO;VERDADERO;-29;;;
45117;45166;1;6857;VERDADERO;VERDADERO;-49;;;
45117;45166;0;6858;VERDADERO;VERDADERO;-49;;;
45154;45166;0;6859;VERDADERO;VERDADERO;-12;;;
45154;45166;0;6860;VERDADERO;VERDADERO;-12;;;
45154;45166;0;6861;VERDADERO;VERDADERO;-12;;;
45154;45186;1;6862;VERDADERO;VERDADERO;-32;;;
45186;45186;0;6863;VERDADERO;VERDADERO;0;;;
45186;45186;0;6864;VERDADERO;VERDADERO;0;;;
45186;45206;0;6865;VERDADERO;VERDADERO;-20;;;
45186;45206;0;6866;VERDADERO;VERDADERO;-20;;;
45186;45226;1;6867;VERDADERO;VERDADERO;-40;;;
45186;45226;0;6868;VERDADERO;VERDADERO;-40;;;
45226;45226;0;6869;VERDADERO;VERDADERO;0;;;
45226;45246;0;6870;VERDADERO;VERDADERO;-20;;;
45226;45246;0;6871;VERDADERO;VERDADERO;-20;;;
45226;45266;1;6872;VERDADERO;VERDADERO;-40;;;
45226;45266;0;6873;VERDADERO;VERDADERO;-40;;;
45253;45266;0;6874;VERDADERO;VERDADERO;-13;;;
45253;45266;0;6875;VERDADERO;VERDADERO;-13;;;
45253;45266;0;6876;VERDADERO;VERDADERO;-13;;;
45253;45286;1;6877;VERDADERO;VERDADERO;-33;;;
45253;45286;0;6878;VERDADERO;VERDADERO;-33;;;
45289;45306;0;6879;VERDADERO;VERDADERO;-17;;;
45289;45306;0;6880;VERDADERO;VERDADERO;-17;;;
45289;45306;0;6881;VERDADERO;VERDADERO;-17;;;
45289;45326;1;6882;VERDADERO;VERDADERO;-37;;;
45289;45326;0;6883;VERDADERO;VERDADERO;-37;;;
45321;45346;0;6884;VERDADERO;VERDADERO;-25;;;
45321;45346;0;6885;VERDADERO;VERDADERO;-25;;;
45321;45346;0;6886;VERDADERO;VERDADERO;-25;;;
45321;45366;0;6887;VERDADERO;VERDADERO;-45;;;
45321;45366;0;6888;VERDADERO;VERDADERO;-45;;;
45321;45366;0;6889;VERDADERO;VERDADERO;-45;;;
45356;45366;0;6890;VERDADERO;VERDADERO;-10;;;
45356;45366;0;6891;VERDADERO;VERDADERO;-10;;;
45356;45366;0;6892;VERDADERO;VERDADERO;-10;;;
45356;45386;1;6893;VERDADERO;VERDADERO;-30;;;
45385;45386;0;6894;VERDADERO;VERDADERO;-1;;;
45385;45386;0;6895;VERDADERO;VERDADERO;-1;;;
45385;45406;0;6896;VERDADERO;VERDADERO;-21;;;
45385;45406;0;6897;VERDADERO;VERDADERO;-21;;;
45385;45426;0;6898;VERDADERO;VERDADERO;-41;;;
45417;45426;0;6899;VERDADERO;VERDADERO;-9;;;
45417;45426;0;6900;VERDADERO;VERDADERO;-9;;;
45417;45446;0;6901;VERDADERO;VERDADERO;-29;;;
45417;45446;0;6902;VERDADERO;VERDADERO;-29;;;
45417;45466;0;6903;VERDADERO;VERDADERO;-49;;;
45448;45466;0;6904;VERDADERO;VERDADERO;-18;;;
45448;45466;0;6905;VERDADERO;VERDADERO;-18;;;
45448;45466;0;6906;VERDADERO;VERDADERO;-18;;;
45448;45466;0;6907;VERDADERO;VERDADERO;-18;;;
45448;45486;0;6908;VERDADERO;VERDADERO;-38;;;
45480;45486;0;6909;VERDADERO;VERDADERO;-6;;;
45480;45486;0;6910;VERDADERO;VERDADERO;-6;;;
45480;45506;0;6911;VERDADERO;VERDADERO;-26;;;
45480;45506;0;6912;VERDADERO;VERDADERO;-26;;;
45480;45526;0;6913;VERDADERO;VERDADERO;-46;;;
45480;45526;0;6914;VERDADERO;VERDADERO;-46;;;
45480;45526;0;6915;VERDADERO;VERDADERO;-46;;;
45524;45546;0;6916;VERDADERO;VERDADERO;-22;;;
45524;45546;0;6917;VERDADERO;VERDADERO;-22;;;
45524;45566;1;6918;VERDADERO;VERDADERO;-42;;;
45524;45566;0;6919;VERDADERO;VERDADERO;-42;;;
45549;45566;0;6920;VERDADERO;VERDADERO;-17;;;
45549;45566;0;6921;VERDADERO;VERDADERO;-17;;;
45549;45566;0;6922;VERDADERO;VERDADERO;-17;;;
45549;45566;0;6923;VERDADERO;VERDADERO;-17;;;
45549;45586;1;6924;VERDADERO;VERDADERO;-37;;;
45581;45586;0;6925;VERDADERO;VERDADERO;-5;;;
45581;45606;0;6926;VERDADERO;VERDADERO;-25;;;
45581;45606;0;6927;VERDADERO;VERDADERO;-25;;;
45581;45606;0;6928;VERDADERO;VERDADERO;-25;;;
45581;45606;0;6929;VERDADERO;VERDADERO;-25;;;
45581;45606;0;6930;VERDADERO;VERDADERO;-25;;;
45617;45626;0;6931;VERDADERO;VERDADERO;-9;;;
45617;45626;0;6932;VERDADERO;VERDADERO;-9;;;
45617;45626;0;6933;VERDADERO;VERDADERO;-9;;;
45617;45646;0;6934;VERDADERO;VERDADERO;-29;;;
45617;45646;0;6935;VERDADERO;VERDADERO;-29;;;
45653;45666;0;6936;VERDADERO;VERDADERO;-13;;;
45653;45666;0;6937;VERDADERO;VERDADERO;-13;;;
45653;45666;0;6938;VERDADERO;VERDADERO;-13;;;
45653;45686;0;6939;VERDADERO;VERDADERO;-33;;;
45653;45686;0;6940;VERDADERO;VERDADERO;-33;;;
45653;45706;1;6941;VERDADERO;FALSO;-53;;;
45691;45706;0;6942;VERDADERO;VERDADERO;-15;;;
45691;45706;0;6943;VERDADERO;VERDADERO;-15;;;
45691;45706;0;6944;VERDADERO;VERDADERO;-15;;;
45691;45706;0;6945;VERDADERO;VERDADERO;-15;;;
45717;45726;0;6946;VERDADERO;VERDADERO;-9;;;
45717;45726;0;6947;VERDADERO;VERDADERO;-9;;;
45717;45726;0;6948;VERDADERO;VERDADERO;-9;;;
45717;45746;0;6949;VERDADERO;VERDADERO;-29;;;
45717;45746;0;6950;VERDADERO;VERDADERO;-29;;;
45717;45766;0;6951;VERDADERO;VERDADERO;-49;;;
45753;45766;0;6952;VERDADERO;VERDADERO;-13;;;
45753;45786;0;6953;VERDADERO;VERDADERO;-33;;;
45753;45786;0;6954;VERDADERO;VERDADERO;-33;;;
45753;45786;0;6955;VERDADERO;VERDADERO;-33;;;
45753;45806;0;6956;VERDADERO;FALSO;-53;;;
45785;45806;0;6957;VERDADERO;VERDADERO;-21;;;
45785;45806;0;6958;VERDADERO;VERDADERO;-21;;;
45785;45806;0;6959;VERDADERO;VERDADERO;-21;;;
45785;45826;0;6960;VERDADERO;VERDADERO;-41;;;
45785;45826;0;6961;VERDADERO;VERDADERO;-41;;;
45785;45846;0;6962;VERDADERO;FALSO;-61;;;
45825;45846;0;6963;VERDADERO;VERDADERO;-21;;;
45825;45846;0;6964;VERDADERO;VERDADERO;-21;;;
45825;45846;0;6965;VERDADERO;VERDADERO;-21;;;
45825;45846;0;6966;VERDADERO;VERDADERO;-21;;;
45853;45866;0;6967;VERDADERO;VERDADERO;-13;;;
45853;45866;0;6968;VERDADERO;VERDADERO;-13;;;
45853;45886;0;6969;VERDADERO;VERDADERO;-33;;;
45853;45886;0;6970;VERDADERO;VERDADERO;-33;;;
45853;45886;0;6971;VERDADERO;VERDADERO;-33;;;
45853;45886;0;6972;VERDADERO;VERDADERO;-33;;;
45889;45886;0;6973;VERDADERO;VERDADERO;3;;;
45889;45886;0;6974;VERDADERO;VERDADERO;3;;;
45889;45906;0;6975;VERDADERO;VERDADERO;-17;;;
45889;45906;0;6976;VERDADERO;VERDADERO;-17;;;
45889;45927;0;6977;VERDADERO;VERDADERO;-38;;;
45921;45927;0;6978;VERDADERO;VERDADERO;-6;;;
45921;45927;0;6979;VERDADERO;VERDADERO;-6;;;
45921;45947;0;6980;VERDADERO;VERDADERO;-26;;;
45921;45947;0;6981;VERDADERO;VERDADERO;-26;;;
45921;45947;0;6982;VERDADERO;VERDADERO;-26;;;
45921;45967;0;6983;VERDADERO;VERDADERO;-46;;;
45961;45967;0;6984;VERDADERO;VERDADERO;-6;;;
45986;45987;1;6985;VERDADERO;VERDADERO;-1;;;
45986;46007;0;6986;VERDADERO;VERDADERO;-21;;;
45986;46007;0;6987;VERDADERO;VERDADERO;-21;;;
45986;46027;0;6988;VERDADERO;VERDADERO;-41;;;
46017;46027;0;6989;VERDADERO;VERDADERO;-10;;;
46017;46027;0;6990;VERDADERO;VERDADERO;-10;;;
46017;46047;0;6991;VERDADERO;VERDADERO;-30;;;
46017;46047;0;6992;VERDADERO;VERDADERO;-30;;;
46017;46047;0;6993;VERDADERO;VERDADERO;-30;;;
46049;46047;0;6994;VERDADERO;VERDADERO;2;;;
46049;46067;0;6995;VERDADERO;VERDADERO;-18;;;
46049;46067;0;6996;VERDADERO;VERDADERO;-18;;;
46049;46087;1;6997;VERDADERO;VERDADERO;-38;;;
46049;46087;0;6998;VERDADERO;VERDADERO;-38;;;
46082;46087;0;6999;VERDADERO;VERDADERO;-5;;;
46082;46087;0;7000;VERDADERO;VERDADERO;-5;;;
46082;46087;0;7001;VERDADERO;VERDADERO;-5;;;
46082;46107;0;7002;VERDADERO;VERDADERO;-25;;;
46082;46107;0;7003;VERDADERO;VERDADERO;-25;;;
46082;46107;0;7004;VERDADERO;VERDADERO;-25;;;
46117;46127;0;7005;VERDADERO;VERDADERO;-10;;;
46117;46127;0;7006;VERDADERO;VERDADERO;-10;;;
46117;46147;1;7007;VERDADERO;VERDADERO;-30;;;
46117;46147;0;7008;VERDADERO;VERDADERO;-30;;;
46117;46147;0;7009;VERDADERO;VERDADERO;-30;;;
46149;46147;0;7010;VERDADERO;VERDADERO;2;;;
46149;46167;0;7011;VERDADERO;VERDADERO;-18;;;
46149;46167;0;7012;VERDADERO;VERDADERO;-18;;;
46149;46187;1;7013;VERDADERO;VERDADERO;-38;;;
46149;46187;0;7014;VERDADERO;VERDADERO;-38;;;
46149;46187;0;7015;VERDADERO;VERDADERO;-38;;;
46185;46207;1;7016;VERDADERO;VERDADERO;-22;;;
46185;46207;0;7017;VERDADERO;VERDADERO;-22;;;
46185;46207;0;7018;VERDADERO;VERDADERO;-22;;;
46185;46207;0;7019;VERDADERO;VERDADERO;-22;;;
46185;46207;0;7020;VERDADERO;VERDADERO;-22;;;
46218;46207;0;7021;VERDADERO;VERDADERO;11;;;
46218;46207;0;7022;VERDADERO;VERDADERO;11;;;
46218;46207;0;7023;VERDADERO;VERDADERO;11;;;
46218;46207;0;7024;VERDADERO;VERDADERO;11;;;
46218;46207;0;7025;VERDADERO;VERDADERO;11;;;
46253;46207;0;7026;VERDADERO;VERDADERO;46;;;
46253;46227;0;7027;VERDADERO;VERDADERO;26;;;
46253;46227;0;7028;VERDADERO;VERDADERO;26;;;
46253;46227;0;7029;VERDADERO;VERDADERO;26;;;
46253;46247;0;7030;VERDADERO;VERDADERO;6;;;
46285;46247;0;7031;VERDADERO;VERDADERO;38;;;
46285;46267;0;7032;VERDADERO;VERDADERO;18;;;
46285;46267;0;7033;VERDADERO;VERDADERO;18;;;
46285;46267;0;7034;VERDADERO;VERDADERO;18;;;
46285;46287;0;7035;VERDADERO;VERDADERO;-2;;;
46317;46287;0;7036;VERDADERO;VERDADERO;30;;;
46317;46307;0;7037;VERDADERO;VERDADERO;10;;;
46317;46307;0;7038;VERDADERO;VERDADERO;10;;;
46317;46307;0;7039;VERDADERO;VERDADERO;10;;;
46317;46327;0;7040;VERDADERO;VERDADERO;-10;;;
46317;46327;0;7041;VERDADERO;VERDADERO;-10;;;
46354;46347;0;7042;VERDADERO;VERDADERO;7;;;
46354;46347;0;7043;VERDADERO;VERDADERO;7;;;
46354;46347;0;7044;VERDADERO;VERDADERO;7;;;
46354;46367;0;7045;VERDADERO;VERDADERO;-13;;;
46354;46367;0;7046;VERDADERO;VERDADERO;-13;;;
46381;46387;1;7047;VERDADERO;VERDADERO;-6;;;
46381;46387;0;7048;VERDADERO;VERDADERO;-6;;;
46381;46387;0;7049;VERDADERO;VERDADERO;-6;;;
46381;46407;0;7050;VERDADERO;VERDADERO;-26;;;
46381;46407;0;7051;VERDADERO;VERDADERO;-26;;;
46417;46427;0;7052;VERDADERO;VERDADERO;-10;;;
46417;46427;0;7053;VERDADERO;VERDADERO;-10;;;
46417;46427;0;7054;VERDADERO;VERDADERO;-10;;;
46417;46447;0;7055;VERDADERO;VERDADERO;-30;;;
46417;46447;0;7056;VERDADERO;VERDADERO;-30;;;
46449;46447;0;7057;VERDADERO;VERDADERO;2;;;
46449;46447;0;7058;VERDADERO;VERDADERO;2;;;
46449;46467;0;7059;VERDADERO;VERDADERO;-18;;;
46449;46467;0;7060;VERDADERO;VERDADERO;-18;;;
46449;46467;0;7061;VERDADERO;VERDADERO;-18;;;
46480;46487;0;7062;VERDADERO;VERDADERO;-7;;;
46480;46487;0;7063;VERDADERO;VERDADERO;-7;;;
46480;46507;0;7064;VERDADERO;VERDADERO;-27;;;
46480;46507;0;7065;VERDADERO;VERDADERO;-27;;;
46480;46507;0;7066;VERDADERO;VERDADERO;-27;;;
46480;46527;0;7067;VERDADERO;VERDADERO;-47;;;
46513;46527;0;7068;VERDADERO;VERDADERO;-14;;;
46513;46527;0;7069;VERDADERO;VERDADERO;-14;;;
46513;46547;0;7070;VERDADERO;VERDADERO;-34;;;
46513;46547;0;7071;VERDADERO;VERDADERO;-34;;;
46545;46547;0;7072;VERDADERO;VERDADERO;-2;;;
46545;46547;0;7073;VERDADERO;VERDADERO;-2;;;
46545;46547;0;7074;VERDADERO;VERDADERO;-2;;;
46545;46567;0;7075;VERDADERO;VERDADERO;-22;;;
46545;46567;0;7076;VERDADERO;VERDADERO;-22;;;
46545;46567;0;7077;VERDADERO;VERDADERO;-22;;;
46581;46587;0;7078;VERDADERO;VERDADERO;-6;;;
46581;46587;0;7079;VERDADERO;VERDADERO;-6;;;
46581;46607;0;7080;VERDADERO;VERDADERO;-26;;;
46581;46607;0;7081;VERDADERO;VERDADERO;-26;;;
46581;46607;0;7082;VERDADERO;VERDADERO;-26;;;
46613;46607;0;7083;VERDADERO;VERDADERO;6;;;
46613;46627;0;7084;VERDADERO;VERDADERO;-14;;;
46613;46627;0;7085;VERDADERO;VERDADERO;-14;;;
46613;46647;0;7086;VERDADERO;VERDADERO;-34;;;
46613;46647;0;7087;VERDADERO;VERDADERO;-34;;;
46613;46647;0;7088;VERDADERO;VERDADERO;-34;;;
46649;46647;0;7089;VERDADERO;VERDADERO;2;;;
46649;46647;0;7090;VERDADERO;VERDADERO;2;;;
46649;46647;0;7091;VERDADERO;VERDADERO;2;;;
46649;46667;1;7092;VERDADERO;VERDADERO;-18;;;
46649;46667;0;7093;VERDADERO;VERDADERO;-18;;;
46649;46667;0;7094;VERDADERO;VERDADERO;-18;;;
46685;46687;0;7095;VERDADERO;VERDADERO;-2;;;
46685;46687;0;7096;VERDADERO;VERDADERO;-2;;;
46685;46707;0;7097;VERDADERO;VERDADERO;-22;;;
46685;46707;0;7098;VERDADERO;VERDADERO;-22;;;
46685;46707;0;7099;VERDADERO;VERDADERO;-22;;;
46718;46727;0;7100;VERDADERO;VERDADERO;-9;;;
46718;46727;0;7101;VERDADERO;VERDADERO;-9;;;
46718;46747;0;7102;VERDADERO;VERDADERO;-29;;;
46718;46747;0;7103;VERDADERO;VERDADERO;-29;;;
46718;46747;0;7104;VERDADERO;VERDADERO;-29;;;
46749;46767;0;7105;VERDADERO;VERDADERO;-18;;;
46749;46767;0;7106;VERDADERO;VERDADERO;-18;;;
46749;46767;0;7107;VERDADERO;VERDADERO;-18;;;
46749;46787;1;7108;VERDADERO;VERDADERO;-38;;;
46749;46787;0;7109;VERDADERO;VERDADERO;-38;;;
46749;46787;0;7110;VERDADERO;VERDADERO;-38;;;
46785;46807;0;7111;VERDADERO;VERDADERO;-22;;;
46785;46807;0;7112;VERDADERO;VERDADERO;-22;;;
46785;46807;0;7113;VERDADERO;VERDADERO;-22;;;
46785;46807;0;7114;VERDADERO;VERDADERO;-22;;;
46785;46807;0;7115;VERDADERO;VERDADERO;-22;;;
46785;46807;0;7116;VERDADERO;VERDADERO;-22;;;
46821;46827;0;7117;VERDADERO;VERDADERO;-6;;;
46821;46827;0;7118;VERDADERO;VERDADERO;-6;;;
46821;46847;0;7119;VERDADERO;VERDADERO;-26;;;
46821;46847;0;7120;VERDADERO;VERDADERO;-26;;;
46821;46847;0;7121;VERDADERO;VERDADERO;-26;;;
46853;46867;1;7122;VERDADERO;VERDADERO;-14;;;
46853;46867;0;7123;VERDADERO;VERDADERO;-14;;;
46853;46867;0;7124;VERDADERO;VERDADERO;-14;;;
46853;46887;1;7125;VERDADERO;VERDADERO;-34;;;
46853;46887;0;7126;VERDADERO;VERDADERO;-34;;;
46885;46907;0;7127;VERDADERO;VERDADERO;-22;;;
46885;46907;0;7128;VERDADERO;VERDADERO;-22;;;
46885;46907;0;7129;VERDADERO;VERDADERO;-22;;;
46885;46927;0;7130;VERDADERO;VERDADERO;-42;;;
46885;46927;0;7131;VERDADERO;VERDADERO;-42;;;
46921;46927;0;7132;VERDADERO;VERDADERO;-6;;;
46921;46947;0;7133;VERDADERO;VERDADERO;-26;;;
46921;46947;0;7134;VERDADERO;VERDADERO;-26;;;
46921;46967;1;7135;VERDADERO;VERDADERO;-46;;;
46921;46967;0;7136;VERDADERO;VERDADERO;-46;;;
46953;46967;0;7137;VERDADERO;VERDADERO;-14;;;
46953;46967;0;7138;VERDADERO;VERDADERO;-14;;;
46953;46967;0;7139;VERDADERO;VERDADERO;-14;;;
46953;46967;0;7140;VERDADERO;VERDADERO;-14;;;
46953;46987;0;7141;VERDADERO;VERDADERO;-34;;;
46985;46987;0;7142;VERDADERO;VERDADERO;-2;;;
46985;47007;0;7143;VERDADERO;VERDADERO;-22;;;
46985;47007;0;7144;VERDADERO;VERDADERO;-22;;;
46985;47007;0;7145;VERDADERO;VERDADERO;-22;;;
46985;47027;0;7146;VERDADERO;VERDADERO;-42;;;
46985;47027;0;7147;VERDADERO;VERDADERO;-42;;;
47021;47027;0;7148;VERDADERO;VERDADERO;-6;;;
47021;47047;0;7149;VERDADERO;VERDADERO;-26;;;
47021;47047;0;7150;VERDADERO;VERDADERO;-26;;;
47021;47047;0;7151;VERDADERO;VERDADERO;-26;;;
47021;47067;0;7152;VERDADERO;VERDADERO;-46;;;
47053;47067;0;7153;VERDADERO;VERDADERO;-14;;;
47053;47067;0;7154;VERDADERO;VERDADERO;-14;;;
47053;47067;0;7155;VERDADERO;VERDADERO;-14;;;
47053;47087;0;7156;VERDADERO;VERDADERO;-34;;;
47053;47087;0;7157;VERDADERO;VERDADERO;-34;;;
47085;47087;0;7158;VERDADERO;VERDADERO;-2;;;
47085;47107;0;7159;VERDADERO;VERDADERO;-22;;;
47085;47107;0;7160;VERDADERO;VERDADERO;-22;;;
47085;47127;0;7161;VERDADERO;VERDADERO;-42;;;
47085;47127;0;7162;VERDADERO;VERDADERO;-42;;;
47116;47127;0;7163;VERDADERO;VERDADERO;-11;;;
47116;47147;0;7164;VERDADERO;VERDADERO;-31;;;
47116;47147;0;7165;VERDADERO;VERDADERO;-31;;;
47116;47167;0;7166;VERDADERO;FALSO;-51;;;
47116;47167;0;7167;VERDADERO;FALSO;-51;;;
47149;47167;0;7168;VERDADERO;VERDADERO;-18;;;
47149;47167;0;7169;VERDADERO;VERDADERO;-18;;;
47149;47167;0;7170;VERDADERO;VERDADERO;-18;;;
47149;47187;0;7171;VERDADERO;VERDADERO;-38;;;
47149;47187;0;7172;VERDADERO;VERDADERO;-38;;;
47149;47207;0;7173;VERDADERO;FALSO;-58;;;
47185;47207;0;7174;VERDADERO;VERDADERO;-22;;;
47185;47207;0;7175;VERDADERO;VERDADERO;-22;;;
47185;47207;0;7176;VERDADERO;VERDADERO;-22;;;
47185;47207;0;7177;VERDADERO;VERDADERO;-22;;;
47185;47207;0;7178;VERDADERO;VERDADERO;-22;;;
47217;47227;0;7179;VERDADERO;VERDADERO;-10;;;
47217;47227;0;7180;VERDADERO;VERDADERO;-10;;;
47217;47227;0;7181;VERDADERO;VERDADERO;-10;;;
47217;47247;0;7182;VERDADERO;VERDADERO;-30;;;
47217;47247;0;7183;VERDADERO;VERDADERO;-30;;;
47249;47267;1;7184;VERDADERO;VERDADERO;-18;;;
47249;47267;0,00E+00;7185;VERDADERO;VERDADERO;-18;;;
47249;47267;0;7186;VERDADERO;VERDADERO;-18;;;
47249;47287;1;7187;VERDADERO;VERDADERO;-38;;;
47249;47287;0;7188;VERDADERO;VERDADERO;-38;;;
47285;47307;0;7189;VERDADERO;VERDADERO;-22;;;
47285;47307;0;7190;VERDADERO;VERDADERO;-22;;;
47285;47307;0;7191;VERDADERO;VERDADERO;-22;;;
47285;47307;0;7192;VERDADERO;VERDADERO;-22;;;
47285;47307;0;7193;VERDADERO;VERDADERO;-22;;;
47285;47307;0;7194;VERDADERO;VERDADERO;-22;;;
47317;47307;0;7195;VERDADERO;VERDADERO;10;;;
47317;47307;0;7196;VERDADERO;VERDADERO;10;;;
47317;47307;0;7197;VERDADERO;VERDADERO;10;;;
47317;47307;0;7198;VERDADERO;VERDADERO;10;;;
47317;47327;0;7199;VERDADERO;VERDADERO;-10;;;
47349;47327;0;7200;VERDADERO;VERDADERO;22;;;
47349;47327;0;7201;VERDADERO;VERDADERO;22;;;
47349;47347;0;7202;VERDADERO;VERDADERO;2;;;
47349;47347;0;7203;VERDADERO;VERDADERO;2;;;
47349;47367;0;7204;VERDADERO;VERDADERO;-18;;;
47349;47367;0;7205;VERDADERO;VERDADERO;-18;;;
47385;47367;0;7206;VERDADERO;VERDADERO;18;;;
47385;47387;1;7207;VERDADERO;VERDADERO;-2;;;
47385;47387;0;7208;VERDADERO;VERDADERO;-2;;;
47385;47407;1;7209;VERDADERO;VERDADERO;-22;;;
47417;47407;0;7210;VERDADERO;VERDADERO;10;;;
47417;47407;0;7211;VERDADERO;VERDADERO;10;;;
47417;47427;0;7212;VERDADERO;VERDADERO;-10;;;
47417;47427;0;7213;VERDADERO;VERDADERO;-10;;;
47417;47447;0;7214;VERDADERO;VERDADERO;-30;;;
47449;47447;0;7215;VERDADERO;VERDADERO;2;;;
47449;47447;0;7216;VERDADERO;VERDADERO;2;;;
47449;47468;0;7217;VERDADERO;VERDADERO;-19;;;
47449;47468;0;7218;VERDADERO;VERDADERO;-19;;;
47449;47488;0;7219;VERDADERO;VERDADERO;-39;;;
47480;47488;0;7220;VERDADERO;VERDADERO;-8;;;
47480;47488;0;7221;VERDADERO;VERDADERO;-8;;;
47480;47488;0;7222;VERDADERO;VERDADERO;-8;;;
47480;47508;0;7223;VERDADERO;VERDADERO;-28;;;
47480;47508;0;7224;VERDADERO;VERDADERO;-28;;;
47513;47528;0;7225;VERDADERO;VERDADERO;-15;;;
47513;47528;0;7226;VERDADERO;VERDADERO;-15;;;
47513;47528;0;7227;VERDADERO;VERDADERO;-15;;;
47513;47548;0;7228;VERDADERO;VERDADERO;-35;;;
47513;47548;0;7229;VERDADERO;VERDADERO;-35;;;
47513;47548;0;7230;VERDADERO;VERDADERO;-35;;;
47549;47548;0;7231;VERDADERO;VERDADERO;1;;;
47549;47568;0;7232;VERDADERO;VERDADERO;-19;;;
47549;47568;0;7233;VERDADERO;VERDADERO;-19;;;
47549;47568;0;7234;VERDADERO;VERDADERO;-19;;;
47549;47588;0;7235;VERDADERO;VERDADERO;-39;;;
47581;47588;0;7236;VERDADERO;VERDADERO;-7;;;
47581;47608;0;7237;VERDADERO;VERDADERO;-27;;;
47581;47608;0;7238;VERDADERO;VERDADERO;-27;;;
47581;47608;0;7239;VERDADERO;VERDADERO;-27;;;
47581;47608;0;7240;VERDADERO;VERDADERO;-27;;;
47613;47608;0;7241;VERDADERO;VERDADERO;5;;;
47613;47628;0;7242;VERDADERO;VERDADERO;-15;;;
47613;47628;0;7243;VERDADERO;VERDADERO;-15;;;
47613;47648;0;7244;VERDADERO;VERDADERO;-35;;;
47613;47648;0;7245;VERDADERO;VERDADERO;-35;;;
47613;47648;0;7246;VERDADERO;VERDADERO;-35;;;
47646;47648;0;7247;VERDADERO;VERDADERO;-2;;;
47646;47648;0;7248;VERDADERO;VERDADERO;-2;;;
47646;47648;0;7249;VERDADERO;VERDADERO;-2;;;
47646;47648;0;7250;VERDADERO;VERDADERO;-2;;;
47646;47648;0;7251;VERDADERO;VERDADERO;-2;;;
47677;47648;0;7252;VERDADERO;VERDADERO;29;;;
47677;47648;0;7253;VERDADERO;VERDADERO;29;;;
47677;47648;0;7254;VERDADERO;VERDADERO;29;;;
47677;47648;0;7255;VERDADERO;VERDADERO;29;;;
47677;47648;0;7256;VERDADERO;VERDADERO;29;;;
47677;47668;0;7257;VERDADERO;VERDADERO;9;;;
47713;47668;0;7258;VERDADERO;VERDADERO;45;;;
47713;47688;0;7259;VERDADERO;VERDADERO;25;;;
47713;47688;0;7260;VERDADERO;VERDADERO;25;;;
47713;47688;0;7261;VERDADERO;VERDADERO;25;;;
47744;47708;0;7262;VERDADERO;VERDADERO;36;;;
47744;47708;0;7263;VERDADERO;VERDADERO;36;;;
47744;47728;1;7264;VERDADERO;VERDADERO;16;;;
47744;47728;0;7265;VERDADERO;VERDADERO;16;;;
47744;47728;0;7266;VERDADERO;VERDADERO;16;;;
47744;47748;0;7267;VERDADERO;VERDADERO;-4;;;
47780;47748;0;7268;VERDADERO;VERDADERO;32;;;
47780;47768;0;7269;VERDADERO;VERDADERO;12;;;
47780;47768;0;7270;VERDADERO;VERDADERO;12;;;
47780;47768;0;7271;VERDADERO;VERDADERO;12;;;
47780;47788;0;7272;VERDADERO;VERDADERO;-8;;;
47812;47788;0;7273;VERDADERO;VERDADERO;24;;;
47812;47808;0;7274;VERDADERO;VERDADERO;4;;;
47812;47808;0;7275;VERDADERO;VERDADERO;4;;;
47812;47808;0;7276;VERDADERO;VERDADERO;4;;;
47812;47828;0;7277;VERDADERO;VERDADERO;-16;;;
47812;47828;0;7278;VERDADERO;VERDADERO;-16;;;
47849;47848;0;7279;VERDADERO;VERDADERO;1;;;
47849;47848;0;7280;VERDADERO;VERDADERO;1;;;
47849;47848;0;7281;VERDADERO;VERDADERO;1;;;
47849;47868;1;7282;VERDADERO;VERDADERO;-19;;;
47849;47868;0;7283;VERDADERO;VERDADERO;-19;;;
47881;47888;0;7284;VERDADERO;VERDADERO;-7;;;
47881;47888;0;7285;VERDADERO;VERDADERO;-7;;;
47881;47908;0;7286;VERDADERO;VERDADERO;-27;;;
47881;47908;0;7287;VERDADERO;VERDADERO;-27;;;
47913;47908;0;7288;VERDADERO;VERDADERO;5;;;
47913;47928;0;7289;VERDADERO;VERDADERO;-15;;;
47913;47928;0;7290;VERDADERO;VERDADERO;-15;;;
47913;47948;0;7291;VERDADERO;VERDADERO;-35;;;
47913;47948;0;7292;VERDADERO;VERDADERO;-35;;;
47913;47948;0;7293;VERDADERO;VERDADERO;-35;;;
47949;47948;0;7294;VERDADERO;VERDADERO;1;;;
47949;47948;0;7295;VERDADERO;VERDADERO;1;;;
47949;47968;0;7296;VERDADERO;VERDADERO;-19;;;
47949;47968;0;7297;VERDADERO;VERDADERO;-19;;;
47949;47988;0;7298;VERDADERO;VERDADERO;-39;;;
47981;47988;0;7299;VERDADERO;VERDADERO;-7;;;
47981;47988;0;7300;VERDADERO;VERDADERO;-7;;;
47981;48008;0;7301;VERDADERO;VERDADERO;-27;;;
47981;48008;0;7302;VERDADERO;VERDADERO;-27;;;
47981;48008;0;7303;VERDADERO;VERDADERO;-27;;;
48013;48008;0;7304;VERDADERO;VERDADERO;5;;;
48013;48028;0;7305;VERDADERO;VERDADERO;-15;;;
48013;48028;0;7306;VERDADERO;VERDADERO;-15;;;
48013;48048;0;7307;VERDADERO;VERDADERO;-35;;;
48013;48048;0;7308;VERDADERO;VERDADERO;-35;;;
48013;48048;0;7309;VERDADERO;VERDADERO;-35;;;
48049;48048;0;7310;VERDADERO;VERDADERO;1;;;
48049;48048;0;7311;VERDADERO;VERDADERO;1;;;
48049;48068;1;7312;VERDADERO;VERDADERO;-19;;;
48049;48068;0;7313;VERDADERO;VERDADERO;-19;;;
48049;48068;0;7314;VERDADERO;VERDADERO;-19;;;
48081;48088;0;7315;VERDADERO;VERDADERO;-7;;;
48081;48088;0;7316;VERDADERO;VERDADERO;-7;;;
48081;48108;0;7317;VERDADERO;VERDADERO;-27;;;
48081;48108;0;7318;VERDADERO;VERDADERO;-27;;;
48081;48108;0;7319;VERDADERO;VERDADERO;-27;;;
48113;48108;0;7320;VERDADERO;VERDADERO;5;;;
48113;48128;0;7321;VERDADERO;VERDADERO;-15;;;
48113;48128;0;7322;VERDADERO;VERDADERO;-15;;;
48113;48148;0;7323;VERDADERO;VERDADERO;-35;;;
48113;48148;0;7324;VERDADERO;VERDADERO;-35;;;
48113;48148;0;7325;VERDADERO;VERDADERO;-35;;;
48149;48168;1;7326;VERDADERO;VERDADERO;-19;;;
48149;48168;0;7327;VERDADERO;VERDADERO;-19;;;
48149;48188;0;7328;VERDADERO;VERDADERO;-39;;;
48149;48188;0;7329;VERDADERO;VERDADERO;-39;;;
48149;48188;0;7330;VERDADERO;VERDADERO;-39;;;
48181;48208;1;7331;VERDADERO;VERDADERO;-27;;;
48181;48208;0;7332;VERDADERO;VERDADERO;-27;;;
48181;48208;0;7333;VERDADERO;VERDADERO;-27;;;
48181;48208;0;7334;VERDADERO;VERDADERO;-27;;;
48181;48228;0;7335;VERDADERO;VERDADERO;-47;;;
48213;48228;0;7336;VERDADERO;VERDADERO;-15;;;
48213;48248;0;7337;VERDADERO;VERDADERO;-35;;;
48213;48248;0;7338;VERDADERO;VERDADERO;-35;;;
48213;48248;0;7339;VERDADERO;VERDADERO;-35;;;
48213;48248;0;7340;VERDADERO;VERDADERO;-35;;;
48245;48248;0;7341;VERDADERO;VERDADERO;-3;;;
48245;48248;0;7342;VERDADERO;VERDADERO;-3;;;
48245;48268;0;7343;VERDADERO;VERDADERO;-23;;;
48245;48268;0;7344;VERDADERO;VERDADERO;-23;;;
48245;48288;0;7345;VERDADERO;VERDADERO;-43;;;
48277;48288;0;7346;VERDADERO;VERDADERO;-11;;;
48277;48288;0;7347;VERDADERO;VERDADERO;-11;;;
48277;48308;0;7348;VERDADERO;VERDADERO;-31;;;
48277;48308;0;7349;VERDADERO;VERDADERO;-31;;;
48277;48308;0;7350;VERDADERO;VERDADERO;-31;;;
48277;48308;0;7351;VERDADERO;VERDADERO;-31;;;
48313;48308;0;7352;VERDADERO;VERDADERO;5;;;
48313;48308;0;7353;VERDADERO;VERDADERO;5;;;
48313;48308;0;7354;VERDADERO;VERDADERO;5;;;
48313;48308;0;7355;VERDADERO;VERDADERO;5;;;
48313;48308;0;7356;VERDADERO;VERDADERO;5;;;
48345;48308;0;7357;VERDADERO;VERDADERO;37;;;
48345;48308;0;7358;VERDADERO;VERDADERO;37;;;
48345;48308;0;7359;VERDADERO;VERDADERO;37;;;
48345;48308;0;7360;VERDADERO;VERDADERO;37;;;
48345;48308;0;7361;VERDADERO;VERDADERO;37;;;
48377;48308;0;7362;FALSO;VERDADERO;69;;;
48377;48308;0;7363;FALSO;VERDADERO;69;;;
48377;48308;0;7364;FALSO;VERDADERO;69;;;
48377;48308;0;7365;FALSO;VERDADERO;69;;;
48377;48308;0;7366;FALSO;VERDADERO;69;;;
48377;48308;0;7367;FALSO;VERDADERO;69;;;
48409;48308;0;7368;FALSO;VERDADERO;101;;;
48409;48328;0;7369;FALSO;VERDADERO;81;;;
48409;48328;0;7370;FALSO;VERDADERO;81;;;
48409;48348;0;7371;FALSO;VERDADERO;61;;;
48409;48348;0;7372;FALSO;VERDADERO;61;;;
48442;48348;0;7373;FALSO;VERDADERO;94;;;
48442;48368;0;7374;FALSO;VERDADERO;74;;;
48442;48368;0;7375;FALSO;VERDADERO;74;;;
48442;48388;0;7376;FALSO;VERDADERO;54;;;
48442;48388;0;7377;FALSO;VERDADERO;54;;;
48477;48388;0;7378;FALSO;VERDADERO;89;;;
48477;48408;0;7379;FALSO;VERDADERO;69;;;
48477;48408;0;7380;FALSO;VERDADERO;69;;;
48477;48428;1;7381;VERDADERO;VERDADERO;49;;;
48477;48428;0;7382;VERDADERO;VERDADERO;49;;;
48509;48448;0;7383;FALSO;VERDADERO;61;;;
48509;48448;0;7384;FALSO;VERDADERO;61;;;
48509;48448;0;7385;FALSO;VERDADERO;61;;;
48509;48468;0;7386;VERDADERO;VERDADERO;41;;;
48509;48468;0;7387;VERDADERO;VERDADERO;41;;;
48509;48488;0;7388;VERDADERO;VERDADERO;21;;;
48545;48488;0;7389;FALSO;VERDADERO;57;;;
48545;48488;0;7390;FALSO;VERDADERO;57;;;
48545;48508;0;7391;VERDADERO;VERDADERO;37;;;
48545;48508;0;7392;VERDADERO;VERDADERO;37;;;
48545;48528;1;7393;VERDADERO;VERDADERO;17;;;
48581;48528;0;7394;FALSO;VERDADERO;53;;;
48581;48528;0;7395;FALSO;VERDADERO;53;;;
48581;48548;0;7396;VERDADERO;VERDADERO;33;;;
48581;48548;0;7397;VERDADERO;VERDADERO;33;;;
48581;48568;0;7398;VERDADERO;VERDADERO;13;;;
48613;48568;0;7399;VERDADERO;VERDADERO;45;;;
48613;48568;0;7400;VERDADERO;VERDADERO;45;;;
48613;48588;0;7401;VERDADERO;VERDADERO;25;;;
48613;48588;0;7402;VERDADERO;VERDADERO;25;;;
48613;48608;0;7403;VERDADERO;VERDADERO;5;;;
48645;48608;0;7404;VERDADERO;VERDADERO;37;;;
48645;48608;0;7405;VERDADERO;VERDADERO;37;;;
48645;48628;0;7406;VERDADERO;VERDADERO;17;;;
48645;48628;0;7407;VERDADERO;VERDADERO;17;;;
48645;48648;0;7408;VERDADERO;VERDADERO;-3;;;
48645;48648;0;7409;VERDADERO;VERDADERO;-3;;;
48681;48668;0;7410;VERDADERO;VERDADERO;13;;;
48681;48668;0;7411;VERDADERO;VERDADERO;13;;;
48681;48668;0;7412;VERDADERO;VERDADERO;13;;;
48681;48688;0;7413;VERDADERO;VERDADERO;-7;;;
48681;48688;0;7414;VERDADERO;VERDADERO;-7;;;
48713;48708;0;7415;VERDADERO;VERDADERO;5;;;
48713;48708;0;7416;VERDADERO;VERDADERO;5;;;
48713;48708;0;7417;VERDADERO;VERDADERO;5;;;
48713;48728;0;7418;VERDADERO;VERDADERO;-15;;;
48713;48728;0;7419;VERDADERO;VERDADERO;-15;;;
48713;48728;0;7420;VERDADERO;VERDADERO;-15;;;
48749;48748;0;7421;VERDADERO;VERDADERO;1;;;
48749;48748;0;7422;VERDADERO;VERDADERO;1;;;
48749;48768;0;7423;VERDADERO;VERDADERO;-19;;;
48749;48768;0;7424;VERDADERO;VERDADERO;-19;;;
48749;48768;0;7425;VERDADERO;VERDADERO;-19;;;
48781;48788;0;7426;VERDADERO;VERDADERO;-7;;;
48781;48788;0;7427;VERDADERO;VERDADERO;-7;;;
48781;48808;0;7428;VERDADERO;VERDADERO;-27;;;
48781;48808;0;7429;VERDADERO;VERDADERO;-27;;;
48781;48808;0;7430;VERDADERO;VERDADERO;-27;;;
48817;48828;0;7431;VERDADERO;VERDADERO;-11;;;
48817;48828;0;7432;VERDADERO;VERDADERO;-11;;;
48817;48848;0;7433;VERDADERO;VERDADERO;-31;;;
48817;48848;0;7434;VERDADERO;VERDADERO;-31;;;
48817;48848;0;7435;VERDADERO;VERDADERO;-31;;;
48849;48848;0;7436;VERDADERO;VERDADERO;1;;;
48849;48868;0;7437;VERDADERO;VERDADERO;-19;;;
48849;48868;0;7438;VERDADERO;VERDADERO;-19;;;
48849;48868;0;7439;VERDADERO;VERDADERO;-19;;;
48849;48888;0;7440;VERDADERO;VERDADERO;-39;;;
48881;48888;0;7441;VERDADERO;VERDADERO;-7;;;
48881;48908;0;7442;VERDADERO;VERDADERO;-27;;;
48881;48908;0;7443;VERDADERO;VERDADERO;-27;;;
48881;48908;0;7444;VERDADERO;VERDADERO;-27;;;
48881;48928;0;7445;VERDADERO;VERDADERO;-47;;;
48881;48928;0;7446;VERDADERO;VERDADERO;-47;;;
48917;48948;0;7447;VERDADERO;VERDADERO;-31;;;
48917;48948;0;7448;VERDADERO;VERDADERO;-31;;;
48917;48948;0;7449;VERDADERO;VERDADERO;-31;;;
48917;48948;0;7450;VERDADERO;VERDADERO;-31;;;
48917;48948;0;7451;VERDADERO;VERDADERO;-31;;;
48949;48968;0;7452;VERDADERO;VERDADERO;-19;;;
48949;48968;0;7453;VERDADERO;VERDADERO;-19;;;
48949;48968;0;7454;VERDADERO;VERDADERO;-19;;;
48949;48988;1;7455;VERDADERO;VERDADERO;-39;;;
48949;48988;0;7456;VERDADERO;VERDADERO;-39;;;
48981;49008;1;7457;VERDADERO;VERDADERO;-27;;;
48981;49008;0;7458;VERDADERO;VERDADERO;-27;;;
48981;49008;0;7459;VERDADERO;VERDADERO;-27;;;
48981;49008;0;7460;VERDADERO;VERDADERO;-27;;;
48981;49028;0;7461;VERDADERO;VERDADERO;-47;;;
49013;49028;0;7462;VERDADERO;VERDADERO;-15;;;
49013;49048;0;7463;VERDADERO;VERDADERO;-35;;;
49013;49048;0;7464;VERDADERO;VERDADERO;-35;;;
49013;49048;0;7465;VERDADERO;VERDADERO;-35;;;
49013;49048;0;7466;VERDADERO;VERDADERO;-35;;;
49045;49048;0;7467;VERDADERO;VERDADERO;-3;;;
49045;49048;0;7468;VERDADERO;VERDADERO;-3;;;
49045;49048;0;7469;VERDADERO;VERDADERO;-3;;;
49045;49068;0;7470;VERDADERO;VERDADERO;-23;;;
49045;49068;0;7471;VERDADERO;VERDADERO;-23;;;
49045;49068;0;7472;VERDADERO;VERDADERO;-23;;;
49081;49088;0;7473;VERDADERO;VERDADERO;-7;;;
49081;49088;0;7474;VERDADERO;VERDADERO;-7;;;
49081;49108;0;7475;VERDADERO;VERDADERO;-27;;;
49081;49108;0;7476;VERDADERO;VERDADERO;-27;;;
49081;49108;0;7477;VERDADERO;VERDADERO;-27;;;
49113;49128;0;7478;VERDADERO;VERDADERO;-15;;;
49113;49128;0;7479;VERDADERO;VERDADERO;-15;;;
49113;49148;0;7480;VERDADERO;VERDADERO;-35;;;
49113;49148;0;7481;VERDADERO;VERDADERO;-35;;;
49113;49148;0;7482;VERDADERO;VERDADERO;-35;;;
49145;49168;1;7483;VERDADERO;VERDADERO;-23;;;
49145;49168;0;7484;VERDADERO;VERDADERO;-23;;;
49145;49168;0;7485;VERDADERO;VERDADERO;-23;;;
49145;49188;0;7486;VERDADERO;VERDADERO;-43;;;
49145;49188;0;7487;VERDADERO;VERDADERO;-43;;;
49145;49208;1;7488;VERDADERO;FALSO;-63;;;
49181;49208;0;7489;VERDADERO;VERDADERO;-27;;;
49181;49208;0;7490;VERDADERO;VERDADERO;-27;;;
49181;49208;0,00E+00;7491;VERDADERO;VERDADERO;-27;;;
49181;49208;0;7492;VERDADERO;VERDADERO;-27;;;
49181;49228;0;7493;VERDADERO;VERDADERO;-47;;;
49213;49228;0;7494;VERDADERO;VERDADERO;-15;;;
49213;49248;0;7495;VERDADERO;VERDADERO;-35;;;
49213;49248;0;7496;VERDADERO;VERDADERO;-35;;;
49213;49248;0;7497;VERDADERO;VERDADERO;-35;;;
49213;49248;0;7498;VERDADERO;VERDADERO;-35;;;
49245;49248;0;7499;VERDADERO;VERDADERO;-3;;;
49245;49248;0;7500;VERDADERO;VERDADERO;-3;;;
49245;49248;0;7501;VERDADERO;VERDADERO;-3;;;
49245;49248;0;7502;VERDADERO;VERDADERO;-3;;;
49245;49268;0;7503;VERDADERO;VERDADERO;-23;;;
49277;49268;0;7504;VERDADERO;VERDADERO;9;;;
49277;49288;0;7505;VERDADERO;VERDADERO;-11;;;
49277;49288;0;7506;VERDADERO;VERDADERO;-11;;;
49277;49308;0;7507;VERDADERO;VERDADERO;-31;;;
49277;49308;0;7508;VERDADERO;VERDADERO;-31;;;
49309;49308;0;7509;VERDADERO;VERDADERO;1;;;
49309;49328;0;7510;VERDADERO;VERDADERO;-19;;;
49309;49328;0;7511;VERDADERO;VERDADERO;-19;;;
49309;49348;0;7512;VERDADERO;VERDADERO;-39;;;
49309;49348;0;7513;VERDADERO;VERDADERO;-39;;;
49345;49348;0;7514;VERDADERO;VERDADERO;-3;;;
49345;49368;0;7515;VERDADERO;VERDADERO;-23;;;
49345;49368;0;7516;VERDADERO;VERDADERO;-23;;;
49345;49368;0;7517;VERDADERO;VERDADERO;-23;;;
49345;49388;0;7518;VERDADERO;VERDADERO;-43;;;
49377;49388;0;7519;VERDADERO;VERDADERO;-11;;;
49377;49388;0;7520;VERDADERO;VERDADERO;-11;;;
49377;49408;0;7521;VERDADERO;VERDADERO;-31;;;
49377;49408;0;7522;VERDADERO;VERDADERO;-31;;;
49377;49408;0;7523;VERDADERO;VERDADERO;-31;;;
49377;49408;0;7524;VERDADERO;VERDADERO;-31;;;
49412;49428;1;7525;VERDADERO;VERDADERO;-16;;;
49412;49428;0;7526;VERDADERO;VERDADERO;-16;;;
49412;49428;0;7527;VERDADERO;VERDADERO;-16;;;
49412;49448;0;7528;VERDADERO;VERDADERO;-36;;;
49412;49448;0;7529;VERDADERO;VERDADERO;-36;;;
49445;49468;0;7530;VERDADERO;VERDADERO;-23;;;
49445;49468;0;7531;VERDADERO;VERDADERO;-23;;;
49445;49468;0;7532;VERDADERO;VERDADERO;-23;;;
49445;49468;0;7533;VERDADERO;VERDADERO;-23;;;
49445;49488;0;7534;VERDADERO;VERDADERO;-43;;;
49445;49488;0;7535;VERDADERO;VERDADERO;-43;;;
49480;49488;0;7536;VERDADERO;VERDADERO;-8;;;
49480;49508;0;7537;VERDADERO;VERDADERO;-28;;;
49480;49508;0;7538;VERDADERO;VERDADERO;-28;;;
49480;49508;0;7539;VERDADERO;VERDADERO;-28;;;
49480;49508;0;7540;VERDADERO;VERDADERO;-28;;;
49480;49508;0;7541;VERDADERO;VERDADERO;-28;;;
49480;49528;0;7542;VERDADERO;VERDADERO;-48;;;
49480;49528;0;7543;VERDADERO;VERDADERO;-48;;;
49480;49548;1;7544;VERDADERO;FALSO;-68;;;
49480;49548;0;7545;VERDADERO;FALSO;-68;;;
49480;49548;0;7546;VERDADERO;FALSO;-68;;;
49549;49568;1;7547;VERDADERO;VERDADERO;-19;;;
49549;49568;0;7548;VERDADERO;VERDADERO;-19;;;
49549;49568;0;7549;VERDADERO;VERDADERO;-19;;;
49549;49568;0;7550;VERDADERO;VERDADERO;-19;;;
49549;49588;0;7551;VERDADERO;VERDADERO;-39;;;
49581;49588;0;7552;VERDADERO;VERDADERO;-7;;;
49581;49588;0;7553;VERDADERO;VERDADERO;-7;;;
49581;49608;0;7554;VERDADERO;VERDADERO;-27;;;
49581;49608;0;7555;VERDADERO;VERDADERO;-27;;;
49581;49608;0;7556;VERDADERO;VERDADERO;-27;;;
49617;49608;0;7557;VERDADERO;VERDADERO;9;;;
49617;49608;0;7558;VERDADERO;VERDADERO;9;;;
49617;49628;0;7559;VERDADERO;VERDADERO;-11;;;
49617;49628;0;7560;VERDADERO;VERDADERO;-11;;;
49617;49648;0;7561;VERDADERO;VERDADERO;-31;;;
49649;49648;0;7562;VERDADERO;VERDADERO;1;;;
49649;49648;0;7563;VERDADERO;VERDADERO;1;;;
49649;49668;0;7564;VERDADERO;VERDADERO;-19;;;
49649;49668;0;7565;VERDADERO;VERDADERO;-19;;;
49649;49668;0;7566;VERDADERO;VERDADERO;-19;;;
49682;49688;0;7567;VERDADERO;VERDADERO;-6;;;
49682;49688;0;7568;VERDADERO;VERDADERO;-6;;;
49682;49708;1;7569;VERDADERO;VERDADERO;-26;;;
49682;49708;0;7570;VERDADERO;VERDADERO;-26;;;
49682;49708;0;7571;VERDADERO;VERDADERO;-26;;;
49713;49728;1;7572;VERDADERO;VERDADERO;-15;;;
49713;49728;0;7573;VERDADERO;VERDADERO;-15;;;
49713;49748;0;7574;VERDADERO;VERDADERO;-35;;;
49713;49748;0;7575;VERDADERO;VERDADERO;-35;;;
49713;49768;0;7576;VERDADERO;FALSO;-55;;;
49745;49768;0;7577;VERDADERO;VERDADERO;-23;;;
49745;49768;0;7578;VERDADERO;VERDADERO;-23;;;
49745;49768;0;7579;VERDADERO;VERDADERO;-23;;;
49745;49768;0;7580;VERDADERO;VERDADERO;-23;;;
49745;49768;0;7581;VERDADERO;VERDADERO;-23;;;
49745;49768;0;7582;VERDADERO;VERDADERO;-23;;;
49781;49768;0;7583;VERDADERO;VERDADERO;13;;;
49781;49768;0;7584;VERDADERO;VERDADERO;13;;;
49781;49788;0;7585;VERDADERO;VERDADERO;-7;;;
49781;49788;0;7586;VERDADERO;VERDADERO;-7;;;
49781;49808;0;7587;VERDADERO;VERDADERO;-27;;;
49812;49808;0;7588;VERDADERO;VERDADERO;4;;;
49812;49808;0;7589;VERDADERO;VERDADERO;4;;;
49812;49808;0;7590;VERDADERO;VERDADERO;4;;;
49812;49808;0;7591;VERDADERO;VERDADERO;4;;;
49812;49808;0;7592;VERDADERO;VERDADERO;4;;;
49844;49828;0;7593;VERDADERO;VERDADERO;16;;;
49844;49828;0;7594;VERDADERO;VERDADERO;16;;;
49844;49848;0;7595;VERDADERO;VERDADERO;-4;;;
49844;49848;0;7596;VERDADERO;VERDADERO;-4;;;
49844;49848;0;7597;VERDADERO;VERDADERO;-4;;;
49877;49868;0;7598;VERDADERO;VERDADERO;9;;;
49877;49868;0;7599;VERDADERO;VERDADERO;9;;;
49877;49888;0;7600;VERDADERO;VERDADERO;-11;;;
49877;49888;0;7601;VERDADERO;VERDADERO;-11;;;
49877;49888;0;7602;VERDADERO;VERDADERO;-11;;;
49910;49908;0;7603;VERDADERO;VERDADERO;2;;;
49910;49908;0;7604;VERDADERO;VERDADERO;2;;;
49910;49928;0;7605;VERDADERO;VERDADERO;-18;;;
49910;49928;0;7606;VERDADERO;VERDADERO;-18;;;
49910;49928;0;7607;VERDADERO;VERDADERO;-18;;;
49910;49948;0;7608;VERDADERO;VERDADERO;-38;;;
49945;49948;0;7609;VERDADERO;VERDADERO;-3;;;
49945;49948;0;7610;VERDADERO;VERDADERO;-3;;;
49945;49968;0;7611;VERDADERO;VERDADERO;-23;;;
49945;49968;0;7612;VERDADERO;VERDADERO;-23;;;
49945;49988;0;7613;VERDADERO;VERDADERO;-43;;;
49977;49988;0;7614;VERDADERO;VERDADERO;-11;;;
49977;49988;0;7615;VERDADERO;VERDADERO;-11;;;
49977;49988;0;7616;VERDADERO;VERDADERO;-11;;;
49977;50008;0;7617;VERDADERO;VERDADERO;-31;;;
49977;50008;0;7618;VERDADERO;VERDADERO;-31;;;
50009;50028;0;7619;VERDADERO;VERDADERO;-19;;;
50009;50028;0;7620;VERDADERO;VERDADERO;-19;;;
50009;50028;0;7621;VERDADERO;VERDADERO;-19;;;
50009;50028;0;7622;VERDADERO;VERDADERO;-19;;;
50009;50028;0;7623;VERDADERO;VERDADERO;-19;;;
50009;50028;0;7624;VERDADERO;VERDADERO;-19;;;
50045;50048;0;7625;VERDADERO;VERDADERO;-3;;;
50045;50048;0;7626;VERDADERO;VERDADERO;-3;;;
50045;50068;0;7627;VERDADERO;VERDADERO;-23;;;
50045;50068;0;7628;VERDADERO;VERDADERO;-23;;;
50045;50068;0;7629;VERDADERO;VERDADERO;-23;;;
50077;50088;0;7630;VERDADERO;VERDADERO;-11;;;
50077;50088;0;7631;VERDADERO;VERDADERO;-11;;;
50077;50108;0;7632;VERDADERO;VERDADERO;-31;;;
50077;50108;0;7633;VERDADERO;VERDADERO;-31;;;
50077;50128;0;7634;VERDADERO;FALSO;-51;;;
50109;50128;0;7635;VERDADERO;VERDADERO;-19;;;
50109;50128;0;7636;VERDADERO;VERDADERO;-19;;;
50109;50128;0;7637;VERDADERO;VERDADERO;-19;;;
50109;50128;0;7638;VERDADERO;VERDADERO;-19;;;
50109;50148;0;7639;VERDADERO;VERDADERO;-39;;;
50144;50148;0;7640;VERDADERO;VERDADERO;-4;;;
50144;50148;0;7641;VERDADERO;VERDADERO;-4;;;
50144;50169;0;7642;VERDADERO;VERDADERO;-25;;;
50144;50169;0;7643;VERDADERO;VERDADERO;-25;;;
50144;50189;1;7644;VERDADERO;VERDADERO;-45;;;
50144;50189;0;7645;VERDADERO;VERDADERO;-45;;;
50180;50189;0;7646;VERDADERO;VERDADERO;-9;;;
50180;50209;1;7647;VERDADERO;VERDADERO;-29;;;
50180;50209;0;7648;VERDADERO;VERDADERO;-29;;;
50180;50229;0;7649;VERDADERO;VERDADERO;-49;;;
50180;50229;0;7650;VERDADERO;VERDADERO;-49;;;
50213;50229;0;7651;VERDADERO;VERDADERO;-16;;;
50213;50229;0;7652;VERDADERO;VERDADERO;-16;;;
50213;50249;0;7653;VERDADERO;VERDADERO;-36;;;
50213;50249;0;7654;VERDADERO;VERDADERO;-36;;;
50213;50269;0;7655;VERDADERO;FALSO;-56;;;
50213;50269;0;7656;VERDADERO;FALSO;-56;;;
50249;50269;0;7657;VERDADERO;VERDADERO;-20;;;
50249;50269;0;7658;VERDADERO;VERDADERO;-20;;;
50249;50269;0;7659;VERDADERO;VERDADERO;-20;;;
50249;50289;0;7660;VERDADERO;VERDADERO;-40;;;
50249;50289;0;7661;VERDADERO;VERDADERO;-40;;;
50281;50309;0;7662;VERDADERO;VERDADERO;-28;;;
50281;50309;0;7663;VERDADERO;VERDADERO;-28;;;
50281;50309;0;7664;VERDADERO;VERDADERO;-28;;;
50281;50309;0;7665;VERDADERO;VERDADERO;-28;;;
50281;50309;0;7666;VERDADERO;VERDADERO;-28;;;
50313;50309;0;7667;VERDADERO;VERDADERO;4;;;
50313;50329;1;7668;VERDADERO;VERDADERO;-16;;;
50313;50329;0;7669;VERDADERO;VERDADERO;-16;;;
50313;50349;1;7670;VERDADERO;VERDADERO;-36;;;
50313;50349;0;7671;VERDADERO;VERDADERO;-36;;;
50345;50349;0;7672;VERDADERO;VERDADERO;-4;;;
50345;50369;0;7673;VERDADERO;VERDADERO;-24;;;
50345;50369;0;7674;VERDADERO;VERDADERO;-24;;;
50345;50389;0;7675;VERDADERO;VERDADERO;-44;;;
50345;50389;0;7676;VERDADERO;VERDADERO;-44;;;
50377;50389;0;7677;VERDADERO;VERDADERO;-12;;;
50377;50409;0;7678;VERDADERO;VERDADERO;-32;;;
50377;50409;0;7679;VERDADERO;VERDADERO;-32;;;
50377;50409;0;7680;VERDADERO;VERDADERO;-32;;;
50377;50409;0;7681;VERDADERO;VERDADERO;-32;;;
50377;50429;0;7682;VERDADERO;FALSO;-52;;;
50413;50429;0;7683;VERDADERO;VERDADERO;-16;;;
50413;50429;0;7684;VERDADERO;VERDADERO;-16;;;
50413;50449;0;7685;VERDADERO;VERDADERO;-36;;;
50413;50449;0;7686;VERDADERO;VERDADERO;-36;;;
50413;50449;0;7687;VERDADERO;VERDADERO;-36;;;
50445;50449;0;7688;VERDADERO;VERDADERO;-4;;;
50445;50449;0;7689;VERDADERO;VERDADERO;-4;;;
50445;50469;0;7690;VERDADERO;VERDADERO;-24;;;
50445;50469;0;7691;VERDADERO;VERDADERO;-24;;;
50445;50489;0;7692;VERDADERO;VERDADERO;-44;;;
50477;50489;0;7693;VERDADERO;VERDADERO;-12;;;
50477;50509;0;7694;VERDADERO;VERDADERO;-32;;;
50477;50509;0;7695;VERDADERO;VERDADERO;-32;;;
50477;50509;0;7696;VERDADERO;VERDADERO;-32;;;
50477;50509;0;7697;VERDADERO;VERDADERO;-32;;;
50477;50529;0;7698;VERDADERO;FALSO;-52;;;
50513;50529;0;7699;VERDADERO;VERDADERO;-16;;;
50513;50529;0;7700;VERDADERO;VERDADERO;-16;;;
50513;50549;0;7701;VERDADERO;VERDADERO;-36;;;
50513;50549;0;7702;VERDADERO;VERDADERO;-36;;;
50545;50549;0;7703;VERDADERO;VERDADERO;-4;;;
50545;50549;0;7704;VERDADERO;VERDADERO;-4;;;
50545;50569;0;7705;VERDADERO;VERDADERO;-24;;;
50545;50569;0;7706;VERDADERO;VERDADERO;-24;;;
50545;50569;0;7707;VERDADERO;VERDADERO;-24;;;
50545;50589;0;7708;VERDADERO;VERDADERO;-44;;;
50577;50589;0;7709;VERDADERO;VERDADERO;-12;;;
50577;50609;0;7710;VERDADERO;VERDADERO;-32;;;
50577;50609;0;7711;VERDADERO;VERDADERO;-32;;;
50577;50609;0;7712;VERDADERO;VERDADERO;-32;;;
50577;50609;0;7713;VERDADERO;VERDADERO;-32;;;
50613;50629;1;7714;VERDADERO;VERDADERO;-16;;;
50613;50629;0;7715;VERDADERO;VERDADERO;-16;;;
50613;50629;0;7716;VERDADERO;VERDADERO;-16;;;
50613;50649;0;7717;VERDADERO;VERDADERO;-36;;;
50613;50649;0;7718;VERDADERO;VERDADERO;-36;;;
50645;50649;0;7719;VERDADERO;VERDADERO;-4;;;
50645;50649;0;7720;VERDADERO;VERDADERO;-4;;;
50645;50669;0;7721;VERDADERO;VERDADERO;-24;;;
50645;50669;0;7722;VERDADERO;VERDADERO;-24;;;
50645;50669;0;7723;VERDADERO;VERDADERO;-24;;;
50677;50690;1;7724;VERDADERO;VERDADERO;-13;;;
50677;50690;0;7725;VERDADERO;VERDADERO;-13;;;
50677;50710;0;7726;VERDADERO;VERDADERO;-33;;;
50677;50710;0;7727;VERDADERO;VERDADERO;-33;;;
50677;50710;0;7728;VERDADERO;VERDADERO;-33;;;
50709;50730;0;7729;VERDADERO;VERDADERO;-21;;;
50709;50730;0;7730;VERDADERO;VERDADERO;-21;;;
50709;50730;0;7731;VERDADERO;VERDADERO;-21;;;
50709;50750;0;7732;VERDADERO;VERDADERO;-41;;;
50709;50750;0;7733;VERDADERO;VERDADERO;-41;;;
50741;50750;0;7734;VERDADERO;VERDADERO;-9;;;
50741;50750;0;7735;VERDADERO;VERDADERO;-9;;;
50741;50750;0;7736;VERDADERO;VERDADERO;-9;;;
50741;50770;0;7737;VERDADERO;VERDADERO;-29;;;
50741;50770;0;7738;VERDADERO;VERDADERO;-29;;;
50741;50770;0;7739;VERDADERO;VERDADERO;-29;;;
50777;50790;0;7740;VERDADERO;VERDADERO;-13;;;
50777;50790;0;7741;VERDADERO;VERDADERO;-13;;;
50777;50810;1;7742;VERDADERO;VERDADERO;-33;;;
50777;50810;0;7743;VERDADERO;VERDADERO;-33;;;
50777;50810;0;7744;VERDADERO;VERDADERO;-33;;;
50809;50830;1;7745;VERDADERO;VERDADERO;-21;;;
50809;50830;0;7746;VERDADERO;VERDADERO;-21;;;
50809;50850;1;7747;VERDADERO;VERDADERO;-41;;;
50809;50850;0;7748;VERDADERO;VERDADERO;-41;;;
50809;50850;0;7749;VERDADERO;VERDADERO;-41;;;
50841;50850;0;7750;VERDADERO;VERDADERO;-9;;;
50841;50870;0;7751;VERDADERO;VERDADERO;-29;;;
50841;50870;0;7752;VERDADERO;VERDADERO;-29;;;
50841;50870;0;7753;VERDADERO;VERDADERO;-29;;;
50841;50890;0;7754;VERDADERO;VERDADERO;-49;;;
50877;50890;0;7755;VERDADERO;VERDADERO;-13;;;
50877;50890;0;7756;VERDADERO;VERDADERO;-13;;;
50877;50890;0;7757;VERDADERO;VERDADERO;-13;;;
50877;50890;0;7758;VERDADERO;VERDADERO;-13;;;
50877;50910;0;7759;VERDADERO;VERDADERO;-33;;;
50909;50910;0;7760;VERDADERO;VERDADERO;-1;;;
50909;50930;0;7761;VERDADERO;VERDADERO;-21;;;
50909;50930;0;7762;VERDADERO;VERDADERO;-21;;;
50909;50930;0;7763;VERDADERO;VERDADERO;-21;;;
50909;50950;0;7764;VERDADERO;VERDADERO;-41;;;
50909;50950;0;7765;VERDADERO;VERDADERO;-41;;;
50945;50950;0;7766;VERDADERO;VERDADERO;-5;;;
50945;50970;1;7767;VERDADERO;VERDADERO;-25;;;
50945;50970;0;7768;VERDADERO;VERDADERO;-25;;;
50945;50970;0;7769;VERDADERO;VERDADERO;-25;;;
50945;50990;0;7770;VERDADERO;VERDADERO;-45;;;
50945;50990;0;7771;VERDADERO;VERDADERO;-45;;;
50980;50990;0;7772;VERDADERO;VERDADERO;-10;;;
50980;50990;0;7773;VERDADERO;VERDADERO;-10;;;
50980;50990;0;7774;VERDADERO;VERDADERO;-10;;;
50980;51010;0;7775;VERDADERO;VERDADERO;-30;;;
50980;51010;0;7776;VERDADERO;VERDADERO;-30;;;
51013;51010;0;7777;VERDADERO;VERDADERO;3;;;
51013;51030;0;7778;VERDADERO;VERDADERO;-17;;;
51013;51030;0;7779;VERDADERO;VERDADERO;-17;;;
51013;51050;0;7780;VERDADERO;VERDADERO;-37;;;
51013;51050;0;7781;VERDADERO;VERDADERO;-37;;;
51045;51050;0;7782;VERDADERO;VERDADERO;-5;;;
51045;51070;0;7783;VERDADERO;VERDADERO;-25;;;
51045;51070;0;7784;VERDADERO;VERDADERO;-25;;;
51045;51090;1;7785;VERDADERO;VERDADERO;-45;;;
51045;51090;0;7786;VERDADERO;VERDADERO;-45;;;
51081;51090;0;7787;VERDADERO;VERDADERO;-9;;;
51081;51090;0;7788;VERDADERO;VERDADERO;-9;;;
51081;51090;0;7789;VERDADERO;VERDADERO;-9;;;
51081;51090;0;7790;VERDADERO;VERDADERO;-9;;;
51081;51110;0;7791;VERDADERO;VERDADERO;-29;;;
51081;51110;0;7792;VERDADERO;VERDADERO;-29;;;
51114;51110;0;7793;VERDADERO;VERDADERO;4;;;
51114;51130;0;7794;VERDADERO;VERDADERO;-16;;;
51114;51130;0;7795;VERDADERO;VERDADERO;-16;;;
51114;51150;0;7796;VERDADERO;VERDADERO;-36;;;
51114;51150;0;7797;VERDADERO;VERDADERO;-36;;;
51149;51150;0;7798;VERDADERO;VERDADERO;-1;;;
51149;51170;0;7799;VERDADERO;VERDADERO;-21;;;
51149;51170;0;7800;VERDADERO;VERDADERO;-21;;;
51149;51190;0;7801;VERDADERO;VERDADERO;-41;;;
51149;51190;0;7802;VERDADERO;VERDADERO;-41;;;
51181;51190;0;7803;VERDADERO;VERDADERO;-9;;;
51181;51190;0;7804;VERDADERO;VERDADERO;-9;;;
51181;51190;0;7805;VERDADERO;VERDADERO;-9;;;
51181;51210;1;7806;VERDADERO;VERDADERO;-29;;;
51181;51210;0;7807;VERDADERO;VERDADERO;-29;;;
51213;51230;0;7808;VERDADERO;VERDADERO;-17;;;
51213;51230;0;7809;VERDADERO;VERDADERO;-17;;;
51213;51230;0;7810;VERDADERO;VERDADERO;-17;;;
51213;51250;0;7811;VERDADERO;VERDADERO;-37;;;
51213;51250;0;7812;VERDADERO;VERDADERO;-37;;;
51213;51270;0;7813;VERDADERO;FALSO;-57;;;
51213;51270;0;7814;VERDADERO;FALSO;-57;;;
51255;51270;0;7815;VERDADERO;VERDADERO;-15;;;
51255;51290;1;7816;VERDADERO;VERDADERO;-35;;;
51255;51290;0;7817;VERDADERO;VERDADERO;-35;;;
51255;51290;0;7818;VERDADERO;VERDADERO;-35;;;
51281;51290;0;7819;VERDADERO;VERDADERO;-9;;;
51281;51290;0;7820;VERDADERO;VERDADERO;-9;;;
51281;51310;0;7821;VERDADERO;VERDADERO;-29;;;
51281;51310;0;7822;VERDADERO;VERDADERO;-29;;;
51281;51310;0;7823;VERDADERO;VERDADERO;-29;;;
51313;51330;0;7824;VERDADERO;VERDADERO;-17;;;
51313;51330;0;7825;VERDADERO;VERDADERO;-17;;;
51313;51330;0;7826;VERDADERO;VERDADERO;-17;;;
51313;51330;0;7827;VERDADERO;VERDADERO;-17;;;
51313;51350;1;7828;VERDADERO;VERDADERO;-37;;;
51345;51350;0;7829;VERDADERO;VERDADERO;-5;;;
51345;51350;0;7830;VERDADERO;VERDADERO;-5;;;
51345;51370;0;7831;VERDADERO;VERDADERO;-25;;;
51345;51370;0;7832;VERDADERO;VERDADERO;-25;;;
51345;51390;0;7833;VERDADERO;VERDADERO;-45;;;
51345;51390;0;7834;VERDADERO;VERDADERO;-45;;;
51382;51390;0;7835;VERDADERO;VERDADERO;-8;;;
51382;51390;0;7836;VERDADERO;VERDADERO;-8;;;
51382;51390;0;7837;VERDADERO;VERDADERO;-8;;;
51382;51390;0;7838;VERDADERO;VERDADERO;-8;;;
51382;51390;0;7839;VERDADERO;VERDADERO;-8;;;
51409;51390;0;7840;VERDADERO;VERDADERO;19;;;
51409;51390;0;7841;VERDADERO;VERDADERO;19;;;
51409;51390;0;7842;VERDADERO;VERDADERO;19;;;
51409;51390;0;7843;VERDADERO;VERDADERO;19;;;
51409;51390;0;7844;VERDADERO;VERDADERO;19;;;
51441;51390;0;7845;FALSO;VERDADERO;51;;;
51441;51390;0;7846;FALSO;VERDADERO;51;;;
51441;51390;0;7847;FALSO;VERDADERO;51;;;
51441;51390;0;7848;FALSO;VERDADERO;51;;;
51441;51390;0;7849;FALSO;VERDADERO;51;;;
51473;51390;0;7850;FALSO;VERDADERO;83;;;
51473;51390;0;7851;FALSO;VERDADERO;83;;;
51473;51410;0;7852;FALSO;VERDADERO;63;;;
51473;51410;0;7853;FALSO;VERDADERO;63;;;
51473;51430;0;7854;VERDADERO;VERDADERO;43;;;
51473;51430;0;7855;VERDADERO;VERDADERO;43;;;
51505;51430;0;7856;FALSO;VERDADERO;75;;;
51505;51450;0;7857;FALSO;VERDADERO;55;;;
51505;51450;0;7858;FALSO;VERDADERO;55;;;
51505;51470;0;7859;VERDADERO;VERDADERO;35;;;
51505;51470;0;7860;VERDADERO;VERDADERO;35;;;
51541;51490;0;7861;FALSO;VERDADERO;51;;;
51541;51490;0;7862;FALSO;VERDADERO;51;;;
51541;51490;0;7863;FALSO;VERDADERO;51;;;
51541;51510;1;7864;VERDADERO;VERDADERO;31;;;
51541;51510;0;7865;VERDADERO;VERDADERO;31;;;
51574;51530;0;7866;VERDADERO;VERDADERO;44;;;
51574;51530;0;7867;VERDADERO;VERDADERO;44;;;
51574;51530;0;7868;VERDADERO;VERDADERO;44;;;
51574;51550;0;7869;VERDADERO;VERDADERO;24;;;
51574;51550;0;7870;VERDADERO;VERDADERO;24;;;
51605;51570;0;7871;VERDADERO;VERDADERO;35;;;
51605;51570;0;7872;VERDADERO;VERDADERO;35;;;
51605;51570;0;7873;VERDADERO;VERDADERO;35;;;
51605;51590;0;7874;VERDADERO;VERDADERO;15;;;
51605;51590;0;7875;VERDADERO;VERDADERO;15;;;
51605;51610;0;7876;VERDADERO;VERDADERO;-5;;;
51640;51610;0;7877;VERDADERO;VERDADERO;30;;;
51640;51630;0;7878;VERDADERO;VERDADERO;10;;;
51640;51630;0;7879;VERDADERO;VERDADERO;10;;;
51640;51630;0;7880;VERDADERO;VERDADERO;10;;;
51673;51650;0;7881;VERDADERO;VERDADERO;23;;;
51673;51650;0;7882;VERDADERO;VERDADERO;23;;;
51673;51670;0;7883;VERDADERO;VERDADERO;3;;;
51673;51670;0;7884;VERDADERO;VERDADERO;3;;;
51673;51670;0;7885;VERDADERO;VERDADERO;3;;;
51673;51690;0;7886;VERDADERO;VERDADERO;-17;;;
51709;51690;0;7887;VERDADERO;VERDADERO;19;;;
51709;51710;0;7888;VERDADERO;VERDADERO;-1;;;
51709;51710;0;7889;VERDADERO;VERDADERO;-1;;;
51709;51710;0;7890;VERDADERO;VERDADERO;-1;;;
51709;51730;0;7891;VERDADERO;VERDADERO;-21;;;
51740;51730;0;7892;VERDADERO;VERDADERO;10;;;
51740;51750;0;7893;VERDADERO;VERDADERO;-10;;;
51740;51750;0;7894;VERDADERO;VERDADERO;-10;;;
51740;51750;0;7895;VERDADERO;VERDADERO;-10;;;
51740;51770;1;7896;VERDADERO;VERDADERO;-30;;;
51740;51770;0;7897;VERDADERO;VERDADERO;-30;;;
51778;51790;1;7898;VERDADERO;VERDADERO;-12;;;
51778;51790;0;7899;VERDADERO;VERDADERO;-12;;;
51778;51790;0;7900;VERDADERO;VERDADERO;-12;;;
51778;51810;0;7901;VERDADERO;VERDADERO;-32;;;
51778;51810;0;7902;VERDADERO;VERDADERO;-32;;;
51809;51810;0;7903;VERDADERO;VERDADERO;-1;;;
51809;51810;0;7904;VERDADERO;VERDADERO;-1;;;
51809;51810;0;7905;VERDADERO;VERDADERO;-1;;;
51809;51810;0;7906;VERDADERO;VERDADERO;-1;;;
51809;51830;0;7907;VERDADERO;VERDADERO;-21;;;
51841;51830;0;7908;VERDADERO;VERDADERO;11;;;
51841;51850;0;7909;VERDADERO;VERDADERO;-9;;;
51841;51850;0;7910;VERDADERO;VERDADERO;-9;;;
51841;51850;0;7911;VERDADERO;VERDADERO;-9;;;
51841;51870;0;7912;VERDADERO;VERDADERO;-29;;;
51877;51870;0;7913;VERDADERO;VERDADERO;7;;;
51877;51870;0;7914;VERDADERO;VERDADERO;7;;;
51877;51890;0;7915;VERDADERO;VERDADERO;-13;;;
51877;51890;0;7916;VERDADERO;VERDADERO;-13;;;
51877;51910;0,00E+00;7917;VERDADERO;VERDADERO;-33;;;
51877;51910;0;7918;VERDADERO;VERDADERO;-33;;;
51913;51910;0;7919;VERDADERO;VERDADERO;3;;;
51913;51930;0;7920;VERDADERO;VERDADERO;-17;;;
51913;51930;0;7921;VERDADERO;VERDADERO;-17;;;
51913;51930;0;7922;VERDADERO;VERDADERO;-17;;;
51913;51950;0;7923;VERDADERO;VERDADERO;-37;;;
51945;51950;0;7924;VERDADERO;VERDADERO;-5;;;
51945;51950;0;7925;VERDADERO;VERDADERO;-5;;;
51945;51970;1;7926;VERDADERO;VERDADERO;-25;;;
51945;51970;0;7927;VERDADERO;VERDADERO;-25;;;
51945;51990;0;7928;VERDADERO;VERDADERO;-45;;;
51977;51990;0;7929;VERDADERO;VERDADERO;-13;;;
51977;51990;0;7930;VERDADERO;VERDADERO;-13;;;
51977;51990;0;7931;VERDADERO;VERDADERO;-13;;;
51977;52010;0;7932;VERDADERO;VERDADERO;-33;;;
51977;52010;0;7933;VERDADERO;VERDADERO;-33;;;
51977;52030;0;7934;VERDADERO;FALSO;-53;;;
52012;52030;0;7935;VERDADERO;VERDADERO;-18;;;
52012;52030;0;7936;VERDADERO;VERDADERO;-18;;;
52012;52050;0;7937;VERDADERO;VERDADERO;-38;;;
52012;52050;0;7938;VERDADERO;VERDADERO;-38;;;
52012;52050;0;7939;VERDADERO;VERDADERO;-38;;;
52012;52050;0;7940;VERDADERO;VERDADERO;-38;;;
52049;52070;1;7941;VERDADERO;VERDADERO;-21;;;
52049;52070;0;7942;VERDADERO;VERDADERO;-21;;;
52049;52090;0;7943;VERDADERO;VERDADERO;-41;;;
52049;52090;0;7944;VERDADERO;VERDADERO;-41;;;
52081;52090;0;7945;VERDADERO;VERDADERO;-9;;;
52081;52090;0;7946;VERDADERO;VERDADERO;-9;;;
52081;52090;0;7947;VERDADERO;VERDADERO;-9;;;
52081;52090;0;7948;VERDADERO;VERDADERO;-9;;;
52081;52090;0;7949;VERDADERO;VERDADERO;-9;;;
52081;52090;0;7950;VERDADERO;VERDADERO;-9;;;
52117;52090;0;7951;VERDADERO;VERDADERO;27;;;
52117;52090;0;7952;VERDADERO;VERDADERO;27;;;
52117;52090;0;7953;VERDADERO;VERDADERO;27;;;
52117;52090;0;7954;VERDADERO;VERDADERO;27;;;
52117;52090;0;7955;VERDADERO;VERDADERO;27;;;
52117;52090;0;7956;VERDADERO;VERDADERO;27;;;
52148;52090;0;7957;FALSO;VERDADERO;58;;;
52148;52090;0;7958;FALSO;VERDADERO;58;;;
52148;52090;0;7959;FALSO;VERDADERO;58;;;
52148;52090;0;7960;FALSO;VERDADERO;58;;;
52177;52090;0;7961;FALSO;VERDADERO;87;;;
52177;52090;0;7962;FALSO;VERDADERO;87;;;
52177;52090;0;7963;FALSO;VERDADERO;87;;;
52177;52110;0;7964;FALSO;VERDADERO;67;;;
52177;52110;0;7965;FALSO;VERDADERO;67;;;
52177;52110;0;7966;FALSO;VERDADERO;67;;;
52213;52130;0;7967;FALSO;VERDADERO;83;;;
52213;52130;0;7968;FALSO;VERDADERO;83;;;
52213;52150;0;7969;FALSO;VERDADERO;63;;;
52213;52150;0;7970;FALSO;VERDADERO;63;;;
52213;52150;0;7971;FALSO;VERDADERO;63;;;
52245;52170;0;7972;FALSO;VERDADERO;75;;;
52245;52170;0;7973;FALSO;VERDADERO;75;;;
52245;52190;0;7974;FALSO;VERDADERO;55;;;
52245;52190;0;7975;FALSO;VERDADERO;55;;;
52245;52190;0;7976;FALSO;VERDADERO;55;;;
52245;52210;0;7977;VERDADERO;VERDADERO;35;;;
52280;52210;0;7978;FALSO;VERDADERO;70;;;
52280;52230;0;7979;FALSO;VERDADERO;50;;;
52280;52230;0;7980;FALSO;VERDADERO;50;;;
52280;52250;0;7981;VERDADERO;VERDADERO;30;;;
52312;52250;0;7982;FALSO;VERDADERO;62;;;
52312;52250;0;7983;FALSO;VERDADERO;62;;;
52312;52270;0;7984;VERDADERO;VERDADERO;42;;;
52312;52270;0;7985;VERDADERO;VERDADERO;42;;;
52312;52290;0;7986;VERDADERO;VERDADERO;22;;;
52345;52290;0;7987;FALSO;VERDADERO;55;;;
52345;52290;0;7988;FALSO;VERDADERO;55;;;
52345;52310;1;7989;VERDADERO;VERDADERO;35;;;
52345;52310;0;7990;VERDADERO;VERDADERO;35;;;
52345;52330;0;7991;VERDADERO;VERDADERO;15;;;
52345;52330;0;7992;VERDADERO;VERDADERO;15;;;
52381;52330;0;7993;FALSO;VERDADERO;51;;;
52381;52350;0;7994;VERDADERO;VERDADERO;31;;;
52381;52350;0;7995;VERDADERO;VERDADERO;31;;;
52381;52370;1;7996;VERDADERO;VERDADERO;11;;;
52381;52370;0;7997;VERDADERO;VERDADERO;11;;;
52413;52370;0;7998;VERDADERO;VERDADERO;43;;;
52413;52390;0;7999;VERDADERO;VERDADERO;23;;;
52413;52390;0;8000;VERDADERO;VERDADERO;23;;;
52413;52410;0;8001;VERDADERO;VERDADERO;3;;;
52413;52410;0;8002;VERDADERO;VERDADERO;3;;;
52445;52410;0;8003;VERDADERO;VERDADERO;35;;;
52445;52430;0;8004;VERDADERO;VERDADERO;15;;;
52445;52430;0;8005;VERDADERO;VERDADERO;15;;;
52445;52450;0;8006;VERDADERO;VERDADERO;-5;;;
52445;52450;0;8007;VERDADERO;VERDADERO;-5;;;
52445;52470;0;8008;VERDADERO;VERDADERO;-25;;;
52481;52470;0;8009;VERDADERO;VERDADERO;11;;;
52481;52470;0;8010;VERDADERO;VERDADERO;11;;;
52481;52490;0;8011;VERDADERO;VERDADERO;-9;;;
52481;52490;0;8012;VERDADERO;VERDADERO;-9;;;
52512;52490;0;8013;VERDADERO;VERDADERO;22;;;
52512;52510;0;8014;VERDADERO;VERDADERO;2;;;
52512;52510;0;8015;VERDADERO;VERDADERO;2;;;
52512;52530;0;8016;VERDADERO;VERDADERO;-18;;;
52512;52530;0;8017;VERDADERO;VERDADERO;-18;;;
52545;52530;0;8018;VERDADERO;VERDADERO;15;;;
52545;52550;0;8019;VERDADERO;VERDADERO;-5;;;
52545;52550;0;8020;VERDADERO;VERDADERO;-5;;;
52545;52550;0;8021;VERDADERO;VERDADERO;-5;;;
52545;52570;0;8022;VERDADERO;VERDADERO;-25;;;
52577;52570;0;8023;VERDADERO;VERDADERO;7;;;
52577;52590;0;8024;VERDADERO;VERDADERO;-13;;;
52577;52590;0;8025;VERDADERO;VERDADERO;-13;;;
52577;52590;0;8026;VERDADERO;VERDADERO;-13;;;
52577;52610;0;8027;VERDADERO;VERDADERO;-33;;;
52577;52610;0;8028;VERDADERO;VERDADERO;-33;;;
52608;52630;0;8029;VERDADERO;VERDADERO;-22;;;
52608;52630;0;8030;VERDADERO;VERDADERO;-22;;;
52608;52630;0;8031;VERDADERO;VERDADERO;-22;;;
52608;52650;0;8032;VERDADERO;VERDADERO;-42;;;
52608;52650;0;8033;VERDADERO;VERDADERO;-42;;;
52645;52670;0;8034;VERDADERO;VERDADERO;-25;;;
52645;52670;0;8035;VERDADERO;VERDADERO;-25;;;
52645;52670;0;8036;VERDADERO;VERDADERO;-25;;;
52645;52690;0;8037;VERDADERO;VERDADERO;-45;;;
52645;52690;0;8038;VERDADERO;VERDADERO;-45;;;
52677;52690;0;8039;VERDADERO;VERDADERO;-13;;;
52677;52710;0;8040;VERDADERO;VERDADERO;-33;;;
52677;52710;0;8041;VERDADERO;VERDADERO;-33;;;
52677;52710;0;8042;VERDADERO;VERDADERO;-33;;;
52677;52730;0;8043;VERDADERO;FALSO;-53;;;
52709;52730;0;8044;VERDADERO;VERDADERO;-21;;;
52709;52730;0;8045;VERDADERO;VERDADERO;-21;;;
52709;52730;0;8046;VERDADERO;VERDADERO;-21;;;
52709;52730;0;8047;VERDADERO;VERDADERO;-21;;;
52709;52730;0;8048;VERDADERO;VERDADERO;-21;;;
52709;52730;0;8049;VERDADERO;VERDADERO;-21;;;
52745;52750;0;8050;VERDADERO;VERDADERO;-5;;;
52745;52750;0;8051;VERDADERO;VERDADERO;-5;;;
52745;52770;1;8052;VERDADERO;VERDADERO;-25;;;
52745;52770;0;8053;VERDADERO;VERDADERO;-25;;;
52745;52770;0;8054;VERDADERO;VERDADERO;-25;;;
52777;52770;0;8055;VERDADERO;VERDADERO;7;;;
52777;52770;0;8056;VERDADERO;VERDADERO;7;;;
52777;52790;0;8057;VERDADERO;VERDADERO;-13;;;
52777;52790;0;8058;VERDADERO;VERDADERO;-13;;;
52777;52790;0;8059;VERDADERO;VERDADERO;-13;;;
52809;52810;0;8060;VERDADERO;VERDADERO;-1;;;
52809;52810;0;8061;VERDADERO;VERDADERO;-1;;;
52809;52830;0;8062;VERDADERO;VERDADERO;-21;;;
52809;52830;0;8063;VERDADERO;VERDADERO;-21;;;
52809;52830;0;8064;VERDADERO;VERDADERO;-21;;;
52809;52850;0;8065;VERDADERO;VERDADERO;-41;;;
52845;52850;0;8066;VERDADERO;VERDADERO;-5;;;
52845;52870;0;8067;VERDADERO;VERDADERO;-25;;;
52845;52870;0;8068;VERDADERO;VERDADERO;-25;;;
52845;52870;0;8069;VERDADERO;VERDADERO;-25;;;
52845;52890;0;8070;VERDADERO;VERDADERO;-45;;;
52877;52890;0;8071;VERDADERO;VERDADERO;-13;;;
52877;52890;0;8072;VERDADERO;VERDADERO;-13;;;
52877;52910;0;8073;VERDADERO;VERDADERO;-33;;;
52877;52910;0;8074;VERDADERO;VERDADERO;-33;;;
52877;52930;0;8075;VERDADERO;FALSO;-53;;;
52909;52930;0;8076;VERDADERO;VERDADERO;-21;;;
52909;52930;0;8077;VERDADERO;VERDADERO;-21;;;
52909;52930;0;8078;VERDADERO;VERDADERO;-21;;;
52909;52930;0;8079;VERDADERO;VERDADERO;-21;;;
52909;52930;0;8080;VERDADERO;VERDADERO;-21;;;
52941;52930;0;8081;VERDADERO;VERDADERO;11;;;
52941;52950;0;8082;VERDADERO;VERDADERO;-9;;;
52941;52950;0;8083;VERDADERO;VERDADERO;-9;;;
52941;52970;0;8084;VERDADERO;VERDADERO;-29;;;
52941;52970;0;8085;VERDADERO;VERDADERO;-29;;;
52973;52970;0;8086;VERDADERO;VERDADERO;3;;;
52973;52990;0;8087;VERDADERO;VERDADERO;-17;;;
52973;52990;0;8088;VERDADERO;VERDADERO;-17;;;
52973;53010;0;8089;VERDADERO;VERDADERO;-37;;;
52973;53010;0;8090;VERDADERO;VERDADERO;-37;;;
52973;53010;0;8091;VERDADERO;VERDADERO;-37;;;
53013;53030;0;8092;VERDADERO;VERDADERO;-17;;;
53013;53030;0;8093;VERDADERO;VERDADERO;-17;;;
53013;53050;0;8094;VERDADERO;VERDADERO;-37;;;
53013;53050;0;8095;VERDADERO;VERDADERO;-37;;;
53013;53050;0;8096;VERDADERO;VERDADERO;-37;;;
53040;53050;0;8097;VERDADERO;VERDADERO;-10;;;
53040;53050;0;8098;VERDADERO;VERDADERO;-10;;;
53040;53070;1;8099;VERDADERO;VERDADERO;-30;;;
53040;53070;0;8100;VERDADERO;VERDADERO;-30;;;
53040;53090;0;8101;VERDADERO;FALSO;-50;;;
53072;53090;0;8102;VERDADERO;VERDADERO;-18;;;
53072;53090;0;8103;VERDADERO;VERDADERO;-18;;;
53072;53090;0;8104;VERDADERO;VERDADERO;-18;;;
53072;53090;0;8105;VERDADERO;VERDADERO;-18;;;
53072;53110;0;8106;VERDADERO;VERDADERO;-38;;;
53109;53110;0;8107;VERDADERO;VERDADERO;-1;;;
53109;53130;0;8108;VERDADERO;VERDADERO;-21;;;
53109;53130;0;8109;VERDADERO;VERDADERO;-21;;;
53109;53130;0;8110;VERDADERO;VERDADERO;-21;;;
53109;53150;0;8111;VERDADERO;VERDADERO;-41;;;
53109;53150;0;8112;VERDADERO;VERDADERO;-41;;;
53144;53150;0;8113;VERDADERO;VERDADERO;-6;;;
53144;53170;1;8114;VERDADERO;VERDADERO;-26;;;
53144;53170;0;8115;VERDADERO;VERDADERO;-26;;;
53144;53170;0;8116;VERDADERO;VERDADERO;-26;;;
53144;53190;0;8117;VERDADERO;VERDADERO;-46;;;
53177;53190;0;8118;VERDADERO;VERDADERO;-13;;;
53177;53190;0;8119;VERDADERO;VERDADERO;-13;;;
53177;53190;0;8120;VERDADERO;VERDADERO;-13;;;
53177;53210;1;8121;VERDADERO;VERDADERO;-33;;;
53177;53210;0;8122;VERDADERO;VERDADERO;-33;;;
53209;53210;0;8123;VERDADERO;VERDADERO;-1;;;
53209;53231;0;8124;VERDADERO;VERDADERO;-22;;;
53209;53231;0;8125;VERDADERO;VERDADERO;-22;;;
53209;53251;1;8126;VERDADERO;VERDADERO;-42;;;
53209;53251;0;8127;VERDADERO;VERDADERO;-42;;;
53245;53251;0;8128;VERDADERO;VERDADERO;-6;;;
53245;53251;0;8129;VERDADERO;VERDADERO;-6;;;
53245;53271;0;8130;VERDADERO;VERDADERO;-26;;;
53245;53271;0;8131;VERDADERO;VERDADERO;-26;;;
53245;53271;0;8132;VERDADERO;VERDADERO;-26;;;
53245;53291;0;8133;VERDADERO;VERDADERO;-46;;;
53281;53291;0;8134;VERDADERO;VERDADERO;-10;;;
53281;53291;0;8135;VERDADERO;VERDADERO;-10;;;
53281;53291;0;8136;VERDADERO;VERDADERO;-10;;;
53281;53311;0;8137;VERDADERO;VERDADERO;-30;;;
53281;53311;0;8138;VERDADERO;VERDADERO;-30;;;
53312;53311;0;8139;VERDADERO;VERDADERO;1;;;
53312;53331;0;8140;VERDADERO;VERDADERO;-19;;;
53312;53331;0;8141;VERDADERO;VERDADERO;-19;;;
53312;53351;1;8142;VERDADERO;VERDADERO;-39;;;
53312;53351;0;8143;VERDADERO;VERDADERO;-39;;;
53345;53351;0;8144;VERDADERO;VERDADERO;-6;;;
53345;53351;0;8145;VERDADERO;VERDADERO;-6;;;
53345;53371;0;8146;VERDADERO;VERDADERO;-26;;;
53345;53371;0;8147;VERDADERO;VERDADERO;-26;;;
53345;53391;0;8148;VERDADERO;VERDADERO;-46;;;
53381;53391;0;8149;VERDADERO;VERDADERO;-10;;;
53381;53391;0;8150;VERDADERO;VERDADERO;-10;;;
53381;53391;0;8151;VERDADERO;VERDADERO;-10;;;
53381;53391;0;8152;VERDADERO;VERDADERO;-10;;;
53381;53411;0;8153;VERDADERO;VERDADERO;-30;;;
53381;53411;0;8154;VERDADERO;VERDADERO;-30;;;
53413;53411;0;8155;VERDADERO;VERDADERO;2;;;
53413;53431;0;8156;VERDADERO;VERDADERO;-18;;;
53413;53431;0;8157;VERDADERO;VERDADERO;-18;;;
53413;53451;0;8158;VERDADERO;VERDADERO;-38;;;
53413;53451;0;8159;VERDADERO;VERDADERO;-38;;;
53445;53451;0;8160;VERDADERO;VERDADERO;-6;;;
53445;53451;0;8161;VERDADERO;VERDADERO;-6;;;
53445;53471;0;8162;VERDADERO;VERDADERO;-26;;;
53445;53471;0;8163;VERDADERO;VERDADERO;-26;;;
53445;53491;0;8164;VERDADERO;VERDADERO;-46;;;
53480;53491;0;8165;VERDADERO;VERDADERO;-11;;;
53480;53491;0;8166;VERDADERO;VERDADERO;-11;;;
53480;53491;0;8167;VERDADERO;VERDADERO;-11;;;
53480;53511;0;8168;VERDADERO;VERDADERO;-31;;;
53480;53511;0;8169;VERDADERO;VERDADERO;-31;;;
53480;53511;0;8170;VERDADERO;VERDADERO;-31;;;
53513;53532;1;8171;VERDADERO;VERDADERO;-19;;;
53513;53532;0;8172;VERDADERO;VERDADERO;-19;;;
53513;53552;1;8173;VERDADERO;VERDADERO;-39;;;
53513;53552;0;8174;VERDADERO;VERDADERO;-39;;;
53513;53552;0;8175;VERDADERO;VERDADERO;-39;;;
53545;53572;0;8176;VERDADERO;VERDADERO;-27;;;
53545;53572;0;8177;VERDADERO;VERDADERO;-27;;;
53545;53592;0;8178;VERDADERO;VERDADERO;-47;;;
53545;53592;0;8179;VERDADERO;VERDADERO;-47;;;
53545;53592;0;8180;VERDADERO;VERDADERO;-47;;;
53577;53592;0;8181;VERDADERO;VERDADERO;-15;;;
53577;53612;0;8182;VERDADERO;VERDADERO;-35;;;
53577;53612;0;8183;VERDADERO;VERDADERO;-35;;;
53577;53612;0;8184;VERDADERO;VERDADERO;-35;;;
53577;53632;0;8185;VERDADERO;FALSO;-55;;;
53609;53632;0;8186;VERDADERO;VERDADERO;-23;;;
53609;53632;0;8187;VERDADERO;VERDADERO;-23;;;
53609;53632;0;8188;VERDADERO;VERDADERO;-23;;;
53609;53632;0;8189;VERDADERO;VERDADERO;-23;;;
53609;53652;0;8190;VERDADERO;VERDADERO;-43;;;
53640;53652;0;8191;VERDADERO;VERDADERO;-12;;;
53640;53672;0;8192;VERDADERO;VERDADERO;-32;;;
53640;53672;0;8193;VERDADERO;VERDADERO;-32;;;
53640;53672;0;8194;VERDADERO;VERDADERO;-32;;;
53640;53672;0;8195;VERDADERO;VERDADERO;-32;;;
53673;53672;0;8196;VERDADERO;VERDADERO;1;;;
53673;53672;0;8197;VERDADERO;VERDADERO;1;;;
53673;53672;0;8198;VERDADERO;VERDADERO;1;;;
53673;53692;0;8199;VERDADERO;VERDADERO;-19;;;
53673;53692;0;8200;VERDADERO;VERDADERO;-19;;;
53673;53692;0;8201;VERDADERO;VERDADERO;-19;;;
53709;53712;1;8202;VERDADERO;VERDADERO;-3;;;
53709;53712;0;8203;VERDADERO;VERDADERO;-3;;;
53709;53732;0;8204;VERDADERO;VERDADERO;-23;;;
53709;53732;0;8205;VERDADERO;VERDADERO;-23;;;
53709;53732;0;8206;VERDADERO;VERDADERO;-23;;;
53741;53732;0;8207;VERDADERO;VERDADERO;9;;;
53741;53752;0;8208;VERDADERO;VERDADERO;-11;;;
53741;53752;0;8209;VERDADERO;VERDADERO;-11;;;
53741;53772;0;8210;VERDADERO;VERDADERO;-31;;;
53741;53772;0;8211;VERDADERO;VERDADERO;-31;;;
53773;53792;1;8212;VERDADERO;VERDADERO;-19;;;
53773;53792;0;8213;VERDADERO;VERDADERO;-19;;;
53773;53792;0;8214;VERDADERO;VERDADERO;-19;;;
53773;53812;0;8215;VERDADERO;VERDADERO;-39;;;
53773;53812;0;8216;VERDADERO;VERDADERO;-39;;;
53805;53812;0;8217;VERDADERO;VERDADERO;-7;;;
53805;53832;0;8218;VERDADERO;VERDADERO;-27;;;
53805;53832;0;8219;VERDADERO;VERDADERO;-27;;;
53805;53832;0;8220;VERDADERO;VERDADERO;-27;;;
53805;53832;0;8221;VERDADERO;VERDADERO;-27;;;
53838;53832;0;8222;VERDADERO;VERDADERO;6;;;
53838;53852;0;8223;VERDADERO;VERDADERO;-14;;;
53838;53852;0;8224;VERDADERO;VERDADERO;-14;;;
53838;53872;0;8225;VERDADERO;VERDADERO;-34;;;
53838;53872;0;8226;VERDADERO;VERDADERO;-34;;;
53838;53872;0;8227;VERDADERO;VERDADERO;-34;;;
53872;53892;1;8228;VERDADERO;VERDADERO;-20;;;
53872;53892;0;8229;VERDADERO;VERDADERO;-20;;;
53872;53892;0;8230;VERDADERO;VERDADERO;-20;;;
53872;53912;0;8231;VERDADERO;VERDADERO;-40;;;
53872;53912;0;8232;VERDADERO;VERDADERO;-40;;;
53905;53932;0;8233;VERDADERO;VERDADERO;-27;;;
53905;53932;0;8234;VERDADERO;VERDADERO;-27;;;
53905;53932;0;8235;VERDADERO;VERDADERO;-27;;;
53905;53932;0;8236;VERDADERO;VERDADERO;-27;;;
53905;53932;0;8237;VERDADERO;VERDADERO;-27;;;
53905;53952;1;8238;VERDADERO;VERDADERO;-47;;;
53940;53952;0;8239;VERDADERO;VERDADERO;-12;;;
53940;53952;0;8240;VERDADERO;VERDADERO;-12;;;
53940;53972;0;8241;VERDADERO;VERDADERO;-32;;;
53940;53972;0;8242;VERDADERO;VERDADERO;-32;;;
53940;53992;0;8243;VERDADERO;FALSO;-52;;;
53972;53992;0;8244;VERDADERO;VERDADERO;-20;;;
53972;53992;0;8245;VERDADERO;VERDADERO;-20;;;
53972;54012;0;8246;VERDADERO;VERDADERO;-40;;;
53972;54012;0;8247;VERDADERO;VERDADERO;-40;;;
53972;54032;0;8248;VERDADERO;FALSO;-60;;;
54008;54032;0;8249;VERDADERO;VERDADERO;-24;;;
54008;54032;0;8250;VERDADERO;VERDADERO;-24;;;
54008;54032;0;8251;VERDADERO;VERDADERO;-24;;;
54008;54032;0;8252;VERDADERO;VERDADERO;-24;;;
54008;54032;0;8253;VERDADERO;VERDADERO;-24;;;
54008;54052;0;8254;VERDADERO;VERDADERO;-44;;;
54041;54052;0;8255;VERDADERO;VERDADERO;-11;;;
54041;54072;0;8256;VERDADERO;VERDADERO;-31;;;
54041;54072;0;8257;VERDADERO;VERDADERO;-31;;;
54041;54072;0;8258;VERDADERO;VERDADERO;-31;;;
54041;54092;0;8259;VERDADERO;FALSO;-51;;;
54077;54092;0;8260;VERDADERO;VERDADERO;-15;;;
54077;54112;0;8261;VERDADERO;VERDADERO;-35;;;
54077;54112;0;8262;VERDADERO;VERDADERO;-35;;;
54077;54112;0;8263;VERDADERO;VERDADERO;-35;;;
54077;54132;0;8264;VERDADERO;FALSO;-55;;;
54077;54132;0;8265;VERDADERO;FALSO;-55;;;
54112;54132;0;8266;VERDADERO;VERDADERO;-20;;;
54112;54132;0;8267;VERDADERO;VERDADERO;-20;;;
54112;54152;0;8268;VERDADERO;VERDADERO;-40;;;
54112;54152;0;8269;VERDADERO;VERDADERO;-40;;;
54112;54172;0;8270;VERDADERO;FALSO;-60;;;
54144;54172;0;8271;VERDADERO;VERDADERO;-28;;;
54144;54172;0;8272;VERDADERO;VERDADERO;-28;;;
54144;54172;0;8273;VERDADERO;VERDADERO;-28;;;
54144;54172;0;8274;VERDADERO;VERDADERO;-28;;;
54144;54172;0;8275;VERDADERO;VERDADERO;-28;;;
54177;54192;1;8276;VERDADERO;VERDADERO;-15;;;
54177;54192;0;8277;VERDADERO;VERDADERO;-15;;;
54177;54212;0;8278;VERDADERO;VERDADERO;-35;;;
54177;54212;0;8279;VERDADERO;VERDADERO;-35;;;
54177;54212;0;8280;VERDADERO;VERDADERO;-35;;;
54209;54212;0;8281;VERDADERO;VERDADERO;-3;;;
54209;54212;0;8282;VERDADERO;VERDADERO;-3;;;
54209;54232;0;8283;VERDADERO;VERDADERO;-23;;;
54209;54232;0;8284;VERDADERO;VERDADERO;-23;;;
54209;54232;0;8285;VERDADERO;VERDADERO;-23;;;
54241;54253;0;8286;VERDADERO;VERDADERO;-12;;;
54241;54253;0;8287;VERDADERO;VERDADERO;-12;;;
54241;54273;0;8288;VERDADERO;VERDADERO;-32;;;
54241;54273;0;8289;VERDADERO;VERDADERO;-32;;;
54241;54273;0;8290;VERDADERO;VERDADERO;-32;;;
54241;54273;0;8291;VERDADERO;VERDADERO;-32;;;
54276;54293;1;8292;VERDADERO;VERDADERO;-17;;;
54276;54293;0;8293;VERDADERO;VERDADERO;-17;;;
54276;54293;0;8294;VERDADERO;VERDADERO;-17;;;
54276;54313;1;8295;VERDADERO;VERDADERO;-37;;;
54276;54313;0;8296;VERDADERO;VERDADERO;-37;;;
54309;54313;0;8297;VERDADERO;VERDADERO;-4;;;
54309;54313;0;8298;VERDADERO;VERDADERO;-4;;;
54309;54333;0;8299;VERDADERO;VERDADERO;-24;;;
54309;54333;0;8300;VERDADERO;VERDADERO;-24;;;
54309;54333;0;8301;VERDADERO;VERDADERO;-24;;;
54341;54353;0;8302;VERDADERO;VERDADERO;-12;;;
54341;54353;0;8303;VERDADERO;VERDADERO;-12;;;
54341;54373;1;8304;VERDADERO;VERDADERO;-32;;;
54341;54373;0;8305;VERDADERO;VERDADERO;-32;;;
54341;54373;0;8306;VERDADERO;VERDADERO;-32;;;
54372;54373;0;8307;VERDADERO;VERDADERO;-1;;;
54372;54393;0;8308;VERDADERO;VERDADERO;-21;;;
54372;54393;0;8309;VERDADERO;VERDADERO;-21;;;
54372;54413;0;8310;VERDADERO;VERDADERO;-41;;;
54372;54413;0;8311;VERDADERO;VERDADERO;-41;;;
54404;54413;0;8312;VERDADERO;VERDADERO;-9;;;
54404;54413;0;8313;VERDADERO;VERDADERO;-9;;;
54404;54413;0;8314;VERDADERO;VERDADERO;-9;;;
54404;54433;0;8315;VERDADERO;VERDADERO;-29;;;
54404;54433;0;8316;VERDADERO;VERDADERO;-29;;;
54404;54433;0;8317;VERDADERO;VERDADERO;-29;;;
54440;54453;1;8318;VERDADERO;VERDADERO;-13;;;
54440;54453;0;8319;VERDADERO;VERDADERO;-13;;;
54440;54453;0;8320;VERDADERO;VERDADERO;-13;;;
54440;54473;0;8321;VERDADERO;VERDADERO;-33;;;
54440;54473;0;8322;VERDADERO;VERDADERO;-33;;;
54473;54493;0;8323;VERDADERO;VERDADERO;-20;;;
54473;54493;0;8324;VERDADERO;VERDADERO;-20;;;
54473;54493;0;8325;VERDADERO;VERDADERO;-20;;;
54473;54513;1;8326;VERDADERO;VERDADERO;-40;;;
54473;54513;0;8327;VERDADERO;VERDADERO;-40;;;
54505;54533;1;8328;VERDADERO;VERDADERO;-28;;;
54505;54533;0;8329;VERDADERO;VERDADERO;-28;;;
54505;54533;0;8330;VERDADERO;VERDADERO;-28;;;
54505;54553;0;8331;VERDADERO;VERDADERO;-48;;;
54505;54553;0;8332;VERDADERO;VERDADERO;-48;;;
54505;54573;1;8333;VERDADERO;FALSO;-68;;;
54547;54573;0;8334;VERDADERO;VERDADERO;-26;;;
54547;54573;0;8335;VERDADERO;VERDADERO;-26;;;
54547;54573;0;8336;VERDADERO;VERDADERO;-26;;;
54547;54593;0;8337;VERDADERO;VERDADERO;-46;;;
54573;54593;0;8338;VERDADERO;VERDADERO;-20;;;
54573;54593;0;8339;VERDADERO;VERDADERO;-20;;;
54573;54613;0;8340;VERDADERO;VERDADERO;-40;;;
54573;54613;0;8341;VERDADERO;VERDADERO;-40;;;
54573;54613;0;8342;VERDADERO;VERDADERO;-40;;;
54605;54613;0;8343;VERDADERO;VERDADERO;-8;;;
54605;54613;0;8344;VERDADERO;VERDADERO;-8;;;
54605;54633;0;8345;VERDADERO;VERDADERO;-28;;;
54605;54633;0;8346;VERDADERO;VERDADERO;-28;;;
54605;54653;0;8347;VERDADERO;VERDADERO;-48;;;
54637;54653;0;8348;VERDADERO;VERDADERO;-16;;;
54637;54653;0;8349;VERDADERO;VERDADERO;-16;;;
54637;54653;0;8350;VERDADERO;VERDADERO;-16;;;
54637;54653;0;8351;VERDADERO;VERDADERO;-16;;;
54637;54673;0;8352;VERDADERO;VERDADERO;-36;;;
54637;54673;0;8353;VERDADERO;VERDADERO;-36;;;
54673;54673;0;8354;VERDADERO;VERDADERO;0;;;
54673;54693;0;8355;VERDADERO;VERDADERO;-20;;;
54673;54693;0;8356;VERDADERO;VERDADERO;-20;;;
54673;54713;1;8357;VERDADERO;VERDADERO;-40;;;
54673;54713;0;8358;VERDADERO;VERDADERO;-40;;;
54708;54713;0;8359;VERDADERO;VERDADERO;-5;;;
54708;54733;0;8360;VERDADERO;VERDADERO;-25;;;
54708;54733;0;8361;VERDADERO;VERDADERO;-25;;;
54708;54753;0;8362;VERDADERO;VERDADERO;-45;;;
54708;54753;0;8363;VERDADERO;VERDADERO;-45;;;
54708;54753;0;8364;VERDADERO;VERDADERO;-45;;;
54741;54753;0;8365;VERDADERO;VERDADERO;-12;;;
54741;54753;0;8366;VERDADERO;VERDADERO;-12;;;
54741;54773;0;8367;VERDADERO;VERDADERO;-32;;;
54741;54773;0;8368;VERDADERO;VERDADERO;-32;;;
54741;54793;0;8369;VERDADERO;FALSO;-52;;;
54773;54793;0;8370;VERDADERO;VERDADERO;-20;;;
54773;54793;0;8371;VERDADERO;VERDADERO;-20;;;
54773;54793;0;8372;VERDADERO;VERDADERO;-20;;;
54773;54793;0;8373;VERDADERO;VERDADERO;-20;;;
54773;54793;0;8374;VERDADERO;VERDADERO;-20;;;
54773;54813;0;8375;VERDADERO;VERDADERO;-40;;;
54809;54813;0;8376;VERDADERO;VERDADERO;-4;;;
54809;54834;0;8377;VERDADERO;VERDADERO;-25;;;
54809;54834;0;8378;VERDADERO;VERDADERO;-25;;;
54809;54834;0;8379;VERDADERO;VERDADERO;-25;;;
54809;54854;0;8380;VERDADERO;VERDADERO;-45;;;
54842;54854;0;8381;VERDADERO;VERDADERO;-12;;;
54842;54854;0;8382;VERDADERO;VERDADERO;-12;;;
54842;54874;0;8383;VERDADERO;VERDADERO;-32;;;
54842;54874;0;8384;VERDADERO;VERDADERO;-32;;;
54842;54894;0;8385;VERDADERO;FALSO;-52;;;
54876;54894;0;8386;VERDADERO;VERDADERO;-18;;;
54876;54894;0;8387;VERDADERO;VERDADERO;-18;;;
54876;54894;0;8388;VERDADERO;VERDADERO;-18;;;
54876;54894;0;8389;VERDADERO;VERDADERO;-18;;;
54876;54894;0;8390;VERDADERO;VERDADERO;-18;;;
54909;54914;1;8391;VERDADERO;VERDADERO;-5;;;
54909;54914;0;8392;VERDADERO;VERDADERO;-5;;;
54909;54934;0;8393;VERDADERO;VERDADERO;-25;;;
54909;54934;0;8394;VERDADERO;VERDADERO;-25;;;
54909;54934;0;8395;VERDADERO;VERDADERO;-25;;;
54940;54954;1;8396;VERDADERO;VERDADERO;-14;;;
54940;54954;0;8397;VERDADERO;VERDADERO;-14;;;
54940;54974;0;8398;VERDADERO;VERDADERO;-34;;;
54940;54974;0;8399;VERDADERO;VERDADERO;-34;;;
54940;54994;0;8400;VERDADERO;FALSO;-54;;;
54940;54994;0;8401;VERDADERO;FALSO;-54;;;
54981;54994;0;8402;VERDADERO;VERDADERO;-13;;;
54981;54994;0;8403;VERDADERO;VERDADERO;-13;;;
54981;54994;0;8404;VERDADERO;VERDADERO;-13;;;
54981;54994;0;8405;VERDADERO;VERDADERO;-13;;;
55006;55014;1;8406;VERDADERO;VERDADERO;-8;;;
55006;55014;0;8407;VERDADERO;VERDADERO;-8;;;
55006;55034;0;8408;VERDADERO;VERDADERO;-28;;;
55006;55034;0;8409;VERDADERO;VERDADERO;-28;;;
55006;55054;0;8410;VERDADERO;VERDADERO;-48;;;
55006;55054;0;8411;VERDADERO;VERDADERO;-48;;;
55040;55054;0;8412;VERDADERO;VERDADERO;-14;;;
55040;55074;0;8413;VERDADERO;VERDADERO;-34;;;
55040;55074;0;8414;VERDADERO;VERDADERO;-34;;;
55040;55094;0;8415;VERDADERO;FALSO;-54;;;
55073;55094;0;8416;VERDADERO;VERDADERO;-21;;;
55073;55094;0;8417;VERDADERO;VERDADERO;-21;;;
55073;55094;0;8418;VERDADERO;VERDADERO;-21;;;
55073;55094;0;8419;VERDADERO;VERDADERO;-21;;;
55073;55114;0;8420;VERDADERO;VERDADERO;-41;;;
55073;55114;0;8421;VERDADERO;VERDADERO;-41;;;
55073;55134;1;8422;VERDADERO;FALSO;-61;;;
55111;55134;0;8423;VERDADERO;VERDADERO;-23;;;
55111;55134;0;8424;VERDADERO;VERDADERO;-23;;;
55111;55134;0;8425;VERDADERO;VERDADERO;-23;;;
55111;55134;0;8426;VERDADERO;VERDADERO;-23;;;
55137;55154;0;8427;VERDADERO;VERDADERO;-17;;;
55137;55154;0;8428;VERDADERO;VERDADERO;-17;;;
55137;55174;1;8429;VERDADERO;VERDADERO;-37;;;
55137;55174;0;8430;VERDADERO;VERDADERO;-37;;;
55137;55174;0;8431;VERDADERO;VERDADERO;-37;;;
55169;55174;0;8432;VERDADERO;VERDADERO;-5;;;
55169;55194;0;8433;VERDADERO;VERDADERO;-25;;;
55169;55194;0;8434;VERDADERO;VERDADERO;-25;;;
55169;55194;0;8435;VERDADERO;VERDADERO;-25;;;
55169;55214;0;8436;VERDADERO;VERDADERO;-45;;;
55201;55214;0;8437;VERDADERO;VERDADERO;-13;;;
55201;55234;0;8438;VERDADERO;VERDADERO;-33;;;
55201;55234;0;8439;VERDADERO;VERDADERO;-33;;;
55201;55234;0;8440;VERDADERO;VERDADERO;-33;;;
55201;55254;0;8441;VERDADERO;FALSO;-53;;;
55233;55254;0;8442;VERDADERO;VERDADERO;-21;;;
55233;55274;0;8443;VERDADERO;VERDADERO;-41;;;
55233;55274;0;8444;VERDADERO;VERDADERO;-41;;;
55233;55274;0;8445;VERDADERO;VERDADERO;-41;;;
55233;55274;0;8446;VERDADERO;VERDADERO;-41;;;
55233;55274;0;8447;VERDADERO;VERDADERO;-41;;;
55268;55274;0;8448;VERDADERO;VERDADERO;-6;;;
55268;55294;0;8449;VERDADERO;VERDADERO;-26;;;
55268;55294;0;8450;VERDADERO;VERDADERO;-26;;;
55268;55314;0;8451;VERDADERO;VERDADERO;-46;;;
55268;55314;0;8452;VERDADERO;VERDADERO;-46;;;
55301;55314;0;8453;VERDADERO;VERDADERO;-13;;;
55301;55314;0;8454;VERDADERO;VERDADERO;-13;;;
55301;55314;0;8455;VERDADERO;VERDADERO;-13;;;
55301;55334;0;8456;VERDADERO;VERDADERO;-33;;;
55301;55334;0;8457;VERDADERO;VERDADERO;-33;;;
55334;55355;0;8458;VERDADERO;VERDADERO;-21;;;
55334;55355;0;8459;VERDADERO;VERDADERO;-21;;;
55334;55355;0;8460;VERDADERO;VERDADERO;-21;;;
55334;55375;1;8461;VERDADERO;VERDADERO;-41;;;
55334;55375;0;8462;VERDADERO;VERDADERO;-41;;;
55334;55375;0;8463;VERDADERO;VERDADERO;-41;;;
55369;55395;0;8464;VERDADERO;VERDADERO;-26;;;
55369;55395;0;8465;VERDADERO;VERDADERO;-26;;;
55369;55395;0;8466;VERDADERO;VERDADERO;-26;;;
55369;55415;0;8467;VERDADERO;VERDADERO;-46;;;
55369;55415;0;8468;VERDADERO;VERDADERO;-46;;;
55401;55415;0;8469;VERDADERO;VERDADERO;-14;;;
55401;55415;0;8470;VERDADERO;VERDADERO;-14;;;
55401;55415;0;8471;VERDADERO;VERDADERO;-14;;;
55401;55435;0;8472;VERDADERO;VERDADERO;-34;;;
55401;55435;0;8473;VERDADERO;VERDADERO;-34;;;
55436;55455;1;8474;VERDADERO;VERDADERO;-19;;;
55436;55455;0;8475;VERDADERO;VERDADERO;-19;;;
55436;55455;0;8476;VERDADERO;VERDADERO;-19;;;
55436;55475;1;8477;VERDADERO;VERDADERO;-39;;;
55436;55475;0;8478;VERDADERO;VERDADERO;-39;;;
55469;55475;0;8479;VERDADERO;VERDADERO;-6;;;
55469;55475;0;8480;VERDADERO;VERDADERO;-6;;;
55469;55495;0;8481;VERDADERO;VERDADERO;-26;;;
55469;55495;0;8482;VERDADERO;VERDADERO;-26;;;
55469;55515;0;8483;VERDADERO;VERDADERO;-46;;;
55469;55515;0;8484;VERDADERO;VERDADERO;-46;;;
55504;55515;0;8485;VERDADERO;VERDADERO;-11;;;
55504;55515;0;8486;VERDADERO;VERDADERO;-11;;;
55504;55515;0;8487;VERDADERO;VERDADERO;-11;;;
55504;55515;0;8488;VERDADERO;VERDADERO;-11;;;
55504;55515;0;8489;VERDADERO;VERDADERO;-11;;;
55504;55535;0;8490;VERDADERO;VERDADERO;-31;;;
55542;55535;0;8491;VERDADERO;VERDADERO;7;;;
55542;55535;0;8492;VERDADERO;VERDADERO;7;;;
55542;55555;0;8493;VERDADERO;VERDADERO;-13;;;
55542;55555;0;8494;VERDADERO;VERDADERO;-13;;;
55569;55575;0;8495;VERDADERO;VERDADERO;-6;;;
55569;55575;0;8496;VERDADERO;VERDADERO;-6;;;
55569;55575;0;8497;VERDADERO;VERDADERO;-6;;;
55569;55595;0;8498;VERDADERO;VERDADERO;-26;;;
55569;55595;0;8499;VERDADERO;VERDADERO;-26;;;
55569;55615;0;8500;VERDADERO;VERDADERO;-46;;;
55605;55615;0;8501;VERDADERO;VERDADERO;-10;;;
55605;55615;0;8502;VERDADERO;VERDADERO;-10;;;
55605;55635;0;8503;VERDADERO;VERDADERO;-30;;;
55605;55635;0;8504;VERDADERO;VERDADERO;-30;;;
55605;55635;0;8505;VERDADERO;VERDADERO;-30;;;
55637;55655;1;8506;VERDADERO;VERDADERO;-18;;;
55637;55655;0;8507;VERDADERO;VERDADERO;-18;;;
55637;55655;0;8508;VERDADERO;VERDADERO;-18;;;
55637;55675;0;8509;VERDADERO;VERDADERO;-38;;;
55637;55675;0;8510;VERDADERO;VERDADERO;-38;;;
55673;55675;0;8511;VERDADERO;VERDADERO;-2;;;
55673;55675;0;8512;VERDADERO;VERDADERO;-2;;;
55673;55695;0;8513;VERDADERO;VERDADERO;-22;;;
55673;55695;0;8514;VERDADERO;VERDADERO;-22;;;
55673;55695;0;8515;VERDADERO;VERDADERO;-22;;;
55673;55715;1;8516;VERDADERO;VERDADERO;-42;;;
55705;55715;0;8517;VERDADERO;VERDADERO;-10;;;
55705;55735;0;8518;VERDADERO;VERDADERO;-30;;;
55705;55735;0;8519;VERDADERO;VERDADERO;-30;;;
55705;55735;0;8520;VERDADERO;VERDADERO;-30;;;
55705;55735;0;8521;VERDADERO;VERDADERO;-30;;;
55740;55735;0;8522;VERDADERO;VERDADERO;5;;;
55740;55755;0;8523;VERDADERO;VERDADERO;-15;;;
55740;55755;0;8524;VERDADERO;VERDADERO;-15;;;
55740;55775;0;8525;VERDADERO;VERDADERO;-35;;;
55740;55775;0;8526;VERDADERO;VERDADERO;-35;;;
55773;55795;0;8527;VERDADERO;VERDADERO;-22;;;
55773;55795;0;8528;VERDADERO;VERDADERO;-22;;;
55773;55795;0;8529;VERDADERO;VERDADERO;-22;;;
55773;55815;0;8530;VERDADERO;VERDADERO;-42;;;
55773;55815;0;8531;VERDADERO;VERDADERO;-42;;;
55804;55835;1;8532;VERDADERO;VERDADERO;-31;;;
55804;55835;0;8533;VERDADERO;VERDADERO;-31;;;
55804;55835;0;8534;VERDADERO;VERDADERO;-31;;;
55804;55835;0;8535;VERDADERO;VERDADERO;-31;;;
55804;55835;0;8536;VERDADERO;VERDADERO;-31;;;
55804;55835;0;8537;VERDADERO;VERDADERO;-31;;;
55841;55855;0;8538;VERDADERO;VERDADERO;-14;;;
55841;55855;0;8539;VERDADERO;VERDADERO;-14;;;
55841;55855;0;8540;VERDADERO;VERDADERO;-14;;;
55841;55875;0;8541;VERDADERO;VERDADERO;-34;;;
55841;55875;0;8542;VERDADERO;VERDADERO;-34;;;
55873;55895;1;8543;VERDADERO;VERDADERO;-22;;;
55873;55895;0;8544;VERDADERO;VERDADERO;-22;;;
55873;55895;0;8545;VERDADERO;VERDADERO;-22;;;
55873;55895;0;8546;VERDADERO;VERDADERO;-22;;;
55873;55895;0;8547;VERDADERO;VERDADERO;-22;;;
55905;55895;0;8548;VERDADERO;VERDADERO;10;;;
55905;55895;0;8549;VERDADERO;VERDADERO;10;;;
55905;55895;0;8550;VERDADERO;VERDADERO;10;;;
55905;55895;0;8551;VERDADERO;VERDADERO;10;;;
55905;55895;0;8552;VERDADERO;VERDADERO;10;;;
55937;55895;0;8553;VERDADERO;VERDADERO;42;;;
55937;55895;0;8554;VERDADERO;VERDADERO;42;;;
55937;55895;0;8555;VERDADERO;VERDADERO;42;;;
55937;55895;0;8556;VERDADERO;VERDADERO;42;;;
55937;55895;0;8557;VERDADERO;VERDADERO;42;;;
55969;55895;0;8558;FALSO;VERDADERO;74;;;
55969;55895;0;8559;FALSO;VERDADERO;74;;;
55969;55895;0;8560;FALSO;VERDADERO;74;;;
55969;55895;0;8561;FALSO;VERDADERO;74;;;
55969;55895;0;8562;FALSO;VERDADERO;74;;;
55969;55915;0;8563;FALSO;VERDADERO;54;;;
56005;55915;0;8564;FALSO;VERDADERO;90;;;
56005;55915;0;8565;FALSO;VERDADERO;90;;;
56005;55935;0;8566;FALSO;VERDADERO;70;;;
56005;55935;0;8567;FALSO;VERDADERO;70;;;
56005;55955;0;8568;FALSO;VERDADERO;50;;;
56037;55955;0;8569;FALSO;VERDADERO;82;;;
56037;55955;0;8570;FALSO;VERDADERO;82;;;
56037;55975;0;8571;FALSO;VERDADERO;62;;;
56037;55975;0;8572;FALSO;VERDADERO;62;;;
56037;55995;0;8573;VERDADERO;VERDADERO;42;;;
56069;55995;0;8574;FALSO;VERDADERO;74;;;
56069;55995;0;8575;FALSO;VERDADERO;74;;;
56069;56015;0;8576;FALSO;VERDADERO;54;;;
56069;56015;0;8577;FALSO;VERDADERO;54;;;
56069;56035;0;8578;VERDADERO;VERDADERO;34;;;
56102;56035;0;8579;FALSO;VERDADERO;67;;;
56102;56035;0;8580;FALSO;VERDADERO;67;;;
56102;56055;0;8581;VERDADERO;VERDADERO;47;;;
56102;56055;0;8582;VERDADERO;VERDADERO;47;;;
56102;56075;0;8583;VERDADERO;VERDADERO;27;;;
56133;56075;0;8584;FALSO;VERDADERO;58;;;
56133;56075;0;8585;FALSO;VERDADERO;58;;;
56133;56095;0;8586;VERDADERO;VERDADERO;38;;;
56133;56095;0;8587;VERDADERO;VERDADERO;38;;;
56133;56115;0;8588;VERDADERO;VERDADERO;18;;;
56133;56115;0;8589;VERDADERO;VERDADERO;18;;;
56168;56115;0;8590;FALSO;VERDADERO;53;;;
56168;56135;1;8591;VERDADERO;VERDADERO;33;;;
56168;56135;0;8592;VERDADERO;VERDADERO;33;;;
56168;56155;0;8593;VERDADERO;VERDADERO;13;;;
56168;56155;0;8594;VERDADERO;VERDADERO;13;;;
56201;56155;0;8595;VERDADERO;VERDADERO;46;;;
56201;56175;0;8596;VERDADERO;VERDADERO;26;;;
56201;56175;0;8597;VERDADERO;VERDADERO;26;;;
56201;56195;0;8598;VERDADERO;VERDADERO;6;;;
56201;56195;0;8599;VERDADERO;VERDADERO;6;;;
56201;56215;0;8600;VERDADERO;VERDADERO;-14;;;
56237;56215;0;8601;VERDADERO;VERDADERO;22;;;
56237;56215;0;8602;VERDADERO;VERDADERO;22;;;
56237;56235;0;8603;VERDADERO;VERDADERO;2;;;
56237;56235;0;8604;VERDADERO;VERDADERO;2;;;
56237;56255;1;8605;VERDADERO;VERDADERO;-18;;;
56273;56255;0;8606;VERDADERO;VERDADERO;18;;;
56273;56255;0;8607;VERDADERO;VERDADERO;18;;;
56273;56275;0;8608;VERDADERO;VERDADERO;-2;;;
56273;56275;0;8609;VERDADERO;VERDADERO;-2;;;
56273;56295;0;8610;VERDADERO;VERDADERO;-22;;;
56305;56295;0;8611;VERDADERO;VERDADERO;10;;;
56305;56295;0;8612;VERDADERO;VERDADERO;10;;;
56305;56315;0;8613;VERDADERO;VERDADERO;-10;;;
56305;56315;0;8614;VERDADERO;VERDADERO;-10;;;
56305;56335;0;8615;VERDADERO;VERDADERO;-30;;;
56337;56335;0;8616;VERDADERO;VERDADERO;2;;;
56337;56355;0;8617;VERDADERO;VERDADERO;-18;;;
56337;56355;0;8618;VERDADERO;VERDADERO;-18;;;
56337;56355;0;8619;VERDADERO;VERDADERO;-18;;;
56337;56355;0;8620;VERDADERO;VERDADERO;-18;;;
56337;56375;0;8621;VERDADERO;VERDADERO;-38;;;
56373;56375;0;8622;VERDADERO;VERDADERO;-2;;;
56373;56395;0;8623;VERDADERO;VERDADERO;-22;;;
56373;56395;0;8624;VERDADERO;VERDADERO;-22;;;
56373;56415;0;8625;VERDADERO;VERDADERO;-42;;;
56373;56415;0;8626;VERDADERO;VERDADERO;-42;;;
56409;56415;0;8627;VERDADERO;VERDADERO;-6;;;
56409;56415;0;8628;VERDADERO;VERDADERO;-6;;;
56409;56435;0;8629;VERDADERO;VERDADERO;-26;;;
56409;56435;0;8630;VERDADERO;VERDADERO;-26;;;
56409;56435;0;8631;VERDADERO;VERDADERO;-26;;;
56443;56455;0;8632;VERDADERO;VERDADERO;-12;;;
56443;56455;0;8633;VERDADERO;VERDADERO;-12;;;
56443;56475;0;8634;VERDADERO;VERDADERO;-32;;;
56443;56475;0;8635;VERDADERO;VERDADERO;-32;;;
56443;56475;0;8636;VERDADERO;VERDADERO;-32;;;
56473;56495;0;8637;VERDADERO;VERDADERO;-22;;;
56473;56495;0;8638;VERDADERO;VERDADERO;-22;;;
56473;56495;0;8639;VERDADERO;VERDADERO;-22;;;
56473;56515;1;8640;VERDADERO;VERDADERO;-42;;;
56473;56515;0;8641;VERDADERO;VERDADERO;-42;;;
56473;56515;0;8642;VERDADERO;VERDADERO;-42;;;
56509;56515;0;8643;VERDADERO;VERDADERO;-6;;;
56509;56515;0;8644;VERDADERO;VERDADERO;-6;;;
56509;56535;0;8645;VERDADERO;VERDADERO;-26;;;
56509;56535;0;8646;VERDADERO;VERDADERO;-26;;;
56509;56535;0;8647;VERDADERO;VERDADERO;-26;;;
56541;56555;0;8648;VERDADERO;VERDADERO;-14;;;
56541;56555;0;8649;VERDADERO;VERDADERO;-14;;;
56541;56575;1;8650;VERDADERO;VERDADERO;-34;;;
56541;56575;0;8651;VERDADERO;VERDADERO;-34;;;
56541;56575;0;8652;VERDADERO;VERDADERO;-34;;;
56572;56595;1;8653;VERDADERO;VERDADERO;-23;;;
56572;56595;0;8654;VERDADERO;VERDADERO;-23;;;
56572;56615;0;8655;VERDADERO;VERDADERO;-43;;;
56572;56615;0;8656;VERDADERO;VERDADERO;-43;;;
56572;56615;0;8657;VERDADERO;VERDADERO;-43;;;
56572;56615;0;8658;VERDADERO;VERDADERO;-43;;;
56609;56635;0;8659;VERDADERO;VERDADERO;-26;;;
56609;56635;0;8660;VERDADERO;VERDADERO;-26;;;
56609;56635;0;8661;VERDADERO;VERDADERO;-26;;;
56609;56655;0;8662;VERDADERO;VERDADERO;-46;;;
56609;56655;0;8663;VERDADERO;VERDADERO;-46;;;
56641;56655;0;8664;VERDADERO;VERDADERO;-14;;;
56641;56655;0;8665;VERDADERO;VERDADERO;-14;;;
56641;56655;0;8666;VERDADERO;VERDADERO;-14;;;
56641;56675;0;8667;VERDADERO;VERDADERO;-34;;;
56641;56675;0;8668;VERDADERO;VERDADERO;-34;;;
56673;56675;0;8669;VERDADERO;VERDADERO;-2;;;
56673;56695;0;8670;VERDADERO;VERDADERO;-22;;;
56673;56695;0;8671;VERDADERO;VERDADERO;-22;;;
56673;56715;0;8672;VERDADERO;VERDADERO;-42;;;
56673;56715;0;8673;VERDADERO;VERDADERO;-42;;;
56705;56715;0;8674;VERDADERO;VERDADERO;-10;;;
56705;56735;0;8675;VERDADERO;VERDADERO;-30;;;
56705;56735;0;8676;VERDADERO;VERDADERO;-30;;;
56705;56755;1;8677;VERDADERO;FALSO;-50;;;
56705;56755;0;8678;VERDADERO;FALSO;-50;;;
56736;56755;0;8679;VERDADERO;VERDADERO;-19;;;
56736;56755;0;8680;VERDADERO;VERDADERO;-19;;;
56736;56755;0;8681;VERDADERO;VERDADERO;-19;;;
56736;56755;0;8682;VERDADERO;VERDADERO;-19;;;
56736;56775;0;8683;VERDADERO;VERDADERO;-39;;;
56769;56775;0;8684;VERDADERO;VERDADERO;-6;;;
56769;56795;0;8685;VERDADERO;VERDADERO;-26;;;
56769;56795;0;8686;VERDADERO;VERDADERO;-26;;;
56769;56795;0;8687;VERDADERO;VERDADERO;-26;;;
56769;56815;0;8688;VERDADERO;VERDADERO;-46;;;
56801;56815;0;8689;VERDADERO;VERDADERO;-14;;;
56801;56835;0;8690;VERDADERO;VERDADERO;-34;;;
56801;56835;0;8691;VERDADERO;VERDADERO;-34;;;
56801;56835;0;8692;VERDADERO;VERDADERO;-34;;;
56801;56855;0;8693;VERDADERO;FALSO;-54;;;
56801;56855;0;8694;VERDADERO;FALSO;-54;;;
56839;56855;0;8695;VERDADERO;VERDADERO;-16;;;
56839;56855;0;8696;VERDADERO;VERDADERO;-16;;;
56839;56875;1;8697;VERDADERO;VERDADERO;-36;;;
56839;56875;0;8698;VERDADERO;VERDADERO;-36;;;
56839;56875;0;8699;VERDADERO;VERDADERO;-36;;;
56869;56895;1;8700;VERDADERO;VERDADERO;-26;;;
56901;56915;1;8701;VERDADERO;VERDADERO;-14;;;
56937;56955;1;8702;VERDADERO;VERDADERO;-18;;;
56973;56975;0;8703;VERDADERO;VERDADERO;-2;;;
57004;57015;0;8704;VERDADERO;VERDADERO;-11;;;
57036;57055;1;8705;VERDADERO;VERDADERO;-19;;;
57072;57075;1;8706;VERDADERO;VERDADERO;-3;;;
57104;57116;1;8707;VERDADERO;VERDADERO;-12;;;
57136;57156;1;8708;VERDADERO;VERDADERO;-20;;;
57172;57176;0;8709;VERDADERO;VERDADERO;-4;;;
57204;57216;1;8710;VERDADERO;VERDADERO;-12;;;
57237;57256;1;8711;VERDADERO;VERDADERO;-19;;;
57273;57276;0;8712;VERDADERO;VERDADERO;-3;;;
57305;57317;0;8713;VERDADERO;VERDADERO;-12;;;
57337;57357;1;8714;VERDADERO;VERDADERO;-20;;;
57369;57377;1;8715;VERDADERO;VERDADERO;-8;;;
57401;57417;1;8716;VERDADERO;VERDADERO;-16;;;
57437;57457;0;8717;VERDADERO;VERDADERO;-20;;;
57437;57457;0;8718;VERDADERO;VERDADERO;-20;;;
57437;57457;0;8719;VERDADERO;VERDADERO;-20;;;
57437;57457;0;8720;VERDADERO;VERDADERO;-20;;;
57437;57457;0;8721;VERDADERO;VERDADERO;-20;;;
57437;57457;0;8722;VERDADERO;VERDADERO;-20;;;
57469;57477;0;8723;VERDADERO;VERDADERO;-8;;;
57469;57477;0;8724;VERDADERO;VERDADERO;-8;;;
57469;57497;0;8725;VERDADERO;VERDADERO;-28;;;
57469;57497;0;8726;VERDADERO;VERDADERO;-28;;;
57469;57497;0;8727;VERDADERO;VERDADERO;-28;;;
57501;57517;1;8728;VERDADERO;VERDADERO;-16;;;
57501;57517;0;8729;VERDADERO;VERDADERO;-16;;;
57501;57517;0;8730;VERDADERO;VERDADERO;-16;;;
57501;57537;0;8731;VERDADERO;VERDADERO;-36;;;
57501;57537;0;8732;VERDADERO;VERDADERO;-36;;;
57534;57557;0;8733;VERDADERO;VERDADERO;-23;;;
57534;57557;0;8734;VERDADERO;VERDADERO;-23;;;
57534;57557;0;8735;VERDADERO;VERDADERO;-23;;;
57534;57557;0;8736;VERDADERO;VERDADERO;-23;;;
57534;57557;0;8737;VERDADERO;VERDADERO;-23;;;
57564;57557;0;8738;VERDADERO;VERDADERO;7;;;
57564;57577;0;8739;VERDADERO;VERDADERO;-13;;;
57564;57577;0;8740;VERDADERO;VERDADERO;-13;;;
57564;57598;1;8741;VERDADERO;VERDADERO;-34;;;
57564;57598;0;8742;VERDADERO;VERDADERO;-34;;;
57564;57598;0;8743;VERDADERO;VERDADERO;-34;;;
57600;57618;0;8744;VERDADERO;VERDADERO;-18;;;
57600;57618;0;8745;VERDADERO;VERDADERO;-18;;;
57600;57618;0;8746;VERDADERO;VERDADERO;-18;;;
57600;57638;0;8747;VERDADERO;VERDADERO;-38;;;
57600;57638;0;8748;VERDADERO;VERDADERO;-38;;;
57633;57658;0;8749;VERDADERO;VERDADERO;-25;;;
57633;57658;0;8750;VERDADERO;VERDADERO;-25;;;
57633;57658;0;8751;VERDADERO;VERDADERO;-25;;;
57633;57658;0;8752;VERDADERO;VERDADERO;-25;;;
57633;57658;0;8753;VERDADERO;VERDADERO;-25;;;
57669;57658;0;8754;VERDADERO;VERDADERO;11;;;
57669;57658;0;8755;VERDADERO;VERDADERO;11;;;
57669;57678;0;8756;VERDADERO;VERDADERO;-9;;;
57669;57678;0;8757;VERDADERO;VERDADERO;-9;;;
57669;57698;0;8758;VERDADERO;VERDADERO;-29;;;
57700;57698;0;8759;VERDADERO;VERDADERO;2;;;
57700;57698;0;8760;VERDADERO;VERDADERO;2;;;
57700;57718;0;8761;VERDADERO;VERDADERO;-18;;;
57700;57718;0;8762;VERDADERO;VERDADERO;-18;;;
57700;57738;1;8763;VERDADERO;VERDADERO;-38;;;
57700;57738;0;8764;VERDADERO;VERDADERO;-38;;;
57736;57738;0;8765;VERDADERO;VERDADERO;-2;;;
57736;57758;0;8766;VERDADERO;VERDADERO;-22;;;
57736;57758;0;8767;VERDADERO;VERDADERO;-22;;;
57736;57778;0;8768;VERDADERO;VERDADERO;-42;;;
57736;57778;0;8769;VERDADERO;VERDADERO;-42;;;
57769;57778;0;8770;VERDADERO;VERDADERO;-9;;;
57769;57778;0;8771;VERDADERO;VERDADERO;-9;;;
57769;57798;0;8772;VERDADERO;VERDADERO;-29;;;
57769;57798;0;8773;VERDADERO;VERDADERO;-29;;;
57769;57818;0;8774;VERDADERO;VERDADERO;-49;;;
57801;57818;0;8775;VERDADERO;VERDADERO;-17;;;
57801;57818;0;8776;VERDADERO;VERDADERO;-17;;;
57801;57818;0;8777;VERDADERO;VERDADERO;-17;;;
57801;57818;0;8778;VERDADERO;VERDADERO;-17;;;
57801;57838;0;8779;VERDADERO;VERDADERO;-37;;;
57801;57838;0;8780;VERDADERO;VERDADERO;-37;;;
57837;57858;0;8781;VERDADERO;VERDADERO;-21;;;
57837;57858;0;8782;VERDADERO;VERDADERO;-21;;;
57837;57858;0;8783;VERDADERO;VERDADERO;-21;;;
57837;57878;1;8784;VERDADERO;VERDADERO;-41;;;
57837;57878;0;8785;VERDADERO;VERDADERO;-41;;;
57869;57878;0;8786;VERDADERO;VERDADERO;-9;;;
57869;57898;0;8787;VERDADERO;VERDADERO;-29;;;
57869;57898;0;8788;VERDADERO;VERDADERO;-29;;;
57869;57898;0;8789;VERDADERO;VERDADERO;-29;;;
57869;57918;0;8790;VERDADERO;VERDADERO;-49;;;
57905;57918;0;8791;VERDADERO;VERDADERO;-13;;;
57905;57918;0;8792;VERDADERO;VERDADERO;-13;;;
57905;57918;0;8793;VERDADERO;VERDADERO;-13;;;
57905;57918;0;8794;VERDADERO;VERDADERO;-13;;;
57905;57918;0;8795;VERDADERO;VERDADERO;-13;;;
57933;57938;1;8796;VERDADERO;VERDADERO;-5;;;
57933;57938;0;8797;VERDADERO;VERDADERO;-5;;;
57933;57958;0;8798;VERDADERO;VERDADERO;-25;;;
57933;57958;0;8799;VERDADERO;VERDADERO;-25;;;
57933;57958;0;8800;VERDADERO;VERDADERO;-25;;;
57964;57978;0;8801;VERDADERO;VERDADERO;-14;;;
57964;57978;0;8802;VERDADERO;VERDADERO;-14;;;
57964;57978;0;8803;VERDADERO;VERDADERO;-14;;;
57964;57998;0;8804;VERDADERO;VERDADERO;-34;;;
57964;57998;0;8805;VERDADERO;VERDADERO;-34;;;
57964;58018;1;8806;VERDADERO;FALSO;-54;;;
58001;58018;0;8807;VERDADERO;VERDADERO;-17;;;
58001;58018;0;8808;VERDADERO;VERDADERO;-17;;;
58001;58018;0;8809;VERDADERO;VERDADERO;-17;;;
58001;58018;0;8810;VERDADERO;VERDADERO;-17;;;
58001;58038;0;8811;VERDADERO;VERDADERO;-37;;;
58033;58038;0;8812;VERDADERO;VERDADERO;-5;;;
58033;58038;0;8813;VERDADERO;VERDADERO;-5;;;
58033;58059;0;8814;VERDADERO;VERDADERO;-26;;;
58033;58059;0;8815;VERDADERO;VERDADERO;-26;;;
58033;58079;0;8816;VERDADERO;VERDADERO;-46;;;
58069;58079;0;8817;VERDADERO;VERDADERO;-10;;;
58069;58079;0;8818;VERDADERO;VERDADERO;-10;;;
58069;58079;0;8819;VERDADERO;VERDADERO;-10;;;
58069;58099;1;8820;VERDADERO;VERDADERO;-30;;;
58069;58099;0;8821;VERDADERO;VERDADERO;-30;;;
58100;58119;0;8822;VERDADERO;VERDADERO;-19;;;
58100;58119;0;8823;VERDADERO;VERDADERO;-19;;;
58100;58119;0;8824;VERDADERO;VERDADERO;-19;;;
58100;58119;0;8825;VERDADERO;VERDADERO;-19;;;
58100;58119;0;8826;VERDADERO;VERDADERO;-19;;;
58100;58119;0;8827;VERDADERO;VERDADERO;-19;;;
58137;58139;0;8828;VERDADERO;VERDADERO;-2;;;
58137;58139;0;8829;VERDADERO;VERDADERO;-2;;;
58137;58159;1;8830;VERDADERO;VERDADERO;-22;;;
58137;58159;0;8831;VERDADERO;VERDADERO;-22;;;
58137;58159;0;8832;VERDADERO;VERDADERO;-22;;;
58169;58179;1;8833;VERDADERO;VERDADERO;-10;;;
58169;58179;0;8834;VERDADERO;VERDADERO;-10;;;
58169;58179;0;8835;VERDADERO;VERDADERO;-10;;;
58169;58199;0;8836;VERDADERO;VERDADERO;-30;;;
58169;58199;0;8837;VERDADERO;VERDADERO;-30;;;
58169;58219;0;8838;VERDADERO;FALSO;-50;;;
58205;58219;0;8839;VERDADERO;VERDADERO;-14;;;
58205;58219;0;8840;VERDADERO;VERDADERO;-14;;;
58205;58219;0;8841;VERDADERO;VERDADERO;-14;;;
58205;58219;0;8842;VERDADERO;VERDADERO;-14;;;
58205;58219;0;8843;VERDADERO;VERDADERO;-14;;;
58236;58219;0;8844;VERDADERO;VERDADERO;17;;;
58236;58219;0;8845;VERDADERO;VERDADERO;17;;;
58236;58239;0;8846;VERDADERO;VERDADERO;-3;;;
58236;58239;0;8847;VERDADERO;VERDADERO;-3;;;
58236;58260;0;8848;VERDADERO;VERDADERO;-24;;;
58269;58260;0;8849;VERDADERO;VERDADERO;9;;;
58269;58260;0;8850;VERDADERO;VERDADERO;9;;;
58269;58280;0;8851;VERDADERO;VERDADERO;-11;;;
58269;58280;0;8852;VERDADERO;VERDADERO;-11;;;
58269;58300;0;8853;VERDADERO;VERDADERO;-31;;;
58305;58300;0;8854;VERDADERO;VERDADERO;5;;;
58305;58300;0;8855;VERDADERO;VERDADERO;5;;;
58305;58320;0;8856;VERDADERO;VERDADERO;-15;;;
58305;58320;0;8857;VERDADERO;VERDADERO;-15;;;
58305;58340;1;8858;VERDADERO;VERDADERO;-35;;;
58305;58340;0;8859;VERDADERO;VERDADERO;-35;;;
58337;58340;0;8860;VERDADERO;VERDADERO;-3;;;
58337;58360;0;8861;VERDADERO;VERDADERO;-23;;;
58337;58360;0;8862;VERDADERO;VERDADERO;-23;;;
58337;58380;0;8863;VERDADERO;VERDADERO;-43;;;
58369;58380;0;8864;VERDADERO;VERDADERO;-11;;;
58369;58380;0;8865;VERDADERO;VERDADERO;-11;;;
58369;58380;0;8866;VERDADERO;VERDADERO;-11;;;
58369;58400;0;8867;VERDADERO;VERDADERO;-31;;;
58369;58400;0;8868;VERDADERO;VERDADERO;-31;;;
58369;58420;0;8869;VERDADERO;FALSO;-51;;;
58401;58420;0;8870;VERDADERO;VERDADERO;-19;;;
58401;58420;0;8871;VERDADERO;VERDADERO;-19;;;
58401;58440;1;8872;VERDADERO;VERDADERO;-39;;;
58401;58440;0;8873;VERDADERO;VERDADERO;-39;;;
58401;58460;0;8874;VERDADERO;FALSO;-59;;;
58433;58460;0;8875;VERDADERO;VERDADERO;-27;;;
58433;58460;0;8876;VERDADERO;VERDADERO;-27;;;
58433;58480;0;8877;VERDADERO;VERDADERO;-47;;;
58433;58480;0;8878;VERDADERO;VERDADERO;-47;;;
58433;58480;0;8879;VERDADERO;VERDADERO;-47;;;
58469;58480;0;8880;VERDADERO;VERDADERO;-11;;;
58469;58480;0;8881;VERDADERO;VERDADERO;-11;;;
58469;58480;0;8882;VERDADERO;VERDADERO;-11;;;
58469;58480;0;8883;VERDADERO;VERDADERO;-11;;;
58469;58500;1;8884;VERDADERO;VERDADERO;-31;;;
58501;58500;0;8885;VERDADERO;VERDADERO;1;;;
58501;58500;0;8886;VERDADERO;VERDADERO;1;;;
58501;58520;0;8887;VERDADERO;VERDADERO;-19;;;
58501;58520;0;8888;VERDADERO;VERDADERO;-19;;;
58501;58520;0;8889;VERDADERO;VERDADERO;-19;;;
58533;58520;0;8890;VERDADERO;VERDADERO;13;;;
58533;58520;0;8891;VERDADERO;VERDADERO;13;;;
58533;58540;0;8892;VERDADERO;VERDADERO;-7;;;
58533;58540;0;8893;VERDADERO;VERDADERO;-7;;;
58533;58540;0;8894;VERDADERO;VERDADERO;-7;;;
58533;58560;0;8895;VERDADERO;VERDADERO;-27;;;
58533;58560;0;8896;VERDADERO;VERDADERO;-27;;;
58573;58580;0;8897;VERDADERO;VERDADERO;-7;;;
58573;58580;0;8898;VERDADERO;VERDADERO;-7;;;
58573;58580;0;8899;VERDADERO;VERDADERO;-7;;;
58573;58580;0;8900;VERDADERO;VERDADERO;-7;;;
58599;58600;0;8901;VERDADERO;VERDADERO;-1;;;
58599;58600;0;8902;VERDADERO;VERDADERO;-1;;;
58599;58620;0;8903;VERDADERO;VERDADERO;-21;;;
58599;58620;0;8904;VERDADERO;VERDADERO;-21;;;
58599;58640;0;8905;VERDADERO;VERDADERO;-41;;;
58633;58640;0;8906;VERDADERO;VERDADERO;-7;;;
58633;58640;0;8907;VERDADERO;VERDADERO;-7;;;
58633;58660;0;8908;VERDADERO;VERDADERO;-27;;;
58633;58660;0;8909;VERDADERO;VERDADERO;-27;;;
58633;58660;0;8910;VERDADERO;VERDADERO;-27;;;
58665;58680;0;8911;VERDADERO;VERDADERO;-15;;;
58665;58680;0;8912;VERDADERO;VERDADERO;-15;;;
58665;58680;0,00E+00;8913;VERDADERO;VERDADERO;-15;;;
58665;58680;0;8914;VERDADERO;VERDADERO;-15;;;
58665;58700;0;8915;VERDADERO;VERDADERO;-35;;;
58665;58700;0;8916;VERDADERO;VERDADERO;-35;;;
58701;58700;0;8917;VERDADERO;VERDADERO;1;;;
58701;58720;0;8918;VERDADERO;VERDADERO;-19;;;
58701;58720;0;8919;VERDADERO;VERDADERO;-19;;;
58701;58740;0;8920;VERDADERO;VERDADERO;-39;;;
58701;58740;0;8921;VERDADERO;VERDADERO;-39;;;
58733;58760;0;8922;VERDADERO;VERDADERO;-27;;;
58733;58760;0;8923;VERDADERO;VERDADERO;-27;;;
58733;58760;0;8924;VERDADERO;VERDADERO;-27;;;
58733;58780;0;8925;VERDADERO;VERDADERO;-47;;;
58733;58780;0;8926;VERDADERO;VERDADERO;-47;;;
58733;58780;0;8927;VERDADERO;VERDADERO;-47;;;
58769;58780;0;8928;VERDADERO;VERDADERO;-11;;;
58769;58780;0;8929;VERDADERO;VERDADERO;-11;;;
58769;58800;0;8930;VERDADERO;VERDADERO;-31;;;
58769;58800;0;8931;VERDADERO;VERDADERO;-31;;;
58769;58820;0,00E+00;8932;VERDADERO;FALSO;-51;;;
58801;58820;0;8933;VERDADERO;VERDADERO;-19;;;
58801;58820;0;8934;VERDADERO;VERDADERO;-19;;;
58801;58820;0;8935;VERDADERO;VERDADERO;-19;;;
58801;58820;0;8936;VERDADERO;VERDADERO;-19;;;
58801;58840;0;8937;VERDADERO;VERDADERO;-39;;;
58833;58840;0;8938;VERDADERO;VERDADERO;-7;;;
58833;58840;0;8939;VERDADERO;VERDADERO;-7;;;
58833;58860;0;8940;VERDADERO;VERDADERO;-27;;;
58833;58860;0;8941;VERDADERO;VERDADERO;-27;;;
58833;58880;0;8942;VERDADERO;VERDADERO;-47;;;
58869;58880;0;8943;VERDADERO;VERDADERO;-11;;;
58869;58880;0;8944;VERDADERO;VERDADERO;-11;;;
58869;58880;0;8945;VERDADERO;VERDADERO;-11;;;
58869;58880;0;8946;VERDADERO;VERDADERO;-11;;;
58869;58900;0;8947;VERDADERO;VERDADERO;-31;;;
58869;58900;0;8948;VERDADERO;VERDADERO;-31;;;
58905;58920;0;8949;VERDADERO;VERDADERO;-15;;;
58905;58920;0;8950;VERDADERO;VERDADERO;-15;;;
58905;58920;0;8951;VERDADERO;VERDADERO;-15;;;
58905;58920;0;8952;VERDADERO;VERDADERO;-15;;;
58905;58920;0;8953;VERDADERO;VERDADERO;-15;;;
58936;58940;0;8954;VERDADERO;VERDADERO;-4;;;
58936;58940;0;8955;VERDADERO;VERDADERO;-4;;;
58936;58960;0;8956;VERDADERO;VERDADERO;-24;;;
58936;58960;0;8957;VERDADERO;VERDADERO;-24;;;
58936;58960;0;8958;VERDADERO;VERDADERO;-24;;;
58970;58980;0;8959;VERDADERO;VERDADERO;-10;;;
58970;58980;0;8960;VERDADERO;VERDADERO;-10;;;
58970;58980;0;8961;VERDADERO;VERDADERO;-10;;;
58970;59000;0;8962;VERDADERO;VERDADERO;-30;;;
58970;59000;0;8963;VERDADERO;VERDADERO;-30;;;
58970;59000;0;8964;VERDADERO;VERDADERO;-30;;;
59005;59020;1;8965;VERDADERO;VERDADERO;-15;;;
59005;59020;0;8966;VERDADERO;VERDADERO;-15;;;
59005;59040;0;8967;VERDADERO;VERDADERO;-35;;;
59005;59040;0;8968;VERDADERO;VERDADERO;-35;;;
59005;59040;0;8969;VERDADERO;VERDADERO;-35;;;
59037;59060;0;8970;VERDADERO;VERDADERO;-23;;;
59037;59060;0;8971;VERDADERO;VERDADERO;-23;;;
59037;59060;0;8972;VERDADERO;VERDADERO;-23;;;
59037;59080;0;8973;VERDADERO;VERDADERO;-43;;;
59037;59080;0;8974;VERDADERO;VERDADERO;-43;;;
59069;59080;0;8975;VERDADERO;VERDADERO;-11;;;
59069;59080;0;8976;VERDADERO;VERDADERO;-11;;;
59069;59080;0;8977;VERDADERO;VERDADERO;-11;;;
59069;59080;0;8978;VERDADERO;VERDADERO;-11;;;
59069;59080;0;8979;VERDADERO;VERDADERO;-11;;;
59101;59100;1;8980;VERDADERO;VERDADERO;1;;;
59101;59100;0;8981;VERDADERO;VERDADERO;1;;;
59101;59120;1;8982;VERDADERO;VERDADERO;-19;;;
59101;59120;0;8983;VERDADERO;VERDADERO;-19;;;
59101;59120;0;8984;VERDADERO;VERDADERO;-19;;;
59133;59140;1;8985;VERDADERO;VERDADERO;-7;;;
59133;59140;0;8986;VERDADERO;VERDADERO;-7;;;
59133;59160;0;8987;VERDADERO;VERDADERO;-27;;;
59133;59160;0;8988;VERDADERO;VERDADERO;-27;;;
59133;59160;0;8989;VERDADERO;VERDADERO;-27;;;
59133;59180;0;8990;VERDADERO;VERDADERO;-47;;;
59169;59180;0;8991;VERDADERO;VERDADERO;-11;;;
59169;59200;0;8992;VERDADERO;VERDADERO;-31;;;
59169;59200;0;8993;VERDADERO;VERDADERO;-31;;;
59169;59220;0;8994;VERDADERO;FALSO;-51;;;
59201;59220;0;8995;VERDADERO;VERDADERO;-19;;;
59201;59220;0;8996;VERDADERO;VERDADERO;-19;;;
59201;59240;0;8997;VERDADERO;VERDADERO;-39;;;
59201;59240;0;8998;VERDADERO;VERDADERO;-39;;;
59201;59240;0;8999;VERDADERO;VERDADERO;-39;;;
59233;59240;0;9000;VERDADERO;VERDADERO;-7;;;
59233;59240;0;9001;VERDADERO;VERDADERO;-7;;;
59233;59260;0;9002;VERDADERO;VERDADERO;-27;;;
59233;59260;0;9003;VERDADERO;VERDADERO;-27;;;
59233;59280;0;9004;VERDADERO;VERDADERO;-47;;;
59233;59280;0;9005;VERDADERO;VERDADERO;-47;;;
59269;59280;0;9006;VERDADERO;VERDADERO;-11;;;
59269;59280;0;9007;VERDADERO;VERDADERO;-11;;;
59269;59280;0;9008;VERDADERO;VERDADERO;-11;;;
59269;59280;0;9009;VERDADERO;VERDADERO;-11;;;
59269;59300;0;9010;VERDADERO;VERDADERO;-31;;;
59301;59300;0;9011;VERDADERO;VERDADERO;1;;;
59301;59320;0;9012;VERDADERO;VERDADERO;-19;;;
59301;59320;0;9013;VERDADERO;VERDADERO;-19;;;
59301;59320;0;9014;VERDADERO;VERDADERO;-19;;;
59301;59340;0;9015;VERDADERO;VERDADERO;-39;;;
59333;59340;0;9016;VERDADERO;VERDADERO;-7;;;
59333;59360;0;9017;VERDADERO;VERDADERO;-27;;;
59333;59360;0;9018;VERDADERO;VERDADERO;-27;;;
59333;59360;0;9019;VERDADERO;VERDADERO;-27;;;
59333;59380;0;9020;VERDADERO;VERDADERO;-47;;;
59365;59380;0;9021;VERDADERO;VERDADERO;-15;;;
59365;59380;0;9022;VERDADERO;VERDADERO;-15;;;
59365;59380;0;9023;VERDADERO;VERDADERO;-15;;;
59365;59380;0;9024;VERDADERO;VERDADERO;-15;;;
59365;59380;0;9025;VERDADERO;VERDADERO;-15;;;
59365;59400;0;9026;VERDADERO;VERDADERO;-35;;;
59397;59400;0;9027;VERDADERO;VERDADERO;-3;;;
59397;59420;0;9028;VERDADERO;VERDADERO;-23;;;
59397;59420;0;9029;VERDADERO;VERDADERO;-23;;;
59397;59440;0;9030;VERDADERO;VERDADERO;-43;;;
59397;59440;0;9031;VERDADERO;VERDADERO;-43;;;
59433;59440;0;9032;VERDADERO;VERDADERO;-7;;;
59433;59460;0;9033;VERDADERO;VERDADERO;-27;;;
59433;59460;0;9034;VERDADERO;VERDADERO;-27;;;
59433;59460;0;9035;VERDADERO;VERDADERO;-27;;;
59433;59480;0;9036;VERDADERO;VERDADERO;-47;;;
59465;59480;0;9037;VERDADERO;VERDADERO;-15;;;
59465;59480;0;9038;VERDADERO;VERDADERO;-15;;;
59465;59480;0;9039;VERDADERO;VERDADERO;-15;;;
59465;59500;0;9040;VERDADERO;VERDADERO;-35;;;
59465;59500;0;9041;VERDADERO;VERDADERO;-35;;;
59496;59520;1;9042;VERDADERO;VERDADERO;-24;;;
59496;59520;0;9043;VERDADERO;VERDADERO;-24;;;
59496;59520;0;9044;VERDADERO;VERDADERO;-24;;;
59496;59520;0;9045;VERDADERO;VERDADERO;-24;;;
59496;59520;0;9046;VERDADERO;VERDADERO;-24;;;
59496;59540;0;9047;VERDADERO;VERDADERO;-44;;;
59532;59540;0;9048;VERDADERO;VERDADERO;-8;;;
59532;59561;0;9049;VERDADERO;VERDADERO;-29;;;
59532;59561;0;9050;VERDADERO;VERDADERO;-29;;;
59532;59561;0;9051;VERDADERO;VERDADERO;-29;;;
59532;59581;0;9052;VERDADERO;VERDADERO;-49;;;
59565;59581;0;9053;VERDADERO;VERDADERO;-16;;;
59565;59601;0;9054;VERDADERO;VERDADERO;-36;;;
59565;59601;0;9055;VERDADERO;VERDADERO;-36;;;
59565;59601;0;9056;VERDADERO;VERDADERO;-36;;;
59565;59621;0;9057;VERDADERO;FALSO;-56;;;
59600;59621;0;9058;VERDADERO;VERDADERO;-21;;;
59600;59621;0;9059;VERDADERO;VERDADERO;-21;;;
59600;59621;0;9060;VERDADERO;VERDADERO;-21;;;
59600;59641;0;9061;VERDADERO;VERDADERO;-41;;;
59600;59641;0;9062;VERDADERO;VERDADERO;-41;;;
59600;59641;0;9063;VERDADERO;VERDADERO;-41;;;
59637;59661;1;9064;VERDADERO;VERDADERO;-24;;;
59637;59661;0;9065;VERDADERO;VERDADERO;-24;;;
59637;59661;0;9066;VERDADERO;VERDADERO;-24;;;
59637;59661;0;9067;VERDADERO;VERDADERO;-24;;;
59637;59661;0;9068;VERDADERO;VERDADERO;-24;;;
59669;59681;0;9069;VERDADERO;VERDADERO;-12;;;
59669;59681;0;9070;VERDADERO;VERDADERO;-12;;;
59669;59681;0;9071;VERDADERO;VERDADERO;-12;;;
59669;59701;0;9072;VERDADERO;VERDADERO;-32;;;
59669;59701;0;9073;VERDADERO;VERDADERO;-32;;;
59701;59721;0;9074;VERDADERO;VERDADERO;-20;;;
59701;59721;0,00E+00;9075;VERDADERO;VERDADERO;-20;;;
59701;59721;0;9076;VERDADERO;VERDADERO;-20;;;
59701;59741;0;9077;VERDADERO;VERDADERO;-40;;;
59701;59741;0;9078;VERDADERO;VERDADERO;-40;;;
59701;59741;0;9079;VERDADERO;VERDADERO;-40;;;
59736;59761;0;9080;VERDADERO;VERDADERO;-25;;;
59736;59761;0;9081;VERDADERO;VERDADERO;-25;;;
59736;59761;0;9082;VERDADERO;VERDADERO;-25;;;
59736;59761;0;9083;VERDADERO;VERDADERO;-25;;;
59736;59761;0;9084;VERDADERO;VERDADERO;-25;;;
59736;59781;0;9085;VERDADERO;VERDADERO;-45;;;
59772;59781;0;9086;VERDADERO;VERDADERO;-9;;;
59772;59781;0;9087;VERDADERO;VERDADERO;-9;;;
59772;59801;0;9088;VERDADERO;VERDADERO;-29;;;
59772;59801;0;9089;VERDADERO;VERDADERO;-29;;;
59772;59821;0;9090;VERDADERO;VERDADERO;-49;;;
59805;59821;0;9091;VERDADERO;VERDADERO;-16;;;
59805;59821;0;9092;VERDADERO;VERDADERO;-16;;;
59805;59821;0;9093;VERDADERO;VERDADERO;-16;;;
59805;59841;0;9094;VERDADERO;VERDADERO;-36;;;
59805;59841;0;9095;VERDADERO;VERDADERO;-36;;;
59837;59861;0;9096;VERDADERO;VERDADERO;-24;;;
59837;59861;0;9097;VERDADERO;VERDADERO;-24;;;
59837;59861;0;9098;VERDADERO;VERDADERO;-24;;;
59837;59861;0;9099;VERDADERO;VERDADERO;-24;;;
59837;59861;0;9100;VERDADERO;VERDADERO;-24;;;
59869;59861;0;9101;VERDADERO;VERDADERO;8;;;
59869;59881;0;9102;VERDADERO;VERDADERO;-12;;;
59869;59881;0;9103;VERDADERO;VERDADERO;-12;;;
59869;59881;0;9104;VERDADERO;VERDADERO;-12;;;
59869;59901;0;9105;VERDADERO;VERDADERO;-32;;;
59902;59901;0;9106;VERDADERO;VERDADERO;1;;;
59902;59921;0;9107;VERDADERO;VERDADERO;-19;;;
59902;59921;0;9108;VERDADERO;VERDADERO;-19;;;
59902;59941;0;9109;VERDADERO;VERDADERO;-39;;;
59902;59941;0;9110;VERDADERO;VERDADERO;-39;;;
59902;59941;0;9111;VERDADERO;VERDADERO;-39;;;
59937;59961;1;9112;VERDADERO;VERDADERO;-24;;;
59937;59961;0;9113;VERDADERO;VERDADERO;-24;;;
59937;59961;0;9114;VERDADERO;VERDADERO;-24;;;
59937;59961;0;9115;VERDADERO;VERDADERO;-24;;;
59937;59961;0;9116;VERDADERO;VERDADERO;-24;;;
59969;59981;0;9117;VERDADERO;VERDADERO;-12;;;
59969;59981;0;9118;VERDADERO;VERDADERO;-12;;;
59969;60001;0;9119;VERDADERO;VERDADERO;-32;;;
59969;60001;0;9120;VERDADERO;VERDADERO;-32;;;
59969;60001;0;9121;VERDADERO;VERDADERO;-32;;;
60001;60021;1;9122;VERDADERO;VERDADERO;-20;;;
60001;60021;0;9123;VERDADERO;VERDADERO;-20;;;
60001;60041;0;9124;VERDADERO;VERDADERO;-40;;;
60001;60041;0;9125;VERDADERO;VERDADERO;-40;;;
60001;60061;0;9126;VERDADERO;FALSO;-60;;;
60037;60061;0;9127;VERDADERO;VERDADERO;-24;;;
60037;60061;0;9128;VERDADERO;VERDADERO;-24;;;
60037;60061;0;9129;VERDADERO;VERDADERO;-24;;;
60037;60061;0;9130;VERDADERO;VERDADERO;-24;;;
60037;60081;0;9131;VERDADERO;VERDADERO;-44;;;
60065;60081;0;9132;VERDADERO;VERDADERO;-16;;;
60065;60081;0;9133;VERDADERO;VERDADERO;-16;;;
60065;60101;0;9134;VERDADERO;VERDADERO;-36;;;
60065;60101;0;9135;VERDADERO;VERDADERO;-36;;;
60065;60101;0;9136;VERDADERO;VERDADERO;-36;;;
60101;60101;0;9137;VERDADERO;VERDADERO;0;;;
60101;60101;0;9138;VERDADERO;VERDADERO;0;;;
60101;60101;0;9139;VERDADERO;VERDADERO;0;;;
60101;60101;0;9140;VERDADERO;VERDADERO;0;;;
60101;60121;0;9141;VERDADERO;VERDADERO;-20;;;
60133;60121;0;9142;VERDADERO;VERDADERO;12;;;
60133;60121;0;9143;VERDADERO;VERDADERO;12;;;
60133;60142;0;9144;VERDADERO;VERDADERO;-9;;;
60133;60142;0;9145;VERDADERO;VERDADERO;-9;;;
60133;60162;0;9146;VERDADERO;VERDADERO;-29;;;
60133;60162;0;9147;VERDADERO;VERDADERO;-29;;;
60133;60162;0;9148;VERDADERO;VERDADERO;-29;;;
60171;60182;0;9149;VERDADERO;VERDADERO;-11;;;
60171;60182;0;9150;VERDADERO;VERDADERO;-11;;;
60171;60202;0;9151;VERDADERO;VERDADERO;-31;;;
60171;60202;0;9152;VERDADERO;VERDADERO;-31;;;
60196;60222;0;9153;VERDADERO;VERDADERO;-26;;;
60196;60222;0;9154;VERDADERO;VERDADERO;-26;;;
60196;60222;0;9155;VERDADERO;VERDADERO;-26;;;
60196;60242;0;9156;VERDADERO;VERDADERO;-46;;;
60196;60242;0;9157;VERDADERO;VERDADERO;-46;;;
60229;60242;0;9158;VERDADERO;VERDADERO;-13;;;
60229;60262;1;9159;VERDADERO;VERDADERO;-33;;;
60229;60262;0;9160;VERDADERO;VERDADERO;-33;;;
60229;60262;0;9161;VERDADERO;VERDADERO;-33;;;
60229;60262;0;9162;VERDADERO;VERDADERO;-33;;;
60261;60262;0;9163;VERDADERO;VERDADERO;-1;;;
60261;60262;0;9164;VERDADERO;VERDADERO;-1;;;
60261;60282;0;9165;VERDADERO;VERDADERO;-21;;;
60261;60282;0;9166;VERDADERO;VERDADERO;-21;;;
60261;60302;0;9167;VERDADERO;VERDADERO;-41;;;
60293;60302;0;9168;VERDADERO;VERDADERO;-9;;;
60293;60302;0;9169;VERDADERO;VERDADERO;-9;;;
60293;60302;0;9170;VERDADERO;VERDADERO;-9;;;
60293;60302;0;9171;VERDADERO;VERDADERO;-9;;;
60293;60322;1;9172;VERDADERO;VERDADERO;-29;;;
60293;60322;0;9173;VERDADERO;VERDADERO;-29;;;
60329;60322;0;9174;VERDADERO;VERDADERO;7;;;
60329;60343;0;9175;VERDADERO;VERDADERO;-14;;;
60329;60343;0;9176;VERDADERO;VERDADERO;-14;;;
60329;60363;1;9177;VERDADERO;VERDADERO;-34;;;
60329;60363;0;9178;VERDADERO;VERDADERO;-34;;;
60360;60363;0;9179;VERDADERO;VERDADERO;-3;;;
60360;60383;0;9180;VERDADERO;VERDADERO;-23;;;
60360;60383;0;9181;VERDADERO;VERDADERO;-23;;;
60360;60403;0;9182;VERDADERO;VERDADERO;-43;;;
60360;60403;0;9183;VERDADERO;VERDADERO;-43;;;
60394;60403;0;9184;VERDADERO;VERDADERO;-9;;;
60394;60403;0;9185;VERDADERO;VERDADERO;-9;;;
60394;60403;0;9186;VERDADERO;VERDADERO;-9;;;
60394;60403;0;9187;VERDADERO;VERDADERO;-9;;;
60394;60423;0;9188;VERDADERO;VERDADERO;-29;;;
60394;60423;0;9189;VERDADERO;VERDADERO;-29;;;
60429;60423;0;9190;VERDADERO;VERDADERO;6;;;
60429;60444;0;9191;VERDADERO;VERDADERO;-15;;;
60429;60444;0;9192;VERDADERO;VERDADERO;-15;;;
60429;60464;0;9193;VERDADERO;VERDADERO;-35;;;
60461;60464;0;9194;VERDADERO;VERDADERO;-3;;;
60461;60464;0;9195;VERDADERO;VERDADERO;-3;;;
60461;60484;0;9196;VERDADERO;VERDADERO;-23;;;
60461;60484;0;9197;VERDADERO;VERDADERO;-23;;;
60461;60504;1;9198;VERDADERO;VERDADERO;-43;;;
60461;60504;0;9199;VERDADERO;VERDADERO;-43;;;
60497;60504;0;9200;VERDADERO;VERDADERO;-7;;;
60497;60504;0;9201;VERDADERO;VERDADERO;-7;;;
60497;60504;0;9202;VERDADERO;VERDADERO;-7;;;
60497;60504;0;9203;VERDADERO;VERDADERO;-7;;;
60497;60524;0;9204;VERDADERO;VERDADERO;-27;;;
60528;60524;0;9205;VERDADERO;VERDADERO;4;;;
60528;60545;1;9206;VERDADERO;VERDADERO;-17;;;
60528;60545;0;9207;VERDADERO;VERDADERO;-17;;;
60528;60545;0;9208;VERDADERO;VERDADERO;-17;;;
60528;60565;0;9209;VERDADERO;VERDADERO;-37;;;
60528;60565;0;9210;VERDADERO;VERDADERO;-37;;;
60565;60565;0;9211;VERDADERO;VERDADERO;0;;;
60565;60585;0;9212;VERDADERO;VERDADERO;-20;;;
60565;60585;0;9213;VERDADERO;VERDADERO;-20;;;
60565;60605;0;9214;VERDADERO;VERDADERO;-40;;;
60565;60605;0;9215;VERDADERO;VERDADERO;-40;;;
60565;60605;0;9216;VERDADERO;VERDADERO;-40;;;
60601;60605;0;9217;VERDADERO;VERDADERO;-4;;;
60601;60605;0;9218;VERDADERO;VERDADERO;-4;;;
60601;60605;0;9219;VERDADERO;VERDADERO;-4;;;
60601;60605;0;9220;VERDADERO;VERDADERO;-4;;;
60601;60625;0;9221;VERDADERO;VERDADERO;-24;;;
60629;60625;0;9222;VERDADERO;VERDADERO;4;;;
60629;60625;0;9223;VERDADERO;VERDADERO;4;;;
60629;60646;0;9224;VERDADERO;VERDADERO;-17;;;
60629;60646;0;9225;VERDADERO;VERDADERO;-17;;;
60629;60666;0;9226;VERDADERO;VERDADERO;-37;;;
60664;60666;0;9227;VERDADERO;VERDADERO;-2;;;
60664;60686;0;9228;VERDADERO;VERDADERO;-22;;;
60664;60686;0;9229;VERDADERO;VERDADERO;-22;;;
60664;60686;0;9230;VERDADERO;VERDADERO;-22;;;
60664;60706;0;9231;VERDADERO;VERDADERO;-42;;;
60697;60706;0;9232;VERDADERO;VERDADERO;-9;;;
60697;60706;0;9233;VERDADERO;VERDADERO;-9;;;
60697;60726;0;9234;VERDADERO;VERDADERO;-29;;;
60697;60726;0;9235;VERDADERO;VERDADERO;-29;;;
60697;60726;0;9236;VERDADERO;VERDADERO;-29;;;
60697;60746;0;9237;VERDADERO;VERDADERO;-49;;;
60733;60746;0;9238;VERDADERO;VERDADERO;-13;;;
60733;60766;0;9239;VERDADERO;VERDADERO;-33;;;
60733;60766;0;9240;VERDADERO;VERDADERO;-33;;;
60733;60766;0;9241;VERDADERO;VERDADERO;-33;;;
60733;60766;0;9242;VERDADERO;VERDADERO;-33;;;
60766;60766;0;9243;VERDADERO;VERDADERO;0;;;
60766;60786;0;9244;VERDADERO;VERDADERO;-20;;;
60766;60786;0;9245;VERDADERO;VERDADERO;-20;;;
60766;60806;0;9246;VERDADERO;VERDADERO;-40;;;
60766;60806;0;9247;VERDADERO;VERDADERO;-40;;;
60766;60806;0;9248;VERDADERO;VERDADERO;-40;;;
60801;60826;0;9249;VERDADERO;VERDADERO;-25;;;
60801;60826;0;9250;VERDADERO;VERDADERO;-25;;;
60801;60846;0;9251;VERDADERO;VERDADERO;-45;;;
60801;60846;0;9252;VERDADERO;VERDADERO;-45;;;
60801;60846;0;9253;VERDADERO;VERDADERO;-45;;;
60832;60866;0;9254;VERDADERO;VERDADERO;-34;;;
60832;60866;0;9255;VERDADERO;VERDADERO;-34;;;
60832;60866;0;9256;VERDADERO;VERDADERO;-34;;;
60832;60866;0;9257;VERDADERO;VERDADERO;-34;;;
60832;60886;1;9258;VERDADERO;FALSO;-54;;;
60832;60886;0;9259;VERDADERO;FALSO;-54;;;
60869;60886;0;9260;VERDADERO;VERDADERO;-17;;;
60869;60906;0;9261;VERDADERO;VERDADERO;-37;;;
60869;60906;0;9262;VERDADERO;VERDADERO;-37;;;
60869;60906;0;9263;VERDADERO;VERDADERO;-37;;;
60869;60906;0;9264;VERDADERO;VERDADERO;-37;;;
60902;60926;0;9265;VERDADERO;VERDADERO;-24;;;
60902;60926;0;9266;VERDADERO;VERDADERO;-24;;;
60902;60926;0;9267;VERDADERO;VERDADERO;-24;;;
60902;60946;0;9268;VERDADERO;VERDADERO;-44;;;
60902;60946;0;9269;VERDADERO;VERDADERO;-44;;;
60936;60946;0;9270;VERDADERO;VERDADERO;-10;;;
60936;60946;0;9271;VERDADERO;VERDADERO;-10;;;
60936;60946;0;9272;VERDADERO;VERDADERO;-10;;;
60936;60966;0;9273;VERDADERO;VERDADERO;-30;;;
60936;60966;0;9274;VERDADERO;VERDADERO;-30;;;
60968;60986;1;9275;VERDADERO;VERDADERO;-18;;;
60968;60986;0;9276;VERDADERO;VERDADERO;-18;;;
60968;61006;0;9277;VERDADERO;VERDADERO;-38;;;
60968;61006;0;9278;VERDADERO;VERDADERO;-38;;;
60968;61006;0;9279;VERDADERO;VERDADERO;-38;;;
61001;61026;0;9280;VERDADERO;VERDADERO;-25;;;
61001;61026;0;9281;VERDADERO;VERDADERO;-25;;;
61001;61026;0;9282;VERDADERO;VERDADERO;-25;;;
61001;61046;0;9283;VERDADERO;VERDADERO;-45;;;
61001;61046;0;9284;VERDADERO;VERDADERO;-45;;;
61001;61046;0;9285;VERDADERO;VERDADERO;-45;;;
61040;61046;0;9286;VERDADERO;VERDADERO;-6;;;
61040;61046;0;9287;VERDADERO;VERDADERO;-6;;;
61040;61066;0;9288;VERDADERO;VERDADERO;-26;;;
61040;61066;0;9289;VERDADERO;VERDADERO;-26;;;
61065;61066;0;9290;VERDADERO;VERDADERO;-1;;;
61065;61086;0;9291;VERDADERO;VERDADERO;-21;;;
61065;61086;0;9292;VERDADERO;VERDADERO;-21;;;
61065;61086;0;9293;VERDADERO;VERDADERO;-21;;;
61065;61086;0;9294;VERDADERO;VERDADERO;-21;;;
61065;61086;0;9295;VERDADERO;VERDADERO;-21;;;
61101;61106;0;9296;VERDADERO;VERDADERO;-5;;;
61101;61106;0;9297;VERDADERO;VERDADERO;-5;;;
61101;61106;0;9298;VERDADERO;VERDADERO;-5;;;
61101;61127;0;9299;VERDADERO;VERDADERO;-26;;;
61101;61127;0;9300;VERDADERO;VERDADERO;-26;;;
61133;61147;1;9301;VERDADERO;VERDADERO;-14;;;
61133;61147;0;9302;VERDADERO;VERDADERO;-14;;;
61133;61167;0;9303;VERDADERO;VERDADERO;-34;;;
61133;61167;0;9304;VERDADERO;VERDADERO;-34;;;
61133;61167;0;9305;VERDADERO;VERDADERO;-34;;;
61133;61187;1;9306;VERDADERO;FALSO;-54;;;
61175;61187;0;9307;VERDADERO;VERDADERO;-12;;;
61175;61187;0;9308;VERDADERO;VERDADERO;-12;;;
61175;61187;0;9309;VERDADERO;VERDADERO;-12;;;
61175;61207;0;9310;VERDADERO;VERDADERO;-32;;;
61200;61207;0;9311;VERDADERO;VERDADERO;-7;;;
61200;61207;0;9312;VERDADERO;VERDADERO;-7;;;
61200;61228;0;9313;VERDADERO;VERDADERO;-28;;;
61200;61228;0;9314;VERDADERO;VERDADERO;-28;;;
61200;61248;0;9315;VERDADERO;VERDADERO;-48;;;
61229;61248;0;9316;VERDADERO;VERDADERO;-19;;;
61229;61248;0;9317;VERDADERO;VERDADERO;-19;;;
61229;61248;0;9318;VERDADERO;VERDADERO;-19;;;
61229;61268;0;9319;VERDADERO;VERDADERO;-39;;;
61229;61268;0;9320;VERDADERO;VERDADERO;-39;;;
61261;61268;0;9321;VERDADERO;VERDADERO;-7;;;
61261;61288;0;9322;VERDADERO;VERDADERO;-27;;;
61261;61288;0;9323;VERDADERO;VERDADERO;-27;;;
61261;61288;0;9324;VERDADERO;VERDADERO;-27;;;
61261;61288;0;9325;VERDADERO;VERDADERO;-27;;;
61293;61288;0;9326;VERDADERO;VERDADERO;5;;;
61293;61308;0;9327;VERDADERO;VERDADERO;-15;;;
61293;61308;0;9328;VERDADERO;VERDADERO;-15;;;
61293;61328;0;9329;VERDADERO;VERDADERO;-35;;;
61293;61328;0;9330;VERDADERO;VERDADERO;-35;;;
61293;61328;0;9331;VERDADERO;VERDADERO;-35;;;
61329;61348;0;9332;VERDADERO;VERDADERO;-19;;;
61329;61348;0;9333;VERDADERO;VERDADERO;-19;;;
61329;61368;1;9334;VERDADERO;VERDADERO;-39;;;
61329;61368;0;9335;VERDADERO;VERDADERO;-39;;;
61329;61368;0;9336;VERDADERO;VERDADERO;-39;;;
61362;61388;1;9337;VERDADERO;VERDADERO;-26;;;
61362;61388;0;9338;VERDADERO;VERDADERO;-26;;;
61362;61388;0;9339;VERDADERO;VERDADERO;-26;;;
61362;61388;0;9340;VERDADERO;VERDADERO;-26;;;
61362;61388;0;9341;VERDADERO;VERDADERO;-26;;;
61393;61408;1;9342;VERDADERO;VERDADERO;-15;;;
61393;61408;0;9343;VERDADERO;VERDADERO;-15;;;
61393;61408;0;9344;VERDADERO;VERDADERO;-15;;;
61393;61428;0;9345;VERDADERO;VERDADERO;-35;;;
61393;61428;0;9346;VERDADERO;VERDADERO;-35;;;
61393;61448;0;9347;VERDADERO;FALSO;-55;;;
61428;61448;0;9348;VERDADERO;VERDADERO;-20;;;
61428;61468;0;9349;VERDADERO;VERDADERO;-40;;;
61428;61468;0;9350;VERDADERO;VERDADERO;-40;;;
61428;61468;0;9351;VERDADERO;VERDADERO;-40;;;
61428;61488;0;9352;VERDADERO;FALSO;-60;;;
61461;61488;0;9353;VERDADERO;VERDADERO;-27;;;
61461;61488;0;9354;VERDADERO;VERDADERO;-27;;;
61461;61488;0;9355;VERDADERO;VERDADERO;-27;;;
61461;61508;1;9356;VERDADERO;VERDADERO;-47;;;
61461;61508;0;9357;VERDADERO;VERDADERO;-47;;;
61497;61508;0;9358;VERDADERO;VERDADERO;-11;;;
61497;61528;0;9359;VERDADERO;VERDADERO;-31;;;
61497;61528;0;9360;VERDADERO;VERDADERO;-31;;;
61497;61528;0;9361;VERDADERO;VERDADERO;-31;;;
61497;61528;0;9362;VERDADERO;VERDADERO;-31;;;
61529;61548;1;9363;VERDADERO;VERDADERO;-19;;;
61529;61548;0;9364;VERDADERO;VERDADERO;-19;;;
61529;61548;0;9365;VERDADERO;VERDADERO;-19;;;
61529;61568;0;9366;VERDADERO;VERDADERO;-39;;;
61529;61568;0;9367;VERDADERO;VERDADERO;-39;;;
61529;61568;0;9368;VERDADERO;VERDADERO;-39;;;
61529;61568;0;9369;VERDADERO;VERDADERO;-39;;;
61570;61568;0;9370;VERDADERO;VERDADERO;2;;;
61570;61588;0;9371;VERDADERO;VERDADERO;-18;;;
61570;61588;0;9372;VERDADERO;VERDADERO;-18;;;
61570;61608;0;9373;VERDADERO;VERDADERO;-38;;;
61597;61608;0;9374;VERDADERO;VERDADERO;-11;;;
61597;61628;0;9375;VERDADERO;VERDADERO;-31;;;
61597;61628;0;9376;VERDADERO;VERDADERO;-31;;;
61597;61628;0;9377;VERDADERO;VERDADERO;-31;;;
61597;61648;1;9378;VERDADERO;FALSO;-51;;;
61628;61648;0;9379;VERDADERO;VERDADERO;-20;;;
61628;61648;0;9380;VERDADERO;VERDADERO;-20;;;
61628;61668;0;9381;VERDADERO;VERDADERO;-40;;;
61628;61668;0;9382;VERDADERO;VERDADERO;-40;;;
61628;61668;0;9383;VERDADERO;VERDADERO;-40;;;
61628;61668;0;9384;VERDADERO;VERDADERO;-40;;;
61665;61668;0;9385;VERDADERO;VERDADERO;-3;;;
61665;61688;0;9386;VERDADERO;VERDADERO;-23;;;
61665;61688;0;9387;VERDADERO;VERDADERO;-23;;;
61665;61708;0;9388;VERDADERO;VERDADERO;-43;;;
61665;61708;0;9389;VERDADERO;VERDADERO;-43;;;
61701;61708;0;9390;VERDADERO;VERDADERO;-7;;;
61701;61728;0;9391;VERDADERO;VERDADERO;-27;;;
61701;61728;0;9392;VERDADERO;VERDADERO;-27;;;
61701;61748;0;9393;VERDADERO;VERDADERO;-47;;;
61701;61748;0;9394;VERDADERO;VERDADERO;-47;;;
61733;61748;0;9395;VERDADERO;VERDADERO;-15;;;
61733;61768;0;9396;VERDADERO;VERDADERO;-35;;;
61733;61768;0;9397;VERDADERO;VERDADERO;-35;;;
61733;61768;0;9398;VERDADERO;VERDADERO;-35;;;
61733;61768;0;9399;VERDADERO;VERDADERO;-35;;;
61765;61768;0;9400;VERDADERO;VERDADERO;-3;;;
61765;61788;0;9401;VERDADERO;VERDADERO;-23;;;
61765;61788;0;9402;VERDADERO;VERDADERO;-23;;;
61765;61808;0;9403;VERDADERO;VERDADERO;-43;;;
61765;61808;0;9404;VERDADERO;VERDADERO;-43;;;
61765;61808;0;9405;VERDADERO;VERDADERO;-43;;;
61800;61808;0;9406;VERDADERO;VERDADERO;-8;;;
61800;61808;0;9407;VERDADERO;VERDADERO;-8;;;
61800;61808;0;9408;VERDADERO;VERDADERO;-8;;;
61800;61828;0;9409;VERDADERO;VERDADERO;-28;;;
61800;61828;0;9410;VERDADERO;VERDADERO;-28;;;
61800;61848;0;9411;VERDADERO;VERDADERO;-48;;;
61837;61848;0;9412;VERDADERO;VERDADERO;-11;;;
61837;61848;0;9413;VERDADERO;VERDADERO;-11;;;
61837;61868;0;9414;VERDADERO;VERDADERO;-31;;;
61837;61868;0;9415;VERDADERO;VERDADERO;-31;;;
61837;61868;0;9416;VERDADERO;VERDADERO;-31;;;
61869;61888;0;9417;VERDADERO;VERDADERO;-19;;;
61869;61888;0;9418;VERDADERO;VERDADERO;-19;;;
61869;61908;0;9419;VERDADERO;VERDADERO;-39;;;
61869;61908;0;9420;VERDADERO;VERDADERO;-39;;;
61869;61908;0;9421;VERDADERO;VERDADERO;-39;;;
61869;61908;0;9422;VERDADERO;VERDADERO;-39;;;
61905;61928;0;9423;VERDADERO;VERDADERO;-23;;;
61905;61928;0;9424;VERDADERO;VERDADERO;-23;;;
61905;61928;0;9425;VERDADERO;VERDADERO;-23;;;
61905;61948;0;9426;VERDADERO;VERDADERO;-43;;;
61905;61948;0;9427;VERDADERO;VERDADERO;-43;;;
61937;61948;0;9428;VERDADERO;VERDADERO;-11;;;
61937;61948;0;9429;VERDADERO;VERDADERO;-11;;;
61937;61948;0;9430;VERDADERO;VERDADERO;-11;;;
61937;61968;0;9431;VERDADERO;VERDADERO;-31;;;
61964;61968;0;9432;VERDADERO;VERDADERO;-4;;;
61964;61968;0;9433;VERDADERO;VERDADERO;-4;;;
61964;61988;0;9434;VERDADERO;VERDADERO;-24;;;
61964;61988;0;9435;VERDADERO;VERDADERO;-24;;;
61964;62008;0;9436;VERDADERO;VERDADERO;-44;;;
61964;62008;0;9437;VERDADERO;VERDADERO;-44;;;
62001;62008;0;9438;VERDADERO;VERDADERO;-7;;;
62001;62028;0;9439;VERDADERO;VERDADERO;-27;;;
62001;62028;0;9440;VERDADERO;VERDADERO;-27;;;
62001;62048;0;9441;VERDADERO;VERDADERO;-47;;;
62001;62048;0;9442;VERDADERO;VERDADERO;-47;;;
62032;62048;0;9443;VERDADERO;VERDADERO;-16;;;
62032;62048;0;9444;VERDADERO;VERDADERO;-16;;;
62032;62048;0;9445;VERDADERO;VERDADERO;-16;;;
62032;62068;0;9446;VERDADERO;VERDADERO;-36;;;
62032;62068;0;9447;VERDADERO;VERDADERO;-36;;;
62069;62068;0;9448;VERDADERO;VERDADERO;1;;;
62069;62088;0;9449;VERDADERO;VERDADERO;-19;;;
62069;62088;0;9450;VERDADERO;VERDADERO;-19;;;
62069;62108;0;9451;VERDADERO;VERDADERO;-39;;;
62069;62108;0;9452;VERDADERO;VERDADERO;-39;;;
62101;62108;0;9453;VERDADERO;VERDADERO;-7;;;
62101;62128;0;9454;VERDADERO;VERDADERO;-27;;;
62101;62128;0;9455;VERDADERO;VERDADERO;-27;;;
62101;62148;0;9456;VERDADERO;VERDADERO;-47;;;
62101;62148;0;9457;VERDADERO;VERDADERO;-47;;;
62133;62148;0;9458;VERDADERO;VERDADERO;-15;;;
62133;62148;0;9459;VERDADERO;VERDADERO;-15;;;
62133;62168;0;9460;VERDADERO;VERDADERO;-35;;;
62133;62168;0;9461;VERDADERO;VERDADERO;-35;;;
62133;62168;0;9462;VERDADERO;VERDADERO;-35;;;
62133;62188;0;9463;VERDADERO;FALSO;-55;;;
62169;62188;0;9464;VERDADERO;VERDADERO;-19;;;
62169;62188;0;9465;VERDADERO;VERDADERO;-19;;;
62169;62188;0;9466;VERDADERO;VERDADERO;-19;;;
62169;62208;0;9467;VERDADERO;VERDADERO;-39;;;
62169;62208;0;9468;VERDADERO;VERDADERO;-39;;;
62201;62208;0;9469;VERDADERO;VERDADERO;-7;;;
62201;62228;0;9470;VERDADERO;VERDADERO;-27;;;
62201;62228;0;9471;VERDADERO;VERDADERO;-27;;;
62201;62228;0;9472;VERDADERO;VERDADERO;-27;;;
62201;62228;0;9473;VERDADERO;VERDADERO;-27;;;
62233;62228;0;9474;VERDADERO;VERDADERO;5;;;
62233;62228;0;9475;VERDADERO;VERDADERO;5;;;
62233;62248;0;9476;VERDADERO;VERDADERO;-15;;;
62233;62248;0;9477;VERDADERO;VERDADERO;-15;;;
62233;62268;0;9478;VERDADERO;VERDADERO;-35;;;
62265;62268;0;9479;VERDADERO;VERDADERO;-3;;;
62265;62268;0;9480;VERDADERO;VERDADERO;-3;;;
62265;62288;0;9481;VERDADERO;VERDADERO;-23;;;
62265;62288;0;9482;VERDADERO;VERDADERO;-23;;;
62265;62308;0;9483;VERDADERO;VERDADERO;-43;;;
62297;62308;0;9484;VERDADERO;VERDADERO;-11;;;
62297;62308;0;9485;VERDADERO;VERDADERO;-11;;;
62297;62328;0;9486;VERDADERO;VERDADERO;-31;;;
62297;62328;0;9487;VERDADERO;VERDADERO;-31;;;
62297;62328;0;9488;VERDADERO;VERDADERO;-31;;;
62329;62328;0;9489;VERDADERO;VERDADERO;1;;;
62329;62348;0;9490;VERDADERO;VERDADERO;-19;;;
62329;62348;0;9491;VERDADERO;VERDADERO;-19;;;
62329;62368;0;9492;VERDADERO;VERDADERO;-39;;;
62329;62368;0;9493;VERDADERO;VERDADERO;-39;;;
62361;62368;0;9494;VERDADERO;VERDADERO;-7;;;
62361;62388;0;9495;VERDADERO;VERDADERO;-27;;;
62361;62388;0;9496;VERDADERO;VERDADERO;-27;;;
62361;62408;0;9497;VERDADERO;VERDADERO;-47;;;
62361;62408;0;9498;VERDADERO;VERDADERO;-47;;;
62361;62428;0;9499;VERDADERO;FALSO;-67;;;
62361;62428;0;9500;VERDADERO;FALSO;-67;;;
62403;62428;0;9501;VERDADERO;VERDADERO;-25;;;
62403;62428;0;9502;VERDADERO;VERDADERO;-25;;;
62403;62428;0;9503;VERDADERO;VERDADERO;-25;;;
62403;62428;0;9504;VERDADERO;VERDADERO;-25;;;
62430;62448;1;9505;VERDADERO;VERDADERO;-18;;;
62430;62448;0;9506;VERDADERO;VERDADERO;-18;;;
62430;62448;0;9507;VERDADERO;VERDADERO;-18;;;
62430;62468;0;9508;VERDADERO;VERDADERO;-38;;;
62461;62468;0;9509;VERDADERO;VERDADERO;-7;;;
62461;62488;0;9510;VERDADERO;VERDADERO;-27;;;
62461;62488;0;9511;VERDADERO;VERDADERO;-27;;;
62461;62488;0;9512;VERDADERO;VERDADERO;-27;;;
62461;62488;0;9513;VERDADERO;VERDADERO;-27;;;
62461;62508;0;9514;VERDADERO;VERDADERO;-47;;;
62497;62508;0;9515;VERDADERO;VERDADERO;-11;;;
62497;62508;0;9516;VERDADERO;VERDADERO;-11;;;
62497;62528;0;9517;VERDADERO;VERDADERO;-31;;;
62497;62528;0;9518;VERDADERO;VERDADERO;-31;;;
62497;62528;0;9519;VERDADERO;VERDADERO;-31;;;
62497;62528;0;9520;VERDADERO;VERDADERO;-31;;;
62532;62528;0;9521;VERDADERO;VERDADERO;4;;;
62532;62528;0;9522;VERDADERO;VERDADERO;4;;;
62532;62528;0;9523;VERDADERO;VERDADERO;4;;;
62532;62548;1;9524;VERDADERO;VERDADERO;-16;;;
62532;62548;0;9525;VERDADERO;VERDADERO;-16;;;
62565;62548;0;9526;VERDADERO;VERDADERO;17;;;
62565;62568;0;9527;VERDADERO;VERDADERO;-3;;;
62565;62568;0;9528;VERDADERO;VERDADERO;-3;;;
62565;62588;0;9529;VERDADERO;VERDADERO;-23;;;
62565;62588;0;9530;VERDADERO;VERDADERO;-23;;;
62597;62608;0;9531;VERDADERO;VERDADERO;-11;;;
62597;62608;0;9532;VERDADERO;VERDADERO;-11;;;
62597;62608;0;9533;VERDADERO;VERDADERO;-11;;;
62597;62628;0;9534;VERDADERO;VERDADERO;-31;;;
62597;62628;0;9535;VERDADERO;VERDADERO;-31;;;
62633;62648;0;9536;VERDADERO;VERDADERO;-15;;;
62633;62648;0;9537;VERDADERO;VERDADERO;-15;;;
62633;62648;0;9538;VERDADERO;VERDADERO;-15;;;
62633;62668;0;9539;VERDADERO;VERDADERO;-35;;;
62633;62668;0;9540;VERDADERO;VERDADERO;-35;;;
62664;62688;0;9541;VERDADERO;VERDADERO;-24;;;
62664;62688;0;9542;VERDADERO;VERDADERO;-24;;;
62664;62688;0;9543;VERDADERO;VERDADERO;-24;;;
62664;62688;0;9544;VERDADERO;VERDADERO;-24;;;
62664;62688;0;9545;VERDADERO;VERDADERO;-24;;;
62664;62708;0;9546;VERDADERO;VERDADERO;-44;;;
62698;62708;0;9547;VERDADERO;VERDADERO;-10;;;
62698;62708;0;9548;VERDADERO;VERDADERO;-10;;;
62698;62728;0;9549;VERDADERO;VERDADERO;-30;;;
62698;62728;0;9550;VERDADERO;VERDADERO;-30;;;
62698;62748;0;9551;VERDADERO;FALSO;-50;;;
62733;62748;0;9552;VERDADERO;VERDADERO;-15;;;
62733;62748;0;9553;VERDADERO;VERDADERO;-15;;;
62733;62768;0;9554;VERDADERO;VERDADERO;-35;;;
62733;62768;0;9555;VERDADERO;VERDADERO;-35;;;
62733;62788;0;9556;VERDADERO;FALSO;-55;;;
62765;62788;0;9557;VERDADERO;VERDADERO;-23;;;
62765;62788;0;9558;VERDADERO;VERDADERO;-23;;;
62765;62788;0;9559;VERDADERO;VERDADERO;-23;;;
62765;62788;0;9560;VERDADERO;VERDADERO;-23;;;
62765;62788;0;9561;VERDADERO;VERDADERO;-23;;;
62797;62808;0;9562;VERDADERO;VERDADERO;-11;;;
62797;62808;0;9563;VERDADERO;VERDADERO;-11;;;
62797;62828;0;9564;VERDADERO;VERDADERO;-31;;;
62797;62828;0;9565;VERDADERO;VERDADERO;-31;;;
62797;62828;0;9566;VERDADERO;VERDADERO;-31;;;
62797;62828;0;9567;VERDADERO;VERDADERO;-31;;;
62833;62828;0;9568;VERDADERO;VERDADERO;5;;;
62833;62848;0;9569;VERDADERO;VERDADERO;-15;;;
62833;62848;0;9570;VERDADERO;VERDADERO;-15;;;
62833;62848;0;9571;VERDADERO;VERDADERO;-15;;;
62833;62868;0;9572;VERDADERO;VERDADERO;-35;;;
62865;62868;0;9573;VERDADERO;VERDADERO;-3;;;
62865;62888;0;9574;VERDADERO;VERDADERO;-23;;;
62865;62888;0;9575;VERDADERO;VERDADERO;-23;;;
62865;62888;0;9576;VERDADERO;VERDADERO;-23;;;
62865;62888;0;9577;VERDADERO;VERDADERO;-23;;;
62897;62908;0;9578;VERDADERO;VERDADERO;-11;;;
62897;62908;0;9579;VERDADERO;VERDADERO;-11;;;
62897;62928;0;9580;VERDADERO;VERDADERO;-31;;;
62897;62928;0;9581;VERDADERO;VERDADERO;-31;;;
62897;62928;0;9582;VERDADERO;VERDADERO;-31;;;
62897;62928;0;9583;VERDADERO;VERDADERO;-31;;;
62932;62928;0;9584;VERDADERO;VERDADERO;4;;;
62932;62928;0;9585;VERDADERO;VERDADERO;4;;;
62932;62948;0;9586;VERDADERO;VERDADERO;-16;;;
62932;62948;0;9587;VERDADERO;VERDADERO;-16;;;
62932;62948;0;9588;VERDADERO;VERDADERO;-16;;;
62965;62968;0;9589;VERDADERO;VERDADERO;-3;;;
62965;62968;0;9590;VERDADERO;VERDADERO;-3;;;
62965;62988;0;9591;VERDADERO;VERDADERO;-23;;;
62965;62988;0;9592;VERDADERO;VERDADERO;-23;;;
62965;63008;0;9593;VERDADERO;VERDADERO;-43;;;
62997;63008;0;9594;VERDADERO;VERDADERO;-11;;;
62997;63008;0;9595;VERDADERO;VERDADERO;-11;;;
62997;63028;0;9596;VERDADERO;VERDADERO;-31;;;
62997;63028;0;9597;VERDADERO;VERDADERO;-31;;;
62997;63048;0;9598;VERDADERO;FALSO;-51;;;
63029;63048;0;9599;VERDADERO;VERDADERO;-19;;;
63029;63048;0;9600;VERDADERO;VERDADERO;-19;;;
63029;63048;0;9601;VERDADERO;VERDADERO;-19;;;
63029;63048;0;9602;VERDADERO;VERDADERO;-19;;;
63029;63068;0;9603;VERDADERO;VERDADERO;-39;;;
63061;63068;0;9604;VERDADERO;VERDADERO;-7;;;
63061;63068;0;9605;VERDADERO;VERDADERO;-7;;;
63061;63088;0;9606;VERDADERO;VERDADERO;-27;;;
63061;63088;0;9607;VERDADERO;VERDADERO;-27;;;
63061;63108;0;9608;VERDADERO;VERDADERO;-47;;;
63097;63108;0;9609;VERDADERO;VERDADERO;-11;;;
63097;63108;0;9610;VERDADERO;VERDADERO;-11;;;
63097;63108;0;9611;VERDADERO;VERDADERO;-11;;;
63097;63128;0;9612;VERDADERO;VERDADERO;-31;;;
63097;63128;0;9613;VERDADERO;VERDADERO;-31;;;
63129;63148;0;9614;VERDADERO;VERDADERO;-19;;;
63129;63148;0;9615;VERDADERO;VERDADERO;-19;;;
63129;63148;0;9616;VERDADERO;VERDADERO;-19;;;
63129;63148;0;9617;VERDADERO;VERDADERO;-19;;;
63129;63148;0;9618;VERDADERO;VERDADERO;-19;;;
63160;63168;0;9619;VERDADERO;VERDADERO;-8;;;
63160;63168;0;9620;VERDADERO;VERDADERO;-8;;;
63160;63168;0;9621;VERDADERO;VERDADERO;-8;;;
63160;63188;0;9622;VERDADERO;VERDADERO;-28;;;
63160;63188;0;9623;VERDADERO;VERDADERO;-28;;;
63160;63208;0;9624;VERDADERO;VERDADERO;-48;;;
63197;63208;0;9625;VERDADERO;VERDADERO;-11;;;
63197;63208;0;9626;VERDADERO;VERDADERO;-11;;;
63197;63228;0;9627;VERDADERO;VERDADERO;-31;;;
63197;63228;0;9628;VERDADERO;VERDADERO;-31;;;
63197;63248;0;9629;VERDADERO;FALSO;-51;;;
63229;63248;0;9630;VERDADERO;VERDADERO;-19;;;
63229;63248;0;9631;VERDADERO;VERDADERO;-19;;;
63229;63248;0;9632;VERDADERO;VERDADERO;-19;;;
63229;63248;0;9633;VERDADERO;VERDADERO;-19;;;
63229;63268;0;9634;VERDADERO;VERDADERO;-39;;;
63261;63268;0;9635;VERDADERO;VERDADERO;-7;;;
63261;63268;0;9636;VERDADERO;VERDADERO;-7;;;
63261;63288;0;9637;VERDADERO;VERDADERO;-27;;;
63261;63288;0;9638;VERDADERO;VERDADERO;-27;;;
63261;63308;0;9639;VERDADERO;VERDADERO;-47;;;
63292;63308;0;9640;VERDADERO;VERDADERO;-16;;;
63292;63308;0;9641;VERDADERO;VERDADERO;-16;;;
63292;63328;0;9642;VERDADERO;VERDADERO;-36;;;
63292;63328;0;9643;VERDADERO;VERDADERO;-36;;;
63292;63328;0;9644;VERDADERO;VERDADERO;-36;;;
63325;63348;1;9645;VERDADERO;VERDADERO;-23;;;
63325;63348;0;9646;VERDADERO;VERDADERO;-23;;;
63325;63348;0;9647;VERDADERO;VERDADERO;-23;;;
63325;63348;0;9648;VERDADERO;VERDADERO;-23;;;
63325;63348;0;9649;VERDADERO;VERDADERO;-23;;;
63325;63368;0;9650;VERDADERO;VERDADERO;-43;;;
63360;63368;0;9651;VERDADERO;VERDADERO;-8;;;
63360;63388;0;9652;VERDADERO;VERDADERO;-28;;;
63360;63388;0;9653;VERDADERO;VERDADERO;-28;;;
63360;63388;0;9654;VERDADERO;VERDADERO;-28;;;
63392;63408;0;9655;VERDADERO;VERDADERO;-16;;;
63392;63408;0;9656;VERDADERO;VERDADERO;-16;;;
63392;63428;0;9657;VERDADERO;VERDADERO;-36;;;
63392;63428;0;9658;VERDADERO;VERDADERO;-36;;;
63392;63428;0;9659;VERDADERO;VERDADERO;-36;;;
63392;63448;0;9660;VERDADERO;FALSO;-56;;;
63425;63448;0;9661;VERDADERO;VERDADERO;-23;;;
63425;63448;0;9662;VERDADERO;VERDADERO;-23;;;
63425;63448;0;9663;VERDADERO;VERDADERO;-23;;;
63425;63448;0;9664;VERDADERO;VERDADERO;-23;;;
63425;63468;0;9665;VERDADERO;VERDADERO;-43;;;
63461;63468;0;9666;VERDADERO;VERDADERO;-7;;;
63461;63468;0;9667;VERDADERO;VERDADERO;-7;;;
63461;63488;0;9668;VERDADERO;VERDADERO;-27;;;
63461;63488;0;9669;VERDADERO;VERDADERO;-27;;;
63461;63508;0;9670;VERDADERO;VERDADERO;-47;;;
63493;63508;0;9671;VERDADERO;VERDADERO;-15;;;
63493;63508;0;9672;VERDADERO;VERDADERO;-15;;;
63493;63528;0;9673;VERDADERO;VERDADERO;-35;;;
63493;63528;0;9674;VERDADERO;VERDADERO;-35;;;
63493;63548;0;9675;VERDADERO;FALSO;-55;;;
63493;63548;0;9676;VERDADERO;FALSO;-55;;;
63529;63548;0;9677;VERDADERO;VERDADERO;-19;;;
63529;63548;0;9678;VERDADERO;VERDADERO;-19;;;
63529;63548;0;9679;VERDADERO;VERDADERO;-19;;;
63529;63548;0;9680;VERDADERO;VERDADERO;-19;;;
63529;63548;0;9681;VERDADERO;VERDADERO;-19;;;
63529;63548;0;9682;VERDADERO;VERDADERO;-19;;;
63529;63548;0;9683;VERDADERO;VERDADERO;-19;;;
63567;63548;0;9684;VERDADERO;VERDADERO;19;;;
63567;63548;0;9685;VERDADERO;VERDADERO;19;;;
63567;63548;0;9686;VERDADERO;VERDADERO;19;;;
63567;63548;0;9687;VERDADERO;VERDADERO;19;;;
63567;63568;0;9688;VERDADERO;VERDADERO;-1;;;
63597;63568;0;9689;VERDADERO;VERDADERO;29;;;
63597;63588;0;9690;VERDADERO;VERDADERO;9;;;
63597;63588;0;9691;VERDADERO;VERDADERO;9;;;
63597;63588;0;9692;VERDADERO;VERDADERO;9;;;
63629;63588;0;9693;VERDADERO;VERDADERO;41;;;
63629;63588;0;9694;VERDADERO;VERDADERO;41;;;
63629;63588;0;9695;VERDADERO;VERDADERO;41;;;
63629;63608;0;9696;VERDADERO;VERDADERO;21;;;
63629;63608;0;9697;VERDADERO;VERDADERO;21;;;
63629;63608;0;9698;VERDADERO;VERDADERO;21;;;
63664;63628;1;9699;VERDADERO;VERDADERO;36;;;
63664;63628;0;9700;VERDADERO;VERDADERO;36;;;
63664;63648;1;9701;VERDADERO;VERDADERO;16;;;
63664;63648;0;9702;VERDADERO;VERDADERO;16;;;
63664;63648;0;9703;VERDADERO;VERDADERO;16;;;
63664;63668;1;9704;VERDADERO;VERDADERO;-4;;;
63703;63668;0;9705;VERDADERO;VERDADERO;35;;;
63703;63688;0;9706;VERDADERO;VERDADERO;15;;;
63703;63688;0;9707;VERDADERO;VERDADERO;15;;;
63703;63688;0;9708;VERDADERO;VERDADERO;15;;;
63703;63708;0;9709;VERDADERO;VERDADERO;-5;;;
63733;63708;0;9710;VERDADERO;VERDADERO;25;;;
63733;63728;0;9711;VERDADERO;VERDADERO;5;;;
63733;63728;0;9712;VERDADERO;VERDADERO;5;;;
63733;63728;0;9713;VERDADERO;VERDADERO;5;;;
63733;63728;0;9714;VERDADERO;VERDADERO;5;;;
63765;63728;0;9715;VERDADERO;VERDADERO;37;;;
63765;63728;0;9716;VERDADERO;VERDADERO;37;;;
63765;63728;0;9717;VERDADERO;VERDADERO;37;;;
63765;63728;0;9718;VERDADERO;VERDADERO;37;;;
63765;63728;0;9719;VERDADERO;VERDADERO;37;;;
63797;63728;0;9720;FALSO;VERDADERO;69;;;
63797;63728;0;9721;FALSO;VERDADERO;69;;;
63797;63728;0;9722;FALSO;VERDADERO;69;;;
63797;63728;0;9723;FALSO;VERDADERO;69;;;
63797;63728;0;9724;FALSO;VERDADERO;69;;;
63797;63728;0;9725;FALSO;VERDADERO;69;;;
63797;63728;0;9726;FALSO;VERDADERO;69;;;
63797;63728;0;9727;FALSO;VERDADERO;69;;;
63840;63728;0;9728;FALSO;VERDADERO;112;;;
63840;63728;0;9729;FALSO;VERDADERO;112;;;
63840;63728;0;9730;FALSO;VERDADERO;112;;;
63840;63728;0;9731;FALSO;VERDADERO;112;;;
63866;63728;0;9732;FALSO;VERDADERO;138;;;
63866;63728;0;9733;FALSO;VERDADERO;138;;;
63866;63728;0;9734;FALSO;VERDADERO;138;;;
63866;63728;0;9735;FALSO;VERDADERO;138;;;
63866;63728;0;9736;FALSO;VERDADERO;138;;;
63897;63728;0;9737;FALSO;VERDADERO;169;;;
63897;63728;0;9738;FALSO;VERDADERO;169;;;
63897;63728;0;9739;FALSO;VERDADERO;169;;;
63897;63728;0;9740;FALSO;VERDADERO;169;;;
63897;63728;0;9741;FALSO;VERDADERO;169;;;
63928;63728;0;9742;FALSO;VERDADERO;200;;;
63928;63728;0;9743;FALSO;VERDADERO;200;;;
63928;63728;0;9744;FALSO;VERDADERO;200;;;
63928;63728;0;9745;FALSO;VERDADERO;200;;;
63928;63728;0;9746;FALSO;VERDADERO;200;;;
63928;63728;0;9747;FALSO;VERDADERO;200;;;
63928;63728;0;9748;FALSO;VERDADERO;200;;;
63966;63728;0;9749;FALSO;VERDADERO;238;;;
63966;63728;0;9750;FALSO;VERDADERO;238;;;
63966;63728;0;9751;FALSO;VERDADERO;238;;;
63966;63728;0;9752;FALSO;VERDADERO;238;;;
63992;63728;0;9753;FALSO;VERDADERO;264;;;
63992;63728;0;9754;FALSO;VERDADERO;264;;;
63992;63728;0;9755;FALSO;VERDADERO;264;;;
63992;63728;0;9756;FALSO;VERDADERO;264;;;
63992;63728;0;9757;FALSO;VERDADERO;264;;;
63992;63728;0;9758;FALSO;VERDADERO;264;;;
64029;63728;0;9759;FALSO;VERDADERO;301;;;
64029;63728;0,00E+00;9760;FALSO;VERDADERO;301;;;
64029;63728;0;9761;FALSO;VERDADERO;301;;;
64029;63728;0;9762;FALSO;VERDADERO;301;;;
64029;63728;0;9763;FALSO;VERDADERO;301;;;
64061;63728;0;9764;FALSO;VERDADERO;333;;;
64061;63728;0;9765;FALSO;VERDADERO;333;;;
64061;63728;0;9766;FALSO;VERDADERO;333;;;
64061;63728;0;9767;FALSO;VERDADERO;333;;;
64061;63728;0;9768;FALSO;VERDADERO;333;;;
64061;63728;0;9769;FALSO;VERDADERO;333;;;
64093;63728;0;9770;FALSO;VERDADERO;365;;;
64093;63728;0;9771;FALSO;VERDADERO;365;;;
64093;63728;0;9772;FALSO;VERDADERO;365;;;
64093;63728;0;9773;FALSO;VERDADERO;365;;;
64093;63728;0;9774;FALSO;VERDADERO;365;;;
64093;63728;0;9775;FALSO;VERDADERO;365;;;
64133;63728;0;9776;FALSO;VERDADERO;405;;;
64133;63728;0;9777;FALSO;VERDADERO;405;;;
64133;63728;0;9778;FALSO;VERDADERO;405;;;
64133;63728;0;9779;FALSO;VERDADERO;405;;;
64157;63728;0;9780;FALSO;VERDADERO;429;;;
64157;63728;0;9781;FALSO;VERDADERO;429;;;
64157;63728;0;9782;FALSO;VERDADERO;429;;;
64157;63728;0;9783;FALSO;VERDADERO;429;;;
64157;63728;0;9784;FALSO;VERDADERO;429;;;
64157;63728;0;9785;FALSO;VERDADERO;429;;;
64193;63728;0;9786;FALSO;VERDADERO;465;;;
64193;63728;0;9787;FALSO;VERDADERO;465;;;
64193;63728;0;9788;FALSO;VERDADERO;465;;;
64193;63728;0;9789;FALSO;VERDADERO;465;;;
64193;63728;0;9790;FALSO;VERDADERO;465;;;
64225;63728;0;9791;FALSO;VERDADERO;497;;;
64225;63728;0;9792;FALSO;VERDADERO;497;;;
64225;63728;0;9793;FALSO;VERDADERO;497;;;
64225;63728;0;9794;FALSO;VERDADERO;497;;;
64225;63728;0;9795;FALSO;VERDADERO;497;;;
64225;63728;0;9796;FALSO;VERDADERO;497;;;
64261;63728;0;9797;FALSO;VERDADERO;533;;;
64261;63728;0;9798;FALSO;VERDADERO;533;;;
64261;63728;0;9799;FALSO;VERDADERO;533;;;
64261;63728;0;9800;FALSO;VERDADERO;533;;;
64261;63728;0;9801;FALSO;VERDADERO;533;;;
64261;63728;0;9802;FALSO;VERDADERO;533;;;
64293;63728;0;9803;FALSO;VERDADERO;565;;;
64293;63728;0;9804;FALSO;VERDADERO;565;;;
64293;63728;0;9805;FALSO;VERDADERO;565;;;
64293;63728;0;9806;FALSO;VERDADERO;565;;;
64293;63728;0;9807;FALSO;VERDADERO;565;;;
64293;63728;0;9808;FALSO;VERDADERO;565;;;
64330;63728;0;9809;FALSO;VERDADERO;602;;;
64330;63728;0,00E+00;9810;FALSO;VERDADERO;602;;;
64330;63728;0;9811;FALSO;VERDADERO;602;;;
64330;63728;0;9812;FALSO;VERDADERO;602;;;
64330;63728;0;9813;FALSO;VERDADERO;602;;;
64361;63728;0;9814;FALSO;VERDADERO;633;;;
64361;63728;0;9815;FALSO;VERDADERO;633;;;
64361;63728;0;9816;FALSO;VERDADERO;633;;;
64361;63728;0;9817;FALSO;VERDADERO;633;;;
64361;63728;0;9818;FALSO;VERDADERO;633;;;
64393;63728;0;9819;FALSO;VERDADERO;665;;;
64393;63728;0;9820;FALSO;VERDADERO;665;;;
64393;63728;0;9821;FALSO;VERDADERO;665;;;
64393;63728;0;9822;FALSO;VERDADERO;665;;;
64393;63728;0;9823;FALSO;VERDADERO;665;;;
64393;63728;0;9824;FALSO;VERDADERO;665;;;
64429;63728;0;9825;FALSO;VERDADERO;701;;;
64429;63728;0;9826;FALSO;VERDADERO;701;;;
64429;63728;0;9827;FALSO;VERDADERO;701;;;
64429;63728;0;9828;FALSO;VERDADERO;701;;;
64429;63728;0;9829;FALSO;VERDADERO;701;;;
64429;63728;0;9830;FALSO;VERDADERO;701;;;
64460;63728;0;9831;FALSO;VERDADERO;732;;;
64460;63728;0;9832;FALSO;VERDADERO;732;;;
64460;63728;0;9833;FALSO;VERDADERO;732;;;
64460;63728;0;9834;FALSO;VERDADERO;732;;;
64460;63728;0;9835;FALSO;VERDADERO;732;;;
64493;63728;0;9836;FALSO;VERDADERO;765;;;
64493;63728;0;9837;FALSO;VERDADERO;765;;;
64493;63728;0;9838;FALSO;VERDADERO;765;;;
64493;63728;0;9839;FALSO;VERDADERO;765;;;
64493;63728;0;9840;FALSO;VERDADERO;765;;;
64525;63728;0;9841;FALSO;VERDADERO;797;;;
64525;63728;0;9842;FALSO;VERDADERO;797;;;
64525;63728;0;9843;FALSO;VERDADERO;797;;;
64525;63728;0;9844;FALSO;VERDADERO;797;;;
64525;63728;0;9845;FALSO;VERDADERO;797;;;
64557;63728;0;9846;FALSO;VERDADERO;829;;;
64557;63728;0;9847;FALSO;VERDADERO;829;;;
64557;63728;0;9848;FALSO;VERDADERO;829;;;
64557;63728;0;9849;FALSO;VERDADERO;829;;;
64557;63728;0;9850;FALSO;VERDADERO;829;;;
64557;63728;0;9851;FALSO;VERDADERO;829;;;
64593;63728;0;9852;FALSO;VERDADERO;865;;;
64593;63728;0;9853;FALSO;VERDADERO;865;;;
64593;63728;0;9854;FALSO;VERDADERO;865;;;
64593;63728;0;9855;FALSO;VERDADERO;865;;;
64593;63728;0;9856;FALSO;VERDADERO;865;;;
64593;63728;0;9857;FALSO;VERDADERO;865;;;
64625;63728;0;9858;FALSO;VERDADERO;897;;;
64625;63728;0;9859;FALSO;VERDADERO;897;;;
64625;63728;0;9860;FALSO;VERDADERO;897;;;
64625;63728;0;9861;FALSO;VERDADERO;897;;;
64625;63728;0;9862;FALSO;VERDADERO;897;;;
64657;63728;0;9863;FALSO;VERDADERO;929;;;
64657;63728;0;9864;FALSO;VERDADERO;929;;;
64657;63728;0;9865;FALSO;VERDADERO;929;;;
64657;63728;0;9866;FALSO;VERDADERO;929;;;
64657;63728;0;9867;FALSO;VERDADERO;929;;;
64657;63728;0;9868;FALSO;VERDADERO;929;;;
64693;63728;0;9869;FALSO;VERDADERO;965;;;
64693;63728;0;9870;FALSO;VERDADERO;965;;;
64693;63728;0;9871;FALSO;VERDADERO;965;;;
64693;63728;0;9872;FALSO;VERDADERO;965;;;
64693;63728;0;9873;FALSO;VERDADERO;965;;;
64725;63728;0;9874;FALSO;VERDADERO;997;;;
64725;63728;0;9875;FALSO;VERDADERO;997;;;
64725;63728;0;9876;FALSO;VERDADERO;997;;;
64725;63728;0;9877;FALSO;VERDADERO;997;;;
64725;63728;0;9878;FALSO;VERDADERO;997;;;
64725;63728;0;9879;FALSO;VERDADERO;997;;;
64761;63728;0;9880;FALSO;VERDADERO;1033;;;
64761;63728;0;9881;FALSO;VERDADERO;1033;;;
64761;63728;0;9882;FALSO;VERDADERO;1033;;;
64761;63728;0;9883;FALSO;VERDADERO;1033;;;
64761;63728;0;9884;FALSO;VERDADERO;1033;;;
64761;63728;0;9885;FALSO;VERDADERO;1033;;;
64793;63728;0;9886;FALSO;VERDADERO;1065;;;
64793;63728;0;9887;FALSO;VERDADERO;1065;;;
64793;63728;0;9888;FALSO;VERDADERO;1065;;;
64793;63728;0;9889;FALSO;VERDADERO;1065;;;
64793;63728;0;9890;FALSO;VERDADERO;1065;;;
64828;63728;0;9891;FALSO;VERDADERO;1100;;;
64828;63728;0;9892;FALSO;VERDADERO;1100;;;
64828;63728;0;9893;FALSO;VERDADERO;1100;;;
64828;63728;0;9894;FALSO;VERDADERO;1100;;;
64828;63728;0;9895;FALSO;VERDADERO;1100;;;
64828;63728;0;9896;FALSO;VERDADERO;1100;;;
64861;63728;0;9897;FALSO;VERDADERO;1133;;;
64861;63728;0;9898;FALSO;VERDADERO;1133;;;
64861;63728;0;9899;FALSO;VERDADERO;1133;;;
64861;63728;0;9900;FALSO;VERDADERO;1133;;;
64861;63728;0;9901;FALSO;VERDADERO;1133;;;
64897;63728;0;9902;FALSO;VERDADERO;1169;;;
64897;63728;0;9903;FALSO;VERDADERO;1169;;;
64897;63728;0;9904;FALSO;VERDADERO;1169;;;
64897;63728;0;9905;FALSO;VERDADERO;1169;;;
64897;63728;0;9906;FALSO;VERDADERO;1169;;;
64897;63728;0;9907;FALSO;VERDADERO;1169;;;
64929;63728;0;9908;FALSO;VERDADERO;1201;;;
64929;63728;0;9909;FALSO;VERDADERO;1201;;;
64929;63728;0;9910;FALSO;VERDADERO;1201;;;
64929;63728;0;9911;FALSO;VERDADERO;1201;;;
64929;63728;0;9912;FALSO;VERDADERO;1201;;;
64929;63728;0;9913;FALSO;VERDADERO;1201;;;
64964;63728;0;9914;FALSO;VERDADERO;1236;;;
64964;63728;0;9915;FALSO;VERDADERO;1236;;;
64964;63728;0;9916;FALSO;VERDADERO;1236;;;
64964;63728;0;9917;FALSO;VERDADERO;1236;;;
64964;63728;0;9918;FALSO;VERDADERO;1236;;;
64997;63728;0;9919;FALSO;VERDADERO;1269;;;
64997;63728;0;9920;FALSO;VERDADERO;1269;;;
64997;63728;0;9921;FALSO;VERDADERO;1269;;;
64997;63728;0;9922;FALSO;VERDADERO;1269;;;
64997;63728;0;9923;FALSO;VERDADERO;1269;;;
65029;63728;0;9924;FALSO;VERDADERO;1301;;;
65029;63728;0;9925;FALSO;VERDADERO;1301;;;
65029;63728;0;9926;FALSO;VERDADERO;1301;;;
65029;63728;0;9927;FALSO;VERDADERO;1301;;;
65029;63728;0;9928;FALSO;VERDADERO;1301;;;
65029;63728;0;9929;FALSO;VERDADERO;1301;;;
65063;63728;0;9930;FALSO;VERDADERO;1335;;;
65063;63728;0;9931;FALSO;VERDADERO;1335;;;
65063;63728;0;9932;FALSO;VERDADERO;1335;;;
65063;63728;0;9933;FALSO;VERDADERO;1335;;;
65063;63728;0;9934;FALSO;VERDADERO;1335;;;
65092;63728;0;9935;FALSO;VERDADERO;1364;;;
65092;63728;0;9936;FALSO;VERDADERO;1364;;;
65092;63728;0;9937;FALSO;VERDADERO;1364;;;
65092;63728;0;9938;FALSO;VERDADERO;1364;;;
65092;63728;0;9939;FALSO;VERDADERO;1364;;;
65092;63728;0;9940;FALSO;VERDADERO;1364;;;
65129;63728;0;9941;FALSO;VERDADERO;1401;;;
65129;63728;0;9942;FALSO;VERDADERO;1401;;;
65129;63728;0;9943;FALSO;VERDADERO;1401;;;
65129;63728;0;9944;FALSO;VERDADERO;1401;;;
65129;63728;0;9945;FALSO;VERDADERO;1401;;;
65161;63728;0;9946;FALSO;VERDADERO;1433;;;
65161;63728;0;9947;FALSO;VERDADERO;1433;;;
65161;63728;0;9948;FALSO;VERDADERO;1433;;;
65161;63728;0;9949;FALSO;VERDADERO;1433;;;
65161;63728;0;9950;FALSO;VERDADERO;1433;;;
65161;63728;0;9951;FALSO;VERDADERO;1433;;;
65200;63728;0;9952;FALSO;VERDADERO;1472;;;
65200;63728;0;9953;FALSO;VERDADERO;1472;;;
65200;63728;0;9954;FALSO;VERDADERO;1472;;;
65200;63728;0;9955;FALSO;VERDADERO;1472;;;
65200;63728;0;9956;FALSO;VERDADERO;1472;;;
65225;63728;0;9957;FALSO;VERDADERO;1497;;;
65225;63728;0;9958;FALSO;VERDADERO;1497;;;
65225;63728;0;9959;FALSO;VERDADERO;1497;;;
65225;63728;0;9960;FALSO;VERDADERO;1497;;;
65225;63728;0;9961;FALSO;VERDADERO;1497;;;
65257;63728;0;9962;FALSO;VERDADERO;1529;;;
65257;63728;0;9963;FALSO;VERDADERO;1529;;;
65257;63728;0;9964;FALSO;VERDADERO;1529;;;
65257;63728;0;9965;FALSO;VERDADERO;1529;;;
65257;63728;0;9966;FALSO;VERDADERO;1529;;;
65289;63728;0;9967;FALSO;VERDADERO;1561;;;
65289;63728;0;9968;FALSO;VERDADERO;1561;;;
65289;63728;0;9969;FALSO;VERDADERO;1561;;;
65289;63728;0;9970;FALSO;VERDADERO;1561;;;
65289;63728;0;9971;FALSO;VERDADERO;1561;;;
65289;63728;0;9972;FALSO;VERDADERO;1561;;;
65321;63728;0;9973;FALSO;VERDADERO;1593;;;
65321;63728;0;9974;FALSO;VERDADERO;1593;;;
65321;63728;0;9975;FALSO;VERDADERO;1593;;;
65321;63728;0;9976;FALSO;VERDADERO;1593;;;
65321;63728;0;9977;FALSO;VERDADERO;1593;;;
65321;63728;0;9978;FALSO;VERDADERO;1593;;;
65357;63728;0;9979;FALSO;VERDADERO;1629;;;
65357;63728;0;9980;FALSO;VERDADERO;1629;;;
65357;63728;0;9981;FALSO;VERDADERO;1629;;;
65357;63728;0;9982;FALSO;VERDADERO;1629;;;
65357;63728;0;9983;FALSO;VERDADERO;1629;;;
65389;63728;0;9984;FALSO;VERDADERO;1661;;;
65389;63728;0;9985;FALSO;VERDADERO;1661;;;
65389;63728;0;9986;FALSO;VERDADERO;1661;;;
65389;63728;0;9987;FALSO;VERDADERO;1661;;;
65389;63728;0;9988;FALSO;VERDADERO;1661;;;
65389;63728;0;9989;FALSO;VERDADERO;1661;;;
65422;63728;0;9990;FALSO;VERDADERO;1694;;;
65422;63728;0;9991;FALSO;VERDADERO;1694;;;
65422;63728;0;9992;FALSO;VERDADERO;1694;;;
65422;63728;0;9993;FALSO;VERDADERO;1694;;;
65422;63728;0;9994;FALSO;VERDADERO;1694;;;
65457;63728;0;9995;FALSO;VERDADERO;1729;;;
65457;63728;0;9996;FALSO;VERDADERO;1729;;;
65457;63728;0;9997;FALSO;VERDADERO;1729;;;
65457;63728;0;9998;FALSO;VERDADERO;1729;;;
65457;63728;0;9999;FALSO;VERDADERO;1729;;;
65457;63728;0;10000;FALSO;VERDADERO;1729;;;
65489;63728;0;10001;FALSO;VERDADERO;1761;;;
65489;63728;0;10002;FALSO;VERDADERO;1761;;;
65489;63728;0;10003;FALSO;VERDADERO;1761;;;
65489;63728;0;10004;FALSO;VERDADERO;1761;;;
65489;63728;0;10005;FALSO;VERDADERO;1761;;;
65489;63728;0;10006;FALSO;VERDADERO;1761;;;
65525;63728;0;10007;FALSO;VERDADERO;1797;;;
65525;63728;0;10008;FALSO;VERDADERO;1797;;;
65525;63728;0;10009;FALSO;VERDADERO;1797;;;
65525;63728;0;10010;FALSO;VERDADERO;1797;;;
65525;63728;0;10011;FALSO;VERDADERO;1797;;;
65557;63728;0;10012;FALSO;VERDADERO;1829;;;
65557;63728;0;10013;FALSO;VERDADERO;1829;;;
65557;63728;0;10014;FALSO;VERDADERO;1829;;;
65557;63728;0;10015;FALSO;VERDADERO;1829;;;
65557;63728;0;10016;FALSO;VERDADERO;1829;;;
65557;63728;0;10017;FALSO;VERDADERO;1829;;;
65593;63728;0;10018;FALSO;VERDADERO;1865;;;
65593;63728;0;10019;FALSO;VERDADERO;1865;;;
65593;63728;0;10020;FALSO;VERDADERO;1865;;;
65593;63728;0;10021;FALSO;VERDADERO;1865;;;
65593;63728;0;10022;FALSO;VERDADERO;1865;;;
65625;63728;0;10023;FALSO;VERDADERO;1897;;;
65625;63728;0;10024;FALSO;VERDADERO;1897;;;
65625;63728;0;10025;FALSO;VERDADERO;1897;;;
65625;63728;0;10026;FALSO;VERDADERO;1897;;;
65625;63728;0;10027;FALSO;VERDADERO;1897;;;
65625;63728;0;10028;FALSO;VERDADERO;1897;;;
65657;63728;0;10029;FALSO;VERDADERO;1929;;;
65657;63728;0;10030;FALSO;VERDADERO;1929;;;
65657;63728;0;10031;FALSO;VERDADERO;1929;;;
65657;63728;0;10032;FALSO;VERDADERO;1929;;;
65657;63728;0;10033;FALSO;VERDADERO;1929;;;
65657;63728;0;10034;FALSO;VERDADERO;1929;;;
65692;63728;0;10035;FALSO;VERDADERO;1964;;;
65692;63728;0;10036;FALSO;VERDADERO;1964;;;
65692;63728;0;10037;FALSO;VERDADERO;1964;;;
65692;63728;0;10038;FALSO;VERDADERO;1964;;;
65692;63728;0;10039;FALSO;VERDADERO;1964;;;
65725;63728;0;10040;FALSO;VERDADERO;1997;;;
65725;63728;0;10041;FALSO;VERDADERO;1997;;;
65725;63728;0;10042;FALSO;VERDADERO;1997;;;
65725;63728;0;10043;FALSO;VERDADERO;1997;;;
65725;63728;0;10044;FALSO;VERDADERO;1997;;;
65725;63728;0;10045;FALSO;VERDADERO;1997;;;
65761;63728;0;10046;FALSO;VERDADERO;2033;;;
65761;63728;0;10047;FALSO;VERDADERO;2033;;;
65761;63728;0;10048;FALSO;VERDADERO;2033;;;
65761;63728;0;10049;FALSO;VERDADERO;2033;;;
65761;63728;0;10050;FALSO;VERDADERO;2033;;;
65792;63728;0;10051;FALSO;VERDADERO;2064;;;
65792;63728;0;10052;FALSO;VERDADERO;2064;;;
65792;63728;0;10053;FALSO;VERDADERO;2064;;;
65792;63728;0;10054;FALSO;VERDADERO;2064;;;
65792;63728;0;10055;FALSO;VERDADERO;2064;;;
65792;63728;0;10056;FALSO;VERDADERO;2064;;;
65825;63728;0;10057;FALSO;VERDADERO;2097;;;
65825;63728;0;10058;FALSO;VERDADERO;2097;;;
65825;63728;0;10059;FALSO;VERDADERO;2097;;;
65825;63728;0;10060;FALSO;VERDADERO;2097;;;
65825;63728;0;10061;FALSO;VERDADERO;2097;;;
65825;63728;0;10062;FALSO;VERDADERO;2097;;;
65861;63728;0;10063;FALSO;VERDADERO;2133;;;
65861;63728;0;10064;FALSO;VERDADERO;2133;;;
65861;63728;0;10065;FALSO;VERDADERO;2133;;;
65861;63728;0;10066;FALSO;VERDADERO;2133;;;
65861;63728;0;10067;FALSO;VERDADERO;2133;;;
65893;63728;0;10068;FALSO;VERDADERO;2165;;;
65893;63728;0;10069;FALSO;VERDADERO;2165;;;
65893;63728;0;10070;FALSO;VERDADERO;2165;;;
65893;63728;0;10071;FALSO;VERDADERO;2165;;;
65893;63728;0;10072;FALSO;VERDADERO;2165;;;
65925;63728;0;10073;FALSO;VERDADERO;2197;;;
65925;63728;0;10074;FALSO;VERDADERO;2197;;;
65925;63728;0;10075;FALSO;VERDADERO;2197;;;
65925;63728;0;10076;FALSO;VERDADERO;2197;;;
65925;63728;0;10077;FALSO;VERDADERO;2197;;;
65925;63728;0;10078;FALSO;VERDADERO;2197;;;
65961;63728;0;10079;FALSO;VERDADERO;2233;;;
65961;63728;0;10080;FALSO;VERDADERO;2233;;;
65961;63728;0;10081;FALSO;VERDADERO;2233;;;
65961;63728;0;10082;FALSO;VERDADERO;2233;;;
65961;63728;0;10083;FALSO;VERDADERO;2233;;;
65993;63728;0;10084;FALSO;VERDADERO;2265;;;
65993;63728;0;10085;FALSO;VERDADERO;2265;;;
65993;63728;0;10086;FALSO;VERDADERO;2265;;;
65993;63728;0;10087;FALSO;VERDADERO;2265;;;
65993;63728;0;10088;FALSO;VERDADERO;2265;;;
66025;63728;0;10089;FALSO;VERDADERO;2297;;;
66025;63728;0;10090;FALSO;VERDADERO;2297;;;
66025;63728;0;10091;FALSO;VERDADERO;2297;;;
66025;63728;0;10092;FALSO;VERDADERO;2297;;;
66025;63728;0;10093;FALSO;VERDADERO;2297;;;
66025;63728;0;10094;FALSO;VERDADERO;2297;;;
66057;63728;0;10095;FALSO;VERDADERO;2329;;;
66057;63728;0;10096;FALSO;VERDADERO;2329;;;
66057;63728;0;10097;FALSO;VERDADERO;2329;;;
66057;63728;0;10098;FALSO;VERDADERO;2329;;;
66057;63728;0;10099;FALSO;VERDADERO;2329;;;
66089;63728;0;10100;FALSO;VERDADERO;2361;;;
66089;63728;0;10101;FALSO;VERDADERO;2361;;;
66089;63728;0;10102;FALSO;VERDADERO;2361;;;
66089;63728;0;10103;FALSO;VERDADERO;2361;;;
66089;63728;0;10104;FALSO;VERDADERO;2361;;;
66089;63728;0;10105;FALSO;VERDADERO;2361;;;
66125;63728;0;10106;FALSO;VERDADERO;2397;;;
66125;63728;0;10107;FALSO;VERDADERO;2397;;;
66125;63728;0;10108;FALSO;VERDADERO;2397;;;
66125;63728;0;10109;FALSO;VERDADERO;2397;;;
66125;63728;0;10110;FALSO;VERDADERO;2397;;;
66157;63728;0;10111;FALSO;VERDADERO;2429;;;
66157;63728;0;10112;FALSO;VERDADERO;2429;;;
66157;63728;0;10113;FALSO;VERDADERO;2429;;;
66157;63728;0;10114;FALSO;VERDADERO;2429;;;
66157;63728;0;10115;FALSO;VERDADERO;2429;;;
66157;63728;0;10116;FALSO;VERDADERO;2429;;;
66188;63728;0;10117;FALSO;VERDADERO;2460;;;
66188;63728;0;10118;FALSO;VERDADERO;2460;;;
66188;63728;0;10119;FALSO;VERDADERO;2460;;;
66188;63728;0;10120;FALSO;VERDADERO;2460;;;
66188;63728;0;10121;FALSO;VERDADERO;2460;;;
66221;63728;0;10122;FALSO;VERDADERO;2493;;;
66221;63728;0;10123;FALSO;VERDADERO;2493;;;
66221;63728;0;10124;FALSO;VERDADERO;2493;;;
66221;63728;0;10125;FALSO;VERDADERO;2493;;;
66221;63728;0;10126;FALSO;VERDADERO;2493;;;
66254;63728;0;10127;FALSO;VERDADERO;2526;;;
66254;63728;0;10128;FALSO;VERDADERO;2526;;;
66254;63728;0;10129;FALSO;VERDADERO;2526;;;
66254;63728;0;10130;FALSO;VERDADERO;2526;;;
66254;63728;0;10131;FALSO;VERDADERO;2526;;;
66254;63728;0;10132;FALSO;VERDADERO;2526;;;
66289;63728;0;10133;FALSO;VERDADERO;2561;;;
66289;63728;0;10134;FALSO;VERDADERO;2561;;;
66289;63728;0;10135;FALSO;VERDADERO;2561;;;
66289;63728;0;10136;FALSO;VERDADERO;2561;;;
66289;63728;0;10137;FALSO;VERDADERO;2561;;;
66320;63728;0;10138;FALSO;VERDADERO;2592;;;
66320;63728;0;10139;FALSO;VERDADERO;2592;;;
66320;63728;0;10140;FALSO;VERDADERO;2592;;;
66320;63728;0;10141;FALSO;VERDADERO;2592;;;
66320;63728;0;10142;FALSO;VERDADERO;2592;;;
66320;63728;0;10143;FALSO;VERDADERO;2592;;;
66357;63728;0;10144;FALSO;VERDADERO;2629;;;
66357;63728;0;10145;FALSO;VERDADERO;2629;;;
66357;63728;0;10146;FALSO;VERDADERO;2629;;;
66357;63728;0;10147;FALSO;VERDADERO;2629;;;
66357;63728;0;10148;FALSO;VERDADERO;2629;;;
66357;63728;0;10149;FALSO;VERDADERO;2629;;;
66388;63728;0;10150;FALSO;VERDADERO;2660;;;
66388;63728;0;10151;FALSO;VERDADERO;2660;;;
66388;63728;0;10152;FALSO;VERDADERO;2660;;;
66388;63728;0;10153;FALSO;VERDADERO;2660;;;
66388;63728;0;10154;FALSO;VERDADERO;2660;;;
66425;63728;0;10155;FALSO;VERDADERO;2697;;;
66425;63728;0;10156;FALSO;VERDADERO;2697;;;
66425;63728;0;10157;FALSO;VERDADERO;2697;;;
66425;63728;0;10158;FALSO;VERDADERO;2697;;;
66425;63728;0;10159;FALSO;VERDADERO;2697;;;
66425;63728;0;10160;FALSO;VERDADERO;2697;;;
66425;63728;0;10161;FALSO;VERDADERO;2697;;;
66425;63728;0;10162;FALSO;VERDADERO;2697;;;
66468;63728;0;10163;FALSO;VERDADERO;2740;;;
66468;63728;0;10164;FALSO;VERDADERO;2740;;;
66468;63728;0;10165;FALSO;VERDADERO;2740;;;
66468;63728;0;10166;FALSO;VERDADERO;2740;;;
66493;63728;0;10167;FALSO;VERDADERO;2765;;;
66493;63728;0;10168;FALSO;VERDADERO;2765;;;
66493;63728;0;10169;FALSO;VERDADERO;2765;;;
66493;63728;0;10170;FALSO;VERDADERO;2765;;;
66493;63728;0;10171;FALSO;VERDADERO;2765;;;
66525;63728;0;10172;FALSO;VERDADERO;2797;;;
66525;63728;0;10173;FALSO;VERDADERO;2797;;;
66525;63728;0;10174;FALSO;VERDADERO;2797;;;
66525;63728;0;10175;FALSO;VERDADERO;2797;;;
66525;63728;0;10176;FALSO;VERDADERO;2797;;;
66557;63728;0;10177;FALSO;VERDADERO;2829;;;
66557;63728;0;10178;FALSO;VERDADERO;2829;;;
66557;63728;0;10179;FALSO;VERDADERO;2829;;;
66557;63728;0;10180;FALSO;VERDADERO;2829;;;
66557;63728;0;10181;FALSO;VERDADERO;2829;;;
66557;63728;0;10182;FALSO;VERDADERO;2829;;;
66593;63728;0;10183;FALSO;VERDADERO;2865;;;
66593;63728;0;10184;FALSO;VERDADERO;2865;;;
66593;63728;0;10185;FALSO;VERDADERO;2865;;;
66593;63728;0;10186;FALSO;VERDADERO;2865;;;
66593;63728;0;10187;FALSO;VERDADERO;2865;;;
66624;63728;0;10188;FALSO;VERDADERO;2896;;;
66624;63728;0;10189;FALSO;VERDADERO;2896;;;
66624;63728;0;10190;FALSO;VERDADERO;2896;;;
66624;63728;0;10191;FALSO;VERDADERO;2896;;;
66624;63728;0;10192;FALSO;VERDADERO;2896;;;
66624;63728;0;10193;FALSO;VERDADERO;2896;;;
66661;63728;0;10194;FALSO;VERDADERO;2933;;;
66661;63728;0;10195;FALSO;VERDADERO;2933;;;
66661;63728;0;10196;FALSO;VERDADERO;2933;;;
66661;63728;0;10197;FALSO;VERDADERO;2933;;;
66661;63728;0;10198;FALSO;VERDADERO;2933;;;
66693;63728;0;10199;FALSO;VERDADERO;2965;;;
66693;63728;0;10200;FALSO;VERDADERO;2965;;;
66693;63728;0;10201;FALSO;VERDADERO;2965;;;
66693;63728;0;10202;FALSO;VERDADERO;2965;;;
66693;63728;0;10203;FALSO;VERDADERO;2965;;;
66693;63728;0;10204;FALSO;VERDADERO;2965;;;
66725;63728;0;10205;FALSO;VERDADERO;2997;;;
66725;63728;0;10206;FALSO;VERDADERO;2997;;;
66725;63728;0;10207;FALSO;VERDADERO;2997;;;
66725;63728;0;10208;FALSO;VERDADERO;2997;;;
66725;63728;0;10209;FALSO;VERDADERO;2997;;;
66757;63728;0;10210;FALSO;VERDADERO;3029;;;
66757;63728;0;10211;FALSO;VERDADERO;3029;;;
66757;63728;0;10212;FALSO;VERDADERO;3029;;;
66757;63728;0;10213;FALSO;VERDADERO;3029;;;
66757;63728;0;10214;FALSO;VERDADERO;3029;;;
66789;63728;0;10215;FALSO;VERDADERO;3061;;;
66789;63728;0;10216;FALSO;VERDADERO;3061;;;
66789;63728;0;10217;FALSO;VERDADERO;3061;;;
66789;63728;0;10218;FALSO;VERDADERO;3061;;;
66789;63728;0;10219;FALSO;VERDADERO;3061;;;
66789;63728;0;10220;FALSO;VERDADERO;3061;;;
66825;63728;0;10221;FALSO;VERDADERO;3097;;;
66825;63728;0;10222;FALSO;VERDADERO;3097;;;
66825;63728;0;10223;FALSO;VERDADERO;3097;;;
66825;63728;0;10224;FALSO;VERDADERO;3097;;;
66825;63728;0;10225;FALSO;VERDADERO;3097;;;
66825;63728;0;10226;FALSO;VERDADERO;3097;;;
66857;63728;0;10227;FALSO;VERDADERO;3129;;;
66857;63728;0;10228;FALSO;VERDADERO;3129;;;
66857;63728;0;10229;FALSO;VERDADERO;3129;;;
66857;63728;0;10230;FALSO;VERDADERO;3129;;;
66857;63728;0;10231;FALSO;VERDADERO;3129;;;
66889;63728;0;10232;FALSO;VERDADERO;3161;;;
66889;63728;0;10233;FALSO;VERDADERO;3161;;;
66889;63728;0;10234;FALSO;VERDADERO;3161;;;
66889;63728;0;10235;FALSO;VERDADERO;3161;;;
66889;63728;0;10236;FALSO;VERDADERO;3161;;;
66889;63728;0;10237;FALSO;VERDADERO;3161;;;
66927;63728;0;10238;FALSO;VERDADERO;3199;;;
66927;63728;0;10239;FALSO;VERDADERO;3199;;;
66927;63728;0;10240;FALSO;VERDADERO;3199;;;
66927;63728;0;10241;FALSO;VERDADERO;3199;;;
66927;63728;0;10242;FALSO;VERDADERO;3199;;;
66957;63728;0;10243;FALSO;VERDADERO;3229;;;
66957;63728;0;10244;FALSO;VERDADERO;3229;;;
66957;63728;0;10245;FALSO;VERDADERO;3229;;;
66957;63728;0;10246;FALSO;VERDADERO;3229;;;
66957;63728;0;10247;FALSO;VERDADERO;3229;;;
66989;63728;0;10248;FALSO;VERDADERO;3261;;;
66989;63728;0;10249;FALSO;VERDADERO;3261;;;
66989;63728;0;10250;FALSO;VERDADERO;3261;;;
66989;63728;0;10251;FALSO;VERDADERO;3261;;;
66989;63728;0;10252;FALSO;VERDADERO;3261;;;
66989;63728;0;10253;FALSO;VERDADERO;3261;;;
67025;63728;0;10254;FALSO;VERDADERO;3297;;;
67025;63728;0;10255;FALSO;VERDADERO;3297;;;
67025;63728;0;10256;FALSO;VERDADERO;3297;;;
67025;63728;0;10257;FALSO;VERDADERO;3297;;;
67025;63728;0;10258;FALSO;VERDADERO;3297;;;
67025;63728;0;10259;FALSO;VERDADERO;3297;;;
67061;63728;0;10260;FALSO;VERDADERO;3333;;;
67061;63728;0;10261;FALSO;VERDADERO;3333;;;
67061;63728;0;10262;FALSO;VERDADERO;3333;;;
67061;63728;0;10263;FALSO;VERDADERO;3333;;;
67061;63728;0;10264;FALSO;VERDADERO;3333;;;
67092;63728;0;10265;FALSO;VERDADERO;3364;;;
67092;63728;0;10266;FALSO;VERDADERO;3364;;;
67092;63728;0;10267;FALSO;VERDADERO;3364;;;
67092;63728;0;10268;FALSO;VERDADERO;3364;;;
67092;63728;0;10269;FALSO;VERDADERO;3364;;;
67092;63728;0;10270;FALSO;VERDADERO;3364;;;
67125;63728;0;10271;FALSO;VERDADERO;3397;;;
67125;63728;0;10272;FALSO;VERDADERO;3397;;;
67125;63728;0;10273;FALSO;VERDADERO;3397;;;
67125;63728;0;10274;FALSO;VERDADERO;3397;;;
67125;63728;0;10275;FALSO;VERDADERO;3397;;;
67125;63728;0;10276;FALSO;VERDADERO;3397;;;
67160;63728;0;10277;FALSO;VERDADERO;3432;;;
67160;63728;0;10278;FALSO;VERDADERO;3432;;;
67160;63728;0;10279;FALSO;VERDADERO;3432;;;
67160;63728;0;10280;FALSO;VERDADERO;3432;;;
67160;63728;0;10281;FALSO;VERDADERO;3432;;;
67160;63728;0;10282;FALSO;VERDADERO;3432;;;
67197;63728;0;10283;FALSO;VERDADERO;3469;;;
67197;63728;0;10284;FALSO;VERDADERO;3469;;;
67197;63728;0;10285;FALSO;VERDADERO;3469;;;
67197;63728;0;10286;FALSO;VERDADERO;3469;;;
67197;63728;0;10287;FALSO;VERDADERO;3469;;;
67229;63728;0;10288;FALSO;VERDADERO;3501;;;
67229;63728;0;10289;FALSO;VERDADERO;3501;;;
67229;63728;0;10290;FALSO;VERDADERO;3501;;;
67229;63728;0;10291;FALSO;VERDADERO;3501;;;
67229;63728;0;10292;FALSO;VERDADERO;3501;;;
67261;63728;0;10293;FALSO;VERDADERO;3533;;;
67261;63728;0;10294;FALSO;VERDADERO;3533;;;
67261;63728;0;10295;FALSO;VERDADERO;3533;;;
67261;63728;0;10296;FALSO;VERDADERO;3533;;;
67261;63728;0;10297;FALSO;VERDADERO;3533;;;
67261;63728;0;10298;FALSO;VERDADERO;3533;;;
67297;63728;0;10299;FALSO;VERDADERO;3569;;;
67297;63728;0;10300;FALSO;VERDADERO;3569;;;
67297;63728;0;10301;FALSO;VERDADERO;3569;;;
67297;63728;0;10302;FALSO;VERDADERO;3569;;;
67297;63728;0;10303;FALSO;VERDADERO;3569;;;
67297;63728;0;10304;FALSO;VERDADERO;3569;;;
67329;63728;0;10305;FALSO;VERDADERO;3601;;;
67329;63728;0;10306;FALSO;VERDADERO;3601;;;
67329;63728;0;10307;FALSO;VERDADERO;3601;;;
67329;63728;0;10308;FALSO;VERDADERO;3601;;;
67329;63728;0;10309;FALSO;VERDADERO;3601;;;
67361;63728;0;10310;FALSO;VERDADERO;3633;;;
67361;63728;0;10311;FALSO;VERDADERO;3633;;;
67361;63728;0;10312;FALSO;VERDADERO;3633;;;
67361;63728;0;10313;FALSO;VERDADERO;3633;;;
67361;63728;0;10314;FALSO;VERDADERO;3633;;;
67361;63728;0;10315;FALSO;VERDADERO;3633;;;
67397;63728;0;10316;FALSO;VERDADERO;3669;;;
67397;63728;0;10317;FALSO;VERDADERO;3669;;;
67397;63728;0;10318;FALSO;VERDADERO;3669;;;
67397;63728;0;10319;FALSO;VERDADERO;3669;;;
67397;63728;0;10320;FALSO;VERDADERO;3669;;;
67429;63728;0;10321;FALSO;VERDADERO;3701;;;
67429;63728;0;10322;FALSO;VERDADERO;3701;;;
67429;63728;0;10323;FALSO;VERDADERO;3701;;;
67429;63728;0;10324;FALSO;VERDADERO;3701;;;
67429;63728;0;10325;FALSO;VERDADERO;3701;;;
67429;63728;0;10326;FALSO;VERDADERO;3701;;;
67465;63728;0;10327;FALSO;VERDADERO;3737;;;
67465;63728;0;10328;FALSO;VERDADERO;3737;;;
67465;63728;0;10329;FALSO;VERDADERO;3737;;;
67465;63728;0;10330;FALSO;VERDADERO;3737;;;
67465;63728;0;10331;FALSO;VERDADERO;3737;;;
67497;63728;0;10332;FALSO;VERDADERO;3769;;;
67497;63728;0;10333;FALSO;VERDADERO;3769;;;
67497;63728;0;10334;FALSO;VERDADERO;3769;;;
67497;63728;0;10335;FALSO;VERDADERO;3769;;;
67497;63728;0;10336;FALSO;VERDADERO;3769;;;
67497;63728;0;10337;FALSO;VERDADERO;3769;;;
67529;63728;0;10338;FALSO;VERDADERO;3801;;;
67529;63728;0;10339;FALSO;VERDADERO;3801;;;
67529;63728;0;10340;FALSO;VERDADERO;3801;;;
67529;63728;0;10341;FALSO;VERDADERO;3801;;;
67529;63728;0;10342;FALSO;VERDADERO;3801;;;
67561;63728;0;10343;FALSO;VERDADERO;3833;;;
67561;63728;0;10344;FALSO;VERDADERO;3833;;;
67561;63728;0;10345;FALSO;VERDADERO;3833;;;
67561;63728;0;10346;FALSO;VERDADERO;3833;;;
67561;63728;0;10347;FALSO;VERDADERO;3833;;;
67592;63728;0;10348;FALSO;VERDADERO;3864;;;
67592;63728;0;10349;FALSO;VERDADERO;3864;;;
67592;63728;0;10350;FALSO;VERDADERO;3864;;;
67592;63728;0;10351;FALSO;VERDADERO;3864;;;
67592;63728;0;10352;FALSO;VERDADERO;3864;;;
67592;63728;0;10353;FALSO;VERDADERO;3864;;;
67592;63728;0;10354;FALSO;VERDADERO;3864;;;
67629;63728;0;10355;FALSO;VERDADERO;3901;;;
67629;63728;0;10356;FALSO;VERDADERO;3901;;;
67629;63728;0;10357;FALSO;VERDADERO;3901;;;
67629;63728;0;10358;FALSO;VERDADERO;3901;;;
67629;63728;0;10359;FALSO;VERDADERO;3901;;;
67661;63728;0;10360;FALSO;VERDADERO;3933;;;
67661;63728;0;10361;FALSO;VERDADERO;3933;;;
67661;63728;0;10362;FALSO;VERDADERO;3933;;;
67661;63728;0;10363;FALSO;VERDADERO;3933;;;
67661;63728;0;10364;FALSO;VERDADERO;3933;;;
67693;63728;0;10365;FALSO;VERDADERO;3965;;;
67693;63728;0;10366;FALSO;VERDADERO;3965;;;
67693;63728;0;10367;FALSO;VERDADERO;3965;;;
67693;63728;0;10368;FALSO;VERDADERO;3965;;;
67693;63728;0;10369;FALSO;VERDADERO;3965;;;
67693;63728;0;10370;FALSO;VERDADERO;3965;;;
67729;63728;0;10371;FALSO;VERDADERO;4001;;;
67729;63728;0;10372;FALSO;VERDADERO;4001;;;
67729;63728;0;10373;FALSO;VERDADERO;4001;;;
67729;63728;0;10374;FALSO;VERDADERO;4001;;;
67729;63728;0;10375;FALSO;VERDADERO;4001;;;
67761;63728;0;10376;FALSO;VERDADERO;4033;;;
67761;63728;0;10377;FALSO;VERDADERO;4033;;;
67761;63728;0;10378;FALSO;VERDADERO;4033;;;
67957;63909;1;10379;FALSO;VERDADERO;4048;;;
67957;63909;0;10380;FALSO;VERDADERO;4048;;;
67957;63909;0;10381;FALSO;VERDADERO;4048;;;
67993;63929;0;10382;FALSO;VERDADERO;4064;;;
67993;63929;0;10383;FALSO;VERDADERO;4064;;;
67993;63949;0;10384;FALSO;VERDADERO;4044;;;
67993;63949;0;10385;FALSO;VERDADERO;4044;;;
67993;63949;0;10386;FALSO;VERDADERO;4044;;;
68025;63969;0;10387;FALSO;VERDADERO;4056;;;
68025;63969;0;10388;FALSO;VERDADERO;4056;;;
68025;63989;0;10389;FALSO;VERDADERO;4036;;;
68025;63989;0;10390;FALSO;VERDADERO;4036;;;
68025;64009;0;10391;FALSO;VERDADERO;4016;;;
68058;64009;0;10392;FALSO;VERDADERO;4049;;;
68058;64009;0;10393;FALSO;VERDADERO;4049;;;
68058;64029;0;10394;FALSO;VERDADERO;4029;;;
68058;64029;0;10395;FALSO;VERDADERO;4029;;;
68058;64049;0;10396;FALSO;VERDADERO;4009;;;
68089;64049;0;10397;FALSO;VERDADERO;4040;;;
68089;64049;0;10398;FALSO;VERDADERO;4040;;;
68089;64069;0;10399;FALSO;VERDADERO;4020;;;
68089;64069;0;10400;FALSO;VERDADERO;4020;;;
68089;64089;0;10401;FALSO;VERDADERO;4000;;;
68120;64089;0;10402;FALSO;VERDADERO;4031;;;
68120;64089;0;10403;FALSO;VERDADERO;4031;;;
68120;64109;0;10404;FALSO;VERDADERO;4011;;;
68120;64109;0;10405;FALSO;VERDADERO;4011;;;
68120;64129;0;10406;FALSO;VERDADERO;3991;;;
68120;64129;0;10407;FALSO;VERDADERO;3991;;;
68120;64129;0;10408;FALSO;VERDADERO;3991;;;
68163;64149;0;10409;FALSO;VERDADERO;4014;;;
68163;64149;0;10410;FALSO;VERDADERO;4014;;;
68163;64169;0;10411;FALSO;VERDADERO;3994;;;
68163;64169;0;10412;FALSO;VERDADERO;3994;;;
68189;64169;0;10413;FALSO;VERDADERO;4020;;;
68189;64189;0;10414;FALSO;VERDADERO;4000;;;
68189;64189;0;10415;FALSO;VERDADERO;4000;;;
68189;64209;0;10416;FALSO;VERDADERO;3980;;;
68189;64209;0;10417;FALSO;VERDADERO;3980;;;
68220;64229;0;10418;FALSO;VERDADERO;3991;;;
68220;64229;0;10419;FALSO;VERDADERO;3991;;;
68220;64229;0;10420;FALSO;VERDADERO;3991;;;
68220;64249;0;10421;FALSO;VERDADERO;3971;;;
68220;64249;0;10422;FALSO;VERDADERO;3971;;;
68257;64269;0;10423;FALSO;VERDADERO;3988;;;
68257;64269;0;10424;FALSO;VERDADERO;3988;;;
68257;64269;0;10425;FALSO;VERDADERO;3988;;;
68257;64289;1;10426;FALSO;VERDADERO;3968;;;
68257;64289;0;10427;FALSO;VERDADERO;3968;;;
68257;64309;0;10428;FALSO;VERDADERO;3948;;;
68293;64309;0;10429;FALSO;VERDADERO;3984;;;
68293;64309;0;10430;FALSO;VERDADERO;3984;;;
68293;64329;0;10431;FALSO;VERDADERO;3964;;;
68293;64329;0;10432;FALSO;VERDADERO;3964;;;
68293;64349;0;10433;FALSO;VERDADERO;3944;;;
68325;64349;0;10434;FALSO;VERDADERO;3976;;;
68325;64369;0;10435;FALSO;VERDADERO;3956;;;
68325;64369;0;10436;FALSO;VERDADERO;3956;;;
68325;64369;0;10437;FALSO;VERDADERO;3956;;;
68357;64389;0;10438;FALSO;VERDADERO;3968;;;
68357;64389;0;10439;FALSO;VERDADERO;3968;;;
68357;64409;0;10440;FALSO;VERDADERO;3948;;;
68357;64409;0;10441;FALSO;VERDADERO;3948;;;
68357;64409;0;10442;FALSO;VERDADERO;3948;;;
68357;64429;0;10443;FALSO;VERDADERO;3928;;;
68393;64429;0;10444;FALSO;VERDADERO;3964;;;
68393;64449;0;10445;FALSO;VERDADERO;3944;;;
68393;64449;0;10446;FALSO;VERDADERO;3944;;;
68393;64449;0;10447;FALSO;VERDADERO;3944;;;
68393;64469;0;10448;FALSO;VERDADERO;3924;;;
68425;64469;0;10449;FALSO;VERDADERO;3956;;;
68425;64489;1;10450;FALSO;VERDADERO;3936;;;
68425;64489;0;10451;FALSO;VERDADERO;3936;;;
68425;64489;0;10452;FALSO;VERDADERO;3936;;;
68425;64509;0;10453;FALSO;VERDADERO;3916;;;
68457;64509;0;10454;FALSO;VERDADERO;3948;;;
68457;64529;0;10455;FALSO;VERDADERO;3928;;;
68457;64529;0;10456;FALSO;VERDADERO;3928;;;
68457;64529;0;10457;FALSO;VERDADERO;3928;;;
68457;64549;0;10458;FALSO;VERDADERO;3908;;;
68457;64549;0;10459;FALSO;VERDADERO;3908;;;
68493;64569;0;10460;FALSO;VERDADERO;3924;;;
68493;64569;0;10461;FALSO;VERDADERO;3924;;;
68493;64589;0;10462;FALSO;VERDADERO;3904;;;
68493;64589;0;10463;FALSO;VERDADERO;3904;;;
68493;64589;0;10464;FALSO;VERDADERO;3904;;;
68525;64609;0;10465;FALSO;VERDADERO;3916;;;
68525;64609;0;10466;FALSO;VERDADERO;3916;;;
68525;64629;0;10467;FALSO;VERDADERO;3896;;;
68525;64629;0;10468;FALSO;VERDADERO;3896;;;
68525;64629;0;10469;FALSO;VERDADERO;3896;;;
68557;64649;0;10470;FALSO;VERDADERO;3908;;;
68557;64649;0;10471;FALSO;VERDADERO;3908;;;
68557;64669;0;10472;FALSO;VERDADERO;3888;;;
68557;64669;0;10473;FALSO;VERDADERO;3888;;;
68557;64669;0;10474;FALSO;VERDADERO;3888;;;
68593;67929;0;10475;FALSO;VERDADERO;664;;;
68593;67929;0;10476;FALSO;VERDADERO;664;;;
68593;67949;0;10477;FALSO;VERDADERO;644;;;
68593;67949;0;10478;FALSO;VERDADERO;644;;;
68593;67949;0;10479;FALSO;VERDADERO;644;;;
68625;67969;0;10480;FALSO;VERDADERO;656;;;
68625;67969;0;10481;FALSO;VERDADERO;656;;;
68625;67989;0;10482;FALSO;VERDADERO;636;;;
68625;67989;0;10483;FALSO;VERDADERO;636;;;
68625;67989;0;10484;FALSO;VERDADERO;636;;;
68657;68009;0;10485;FALSO;VERDADERO;648;;;
68657;68009;0;10486;FALSO;VERDADERO;648;;;
68657;68029;0;10487;FALSO;VERDADERO;628;;;
68657;68029;0;10488;FALSO;VERDADERO;628;;;
68657;68049;1;10489;FALSO;VERDADERO;608;;;
68657;68049;0;10490;FALSO;VERDADERO;608;;;
68693;68049;0;10491;FALSO;VERDADERO;644;;;
68693;68069;0;10492;FALSO;VERDADERO;624;;;
68693;68069;0;10493;FALSO;VERDADERO;624;;;
68693;68089;0;10494;FALSO;VERDADERO;604;;;
68693;68089;0;10495;FALSO;VERDADERO;604;;;
68725;68089;0;10496;FALSO;VERDADERO;636;;;
68725;68109;0;10497;FALSO;VERDADERO;616;;;
68725;68109;0;10498;FALSO;VERDADERO;616;;;
68725;68129;0;10499;FALSO;VERDADERO;596;;;
68725;68129;0;10500;FALSO;VERDADERO;596;;;
68757;68129;0;10501;FALSO;VERDADERO;628;;;
68757;68149;1;10502;FALSO;VERDADERO;608;;;
68757;68149;0;10503;FALSO;VERDADERO;608;;;
68757;68169;0;10504;FALSO;VERDADERO;588;;;
68757;68169;0;10505;FALSO;VERDADERO;588;;;
68789;68169;0;10506;FALSO;VERDADERO;620;;;
68789;68189;0;10507;FALSO;VERDADERO;600;;;
68789;68189;0;10508;FALSO;VERDADERO;600;;;
68789;68209;0;10509;FALSO;VERDADERO;580;;;
68789;68209;0;10510;FALSO;VERDADERO;580;;;
68820;68229;0;10511;FALSO;VERDADERO;591;;;
68820;68229;0;10512;FALSO;VERDADERO;591;;;
68820;68229;0;10513;FALSO;VERDADERO;591;;;
68820;68249;0;10514;FALSO;VERDADERO;571;;;
68820;68249;0;10515;FALSO;VERDADERO;571;;;
68857;68269;0;10516;FALSO;VERDADERO;588;;;
68857;68269;0;10517;FALSO;VERDADERO;588;;;
68857;68269;0;10518;FALSO;VERDADERO;588;;;
68857;68289;0;10519;FALSO;VERDADERO;568;;;
68857;68289;0;10520;FALSO;VERDADERO;568;;;
68889;68309;0;10521;FALSO;VERDADERO;580;;;
68889;68309;0;10522;FALSO;VERDADERO;580;;;
68889;68309;0;10523;FALSO;VERDADERO;580;;;
68889;68329;0;10524;FALSO;VERDADERO;560;;;
68889;68329;0;10525;FALSO;VERDADERO;560;;;
68921;68349;0;10526;FALSO;VERDADERO;572;;;
68921;68349;0;10527;FALSO;VERDADERO;572;;;
68921;68349;0;10528;FALSO;VERDADERO;572;;;
68921;68369;1;10529;FALSO;VERDADERO;552;;;
68921;68369;0;10530;FALSO;VERDADERO;552;;;
68921;68389;0;10531;FALSO;VERDADERO;532;;;
68957;68389;0;10532;FALSO;VERDADERO;568;;;
68957;68389;0;10533;FALSO;VERDADERO;568;;;
68957;68409;0;10534;FALSO;VERDADERO;548;;;
68957;68409;0;10535;FALSO;VERDADERO;548;;;
68957;68429;0;10536;FALSO;VERDADERO;528;;;
68989;68429;0;10537;FALSO;VERDADERO;560;;;
68989;68429;0;10538;FALSO;VERDADERO;560;;;
68989;68449;0;10539;FALSO;VERDADERO;540;;;
68989;68449;0;10540;FALSO;VERDADERO;540;;;
68989;68469;0;10541;FALSO;VERDADERO;520;;;
69021;68469;0;10542;FALSO;VERDADERO;552;;;
69021;68469;0;10543;FALSO;VERDADERO;552;;;
69021;68489;0;10544;FALSO;VERDADERO;532;;;
69021;68489;0;10545;FALSO;VERDADERO;532;;;
69021;68509;0;10546;FALSO;VERDADERO;512;;;
69021;68509;0;10547;FALSO;VERDADERO;512;;;
69057;68509;0;10548;FALSO;VERDADERO;548;;;
69057;68529;0;10549;FALSO;VERDADERO;528;;;
69057;68529;0;10550;FALSO;VERDADERO;528;;;
69057;68549;0;10551;FALSO;VERDADERO;508;;;
69089;68549;0;10552;FALSO;VERDADERO;540;;;
69089;68549;0;10553;FALSO;VERDADERO;540;;;
69089;68569;0;10554;FALSO;VERDADERO;520;;;
69089;68569;0;10555;FALSO;VERDADERO;520;;;
69089;68589;0;10556;FALSO;VERDADERO;500;;;
69089;68589;0;10557;FALSO;VERDADERO;500;;;
69125;68589;0;10558;FALSO;VERDADERO;536;;;
69125;68609;0;10559;FALSO;VERDADERO;516;;;
69125;68609;0;10560;FALSO;VERDADERO;516;;;
69125;68629;1;10561;FALSO;VERDADERO;496;;;
69125;68629;0;10562;FALSO;VERDADERO;496;;;
69157;68629;0;10563;FALSO;VERDADERO;528;;;
69157;68649;0;10564;FALSO;VERDADERO;508;;;
69157;68649;0;10565;FALSO;VERDADERO;508;;;
69157;68669;0;10566;FALSO;VERDADERO;488;;;
69157;68669;0;10567;FALSO;VERDADERO;488;;;
69189;68689;0;10568;FALSO;VERDADERO;500;;;
69189;68689;0;10569;FALSO;VERDADERO;500;;;
69189;68689;0;10570;FALSO;VERDADERO;500;;;
69189;68709;0;10571;FALSO;VERDADERO;480;;;
69189;68709;0;10572;FALSO;VERDADERO;480;;;
69221;68729;0;10573;FALSO;VERDADERO;492;;;
69221;68729;0;10574;FALSO;VERDADERO;492;;;
69221;68729;0;10575;FALSO;VERDADERO;492;;;
69221;68749;0;10576;FALSO;VERDADERO;472;;;
69221;68749;0;10577;FALSO;VERDADERO;472;;;
69253;68769;0;10578;FALSO;VERDADERO;484;;;
69253;68769;0;10579;FALSO;VERDADERO;484;;;
69253;68769;0;10580;FALSO;VERDADERO;484;;;
69253;68789;0;10581;FALSO;VERDADERO;464;;;
69253;68789;0;10582;FALSO;VERDADERO;464;;;
69253;68809;1;10583;FALSO;VERDADERO;444;;;
69289;68809;0;10584;FALSO;VERDADERO;480;;;
69289;68809;0;10585;FALSO;VERDADERO;480;;;
69289;68829;0;10586;FALSO;VERDADERO;460;;;
69289;68829;0;10587;FALSO;VERDADERO;460;;;
69289;68849;0;10588;FALSO;VERDADERO;440;;;
69321;68849;0;10589;FALSO;VERDADERO;472;;;
69321;68869;0;10590;FALSO;VERDADERO;452;;;
69321;68869;0;10591;FALSO;VERDADERO;452;;;
69321;68869;0;10592;FALSO;VERDADERO;452;;;
69353;68889;0;10593;FALSO;VERDADERO;464;;;
69353;68889;0;10594;FALSO;VERDADERO;464;;;
69353;68909;0;10595;FALSO;VERDADERO;444;;;
69353;68909;0;10596;FALSO;VERDADERO;444;;;
69353;68909;0;10597;FALSO;VERDADERO;444;;;
69353;68929;0;10598;FALSO;VERDADERO;424;;;
69386;68929;0;10599;FALSO;VERDADERO;457;;;
69386;68949;0;10600;FALSO;VERDADERO;437;;;
69386;68949;0;10601;FALSO;VERDADERO;437;;;
69386;68949;0;10602;FALSO;VERDADERO;437;;;
69386;68969;0;10603;FALSO;VERDADERO;417;;;
69417;68969;0;10604;FALSO;VERDADERO;448;;;
69417;68989;0;10605;FALSO;VERDADERO;428;;;
69417;68989;0;10606;FALSO;VERDADERO;428;;;
69417;68989;0;10607;FALSO;VERDADERO;428;;;
69417;69009;0;10608;FALSO;VERDADERO;408;;;
69453;69009;0;10609;FALSO;VERDADERO;444;;;
69453;69029;0;10610;FALSO;VERDADERO;424;;;
69453;69029;0;10611;FALSO;VERDADERO;424;;;
69453;69029;0;10612;FALSO;VERDADERO;424;;;
69453;69049;0;10613;FALSO;VERDADERO;404;;;
69485;69049;0;10614;FALSO;VERDADERO;436;;;
69485;69069;0;10615;FALSO;VERDADERO;416;;;
69485;69069;0;10616;FALSO;VERDADERO;416;;;
69485;69069;0;10617;FALSO;VERDADERO;416;;;
69485;69089;0;10618;FALSO;VERDADERO;396;;;
69485;69089;0;10619;FALSO;VERDADERO;396;;;
69521;69109;0;10620;FALSO;VERDADERO;412;;;
69521;69109;0;10621;FALSO;VERDADERO;412;;;
69521;69109;0;10622;FALSO;VERDADERO;412;;;
69521;69129;0;10623;FALSO;VERDADERO;392;;;
69521;69129;0;10624;FALSO;VERDADERO;392;;;
69553;69149;0;10625;FALSO;VERDADERO;404;;;
69553;69149;0;10626;FALSO;VERDADERO;404;;;
69553;69169;0;10627;FALSO;VERDADERO;384;;;
69553;69169;0;10628;FALSO;VERDADERO;384;;;
69553;69169;0;10629;FALSO;VERDADERO;384;;;
69589;69189;0;10630;FALSO;VERDADERO;400;;;
69589;69189;0;10631;FALSO;VERDADERO;400;;;
69589;69209;1;10632;FALSO;VERDADERO;380;;;
69589;69209;0;10633;FALSO;VERDADERO;380;;;
69589;69209;0;10634;FALSO;VERDADERO;380;;;
69621;69229;0;10635;FALSO;VERDADERO;392;;;
69621;69229;0;10636;FALSO;VERDADERO;392;;;
69621;69249;0;10637;FALSO;VERDADERO;372;;;
69621;69249;0;10638;FALSO;VERDADERO;372;;;
69621;69249;0;10639;FALSO;VERDADERO;372;;;
69621;69269;1;10640;FALSO;VERDADERO;352;;;
69657;69269;0;10641;FALSO;VERDADERO;388;;;
69657;69289;0;10642;FALSO;VERDADERO;368;;;
69657;69289;0;10643;FALSO;VERDADERO;368;;;
69657;69309;0;10644;FALSO;VERDADERO;348;;;
69689;69309;0;10645;FALSO;VERDADERO;380;;;
69689;69309;0;10646;FALSO;VERDADERO;380;;;
69689;69329;0;10647;FALSO;VERDADERO;360;;;
69689;69329;0;10648;FALSO;VERDADERO;360;;;
69689;69349;1;10649;FALSO;VERDADERO;340;;;
69689;69349;0;10650;FALSO;VERDADERO;340;;;
69689;69349;0;10651;FALSO;VERDADERO;340;;;
69727;69369;0;10652;FALSO;VERDADERO;358;;;
69727;69369;0;10653;FALSO;VERDADERO;358;;;
69727;69389;1;10654;FALSO;VERDADERO;338;;;
69727;69389;0;10655;FALSO;VERDADERO;338;;;
69757;69389;0;10656;FALSO;VERDADERO;368;;;
69757;69409;0;10657;FALSO;VERDADERO;348;;;
69757;69409;0;10658;FALSO;VERDADERO;348;;;
69757;69429;1;10659;FALSO;VERDADERO;328;;;
69757;69429;0;10660;FALSO;VERDADERO;328;;;
69789;69429;0;10661;FALSO;VERDADERO;360;;;
69789;69449;0;10662;FALSO;VERDADERO;340;;;
69789;69449;0;10663;FALSO;VERDADERO;340;;;
69789;69469;0;10664;FALSO;VERDADERO;320;;;
69789;69469;0;10665;FALSO;VERDADERO;320;;;
69825;69489;0;10666;FALSO;VERDADERO;336;;;
69825;69489;0;10667;FALSO;VERDADERO;336;;;
69825;69489;0;10668;FALSO;VERDADERO;336;;;
69825;69509;1;10669;FALSO;VERDADERO;316;;;
69825;69509;0;10670;FALSO;VERDADERO;316;;;
69825;69529;0;10671;FALSO;VERDADERO;296;;;
69857;69529;0;10672;FALSO;VERDADERO;328;;;
69857;69529;0;10673;FALSO;VERDADERO;328;;;
69857;69549;1;10674;FALSO;VERDADERO;308;;;
69857;69549;0;10675;FALSO;VERDADERO;308;;;
69857;69570;0;10676;FALSO;VERDADERO;287;;;
69888;69570;0;10677;FALSO;VERDADERO;318;;;
69888;69570;0;10678;FALSO;VERDADERO;318;;;
69888;69590;0;10679;FALSO;VERDADERO;298;;;
69888;69590;0;10680;FALSO;VERDADERO;298;;;
69888;69610;0;10681;FALSO;VERDADERO;278;;;
69924;69610;0;10682;FALSO;VERDADERO;314;;;
69924;69610;0;10683;FALSO;VERDADERO;314;;;
69924;69630;0;10684;FALSO;VERDADERO;294;;;
69924;69630;0;10685;FALSO;VERDADERO;294;;;
69924;69650;1;10686;FALSO;VERDADERO;274;;;
69957;69650;0;10687;FALSO;VERDADERO;307;;;
69957;69650;0;10688;FALSO;VERDADERO;307;;;
69957;69670;0;10689;FALSO;VERDADERO;287;;;
69957;69670;0;10690;FALSO;VERDADERO;287;;;
69957;69690;0;10691;FALSO;VERDADERO;267;;;
69989;69690;0;10692;FALSO;VERDADERO;299;;;
69989;69690;0;10693;FALSO;VERDADERO;299;;;
69989;69710;0;10694;FALSO;VERDADERO;279;;;
69989;69710;0;10695;FALSO;VERDADERO;279;;;
69989;69730;0;10696;FALSO;VERDADERO;259;;;
69989;69730;0;10697;FALSO;VERDADERO;259;;;
70025;69730;0;10698;FALSO;VERDADERO;295;;;
70025;69750;0;10699;FALSO;VERDADERO;275;;;
70025;69750;0;10700;FALSO;VERDADERO;275;;;
70025;69770;0;10701;FALSO;VERDADERO;255;;;
70025;69770;0;10702;FALSO;VERDADERO;255;;;
70057;69770;0;10703;FALSO;VERDADERO;287;;;
70057;69790;0;10704;FALSO;VERDADERO;267;;;
70057;69790;0;10705;FALSO;VERDADERO;267;;;
70057;69810;0;10706;FALSO;VERDADERO;247;;;
70057;69810;0;10707;FALSO;VERDADERO;247;;;
70089;69810;0;10708;FALSO;VERDADERO;279;;;
70089;69830;0;10709;FALSO;VERDADERO;259;;;
70089;69830;0;10710;FALSO;VERDADERO;259;;;
70089;69850;0;10711;FALSO;VERDADERO;239;;;
70089;69850;0;10712;FALSO;VERDADERO;239;;;
70125;69850;0;10713;FALSO;VERDADERO;275;;;
70125;69870;0;10714;FALSO;VERDADERO;255;;;
70125;69870;0;10715;FALSO;VERDADERO;255;;;
70125;69890;0;10716;FALSO;VERDADERO;235;;;
70125;69890;0;10717;FALSO;VERDADERO;235;;;
70157;69890;0;10718;FALSO;VERDADERO;267;;;
70157;69910;0;10719;FALSO;VERDADERO;247;;;
70157;69910;0;10720;FALSO;VERDADERO;247;;;
70157;69930;0;10721;FALSO;VERDADERO;227;;;
70157;69930;0;10722;FALSO;VERDADERO;227;;;
70189;69930;0;10723;FALSO;VERDADERO;259;;;
70189;69950;0;10724;FALSO;VERDADERO;239;;;
70189;69950;0;10725;FALSO;VERDADERO;239;;;
70189;69970;0;10726;FALSO;VERDADERO;219;;;
70189;69970;0;10727;FALSO;VERDADERO;219;;;
70189;69970;0;10728;FALSO;VERDADERO;219;;;
70221;69990;0;10729;FALSO;VERDADERO;231;;;
70221;69990;0;10730;FALSO;VERDADERO;231;;;
70221;70010;0;10731;FALSO;VERDADERO;211;;;
70221;70010;0;10732;FALSO;VERDADERO;211;;;
70221;70010;0;10733;FALSO;VERDADERO;211;;;
70252;70030;0;10734;FALSO;VERDADERO;222;;;
70252;70030;0;10735;FALSO;VERDADERO;222;;;
70252;70050;0;10736;FALSO;VERDADERO;202;;;
70252;70050;0;10737;FALSO;VERDADERO;202;;;
70252;70050;0;10738;FALSO;VERDADERO;202;;;
70288;70070;0;10739;FALSO;VERDADERO;218;;;
70288;70070;0;10740;FALSO;VERDADERO;218;;;
70288;70090;0;10741;FALSO;VERDADERO;198;;;
70288;70090;0;10742;FALSO;VERDADERO;198;;;
70288;70110;0;10743;FALSO;VERDADERO;178;;;
70322;70110;0;10744;FALSO;VERDADERO;212;;;
70322;70110;0;10745;FALSO;VERDADERO;212;;;
70322;70130;1;10746;FALSO;VERDADERO;192;;;
70322;70130;0;10747;FALSO;VERDADERO;192;;;
70322;70150;0;10748;FALSO;VERDADERO;172;;;
70353;70150;0;10749;FALSO;VERDADERO;203;;;
70353;70150;0;10750;FALSO;VERDADERO;203;;;
70353;70170;0;10751;FALSO;VERDADERO;183;;;
70353;70170;0;10752;FALSO;VERDADERO;183;;;
70353;70190;1;10753;FALSO;VERDADERO;163;;;
70384;70190;0;10754;FALSO;VERDADERO;194;;;
70384;70190;0;10755;FALSO;VERDADERO;194;;;
70384;70210;0;10756;FALSO;VERDADERO;174;;;
70384;70210;0;10757;FALSO;VERDADERO;174;;;
70384;70230;0;10758;FALSO;VERDADERO;154;;;
70416;70230;0;10759;FALSO;VERDADERO;186;;;
70416;70230;0;10760;FALSO;VERDADERO;186;;;
70416;70250;0;10761;FALSO;VERDADERO;166;;;
70416;70250;0;10762;FALSO;VERDADERO;166;;;
70416;70270;0;10763;FALSO;VERDADERO;146;;;
70416;70270;0;10764;FALSO;VERDADERO;146;;;
70452;70270;0;10765;FALSO;VERDADERO;182;;;
70452;70290;0;10766;FALSO;VERDADERO;162;;;
70452;70290;0;10767;FALSO;VERDADERO;162;;;
70452;70310;0;10768;FALSO;VERDADERO;142;;;
70452;70310;0;10769;FALSO;VERDADERO;142;;;
70485;70310;0;10770;FALSO;VERDADERO;175;;;
70485;70330;0;10771;FALSO;VERDADERO;155;;;
70485;70330;0;10772;FALSO;VERDADERO;155;;;
70485;70350;0;10773;FALSO;VERDADERO;135;;;
70485;70350;0;10774;FALSO;VERDADERO;135;;;
70516;70350;0;10775;FALSO;VERDADERO;166;;;
70516;70370;0;10776;FALSO;VERDADERO;146;;;
70516;70370;0;10777;FALSO;VERDADERO;146;;;
70516;70390;0;10778;FALSO;VERDADERO;126;;;
70516;70390;0;10779;FALSO;VERDADERO;126;;;
70549;70410;0;10780;FALSO;VERDADERO;139;;;
70549;70410;0;10781;FALSO;VERDADERO;139;;;
70549;70410;0;10782;FALSO;VERDADERO;139;;;
70549;70430;0;10783;FALSO;VERDADERO;119;;;
70549;70430;0;10784;FALSO;VERDADERO;119;;;
70581;70451;0;10785;FALSO;VERDADERO;130;;;
70581;70451;0;10786;FALSO;VERDADERO;130;;;
70581;70451;0;10787;FALSO;VERDADERO;130;;;
70581;70471;1;10788;FALSO;VERDADERO;110;;;
70581;70471;0;10789;FALSO;VERDADERO;110;;;
70617;70491;0;10790;FALSO;VERDADERO;126;;;
70617;70491;0;10791;FALSO;VERDADERO;126;;;
70617;70491;0;10792;FALSO;VERDADERO;126;;;
70617;70511;1;10793;FALSO;VERDADERO;106;;;
70617;70511;0;10794;FALSO;VERDADERO;106;;;
70648;70531;0;10795;FALSO;VERDADERO;117;;;
70648;70531;0;10796;FALSO;VERDADERO;117;;;
70648;70531;0;10797;FALSO;VERDADERO;117;;;
70648;70551;0;10798;FALSO;VERDADERO;97;;;
70648;70551;0;10799;FALSO;VERDADERO;97;;;
70648;70571;0;10800;FALSO;VERDADERO;77;;;
70648;70571;0;10801;FALSO;VERDADERO;77;;;
70648;70571;0;10802;FALSO;VERDADERO;77;;;
70648;70591;0;10803;FALSO;VERDADERO;57;;;
70648;70591;0;10804;FALSO;VERDADERO;57;;;
70648;70611;0;10805;VERDADERO;VERDADERO;37;;;
70648;70611;0;10806;VERDADERO;VERDADERO;37;;;
70648;70611;0;10807;VERDADERO;VERDADERO;37;;;
70648;70631;0;10808;VERDADERO;VERDADERO;17;;;
70648;70631;0;10809;VERDADERO;VERDADERO;17;;;
70648;70651;1;10810;VERDADERO;VERDADERO;-3;;;
70753;70651;0;10811;FALSO;VERDADERO;102;;;
70753;70651;0;10812;FALSO;VERDADERO;102;;;
70753;70671;0;10813;FALSO;VERDADERO;82;;;
70753;70671;0;10814;FALSO;VERDADERO;82;;;
70753;70691;0;10815;FALSO;VERDADERO;62;;;
70753;70691;0;10816;FALSO;VERDADERO;62;;;
70786;70711;0;10817;FALSO;VERDADERO;75;;;
70786;70711;0;10818;FALSO;VERDADERO;75;;;
70786;70711;0;10819;FALSO;VERDADERO;75;;;
70786;70731;0;10820;FALSO;VERDADERO;55;;;
70817;70731;0;10821;FALSO;VERDADERO;86;;;
70817;70751;0;10822;FALSO;VERDADERO;66;;;
70817;70751;0;10823;FALSO;VERDADERO;66;;;
70817;70751;0;10824;FALSO;VERDADERO;66;;;
70817;70771;0;10825;VERDADERO;VERDADERO;46;;;
70817;70771;0;10826;VERDADERO;VERDADERO;46;;;
70852;70791;0;10827;FALSO;VERDADERO;61;;;
70852;70791;0;10828;FALSO;VERDADERO;61;;;
70852;70791;0;10829;FALSO;VERDADERO;61;;;
70852;70811;0;10830;VERDADERO;VERDADERO;41;;;
70852;70811;0;10831;VERDADERO;VERDADERO;41;;;
70885;70831;0;10832;FALSO;VERDADERO;54;;;
70885;70831;0;10833;FALSO;VERDADERO;54;;;
70885;70831;0;10834;FALSO;VERDADERO;54;;;
70885;70851;0;10835;VERDADERO;VERDADERO;34;;;
70885;70851;0;10836;VERDADERO;VERDADERO;34;;;
70885;70871;1;10837;VERDADERO;VERDADERO;14;;;
70921;70871;0;10838;FALSO;VERDADERO;50;;;
70921;70891;0;10839;VERDADERO;VERDADERO;30;;;
70921;70891;0;10840;VERDADERO;VERDADERO;30;;;
70921;70891;0;10841;VERDADERO;VERDADERO;30;;;
70921;70911;1;10842;VERDADERO;VERDADERO;10;;;
70921;70911;0;10843;VERDADERO;VERDADERO;10;;;
70957;70931;0;10844;VERDADERO;VERDADERO;26;;;
70957;70931;0;10845;VERDADERO;VERDADERO;26;;;
70957;70931;0;10846;VERDADERO;VERDADERO;26;;;
70957;70951;0;10847;VERDADERO;VERDADERO;6;;;
70989;70951;0;10848;VERDADERO;VERDADERO;38;;;
70989;70971;0;10849;VERDADERO;VERDADERO;18;;;
70989;70971;0;10850;VERDADERO;VERDADERO;18;;;
70989;70971;0;10851;VERDADERO;VERDADERO;18;;;
70989;70991;0;10852;VERDADERO;VERDADERO;-2;;;
70989;70991;0;10853;VERDADERO;VERDADERO;-2;;;
71021;71011;1;10854;VERDADERO;VERDADERO;10;;;
71021;71011;0;10855;VERDADERO;VERDADERO;10;;;
71021;71011;0;10856;VERDADERO;VERDADERO;10;;;
71021;71031;0;10857;VERDADERO;VERDADERO;-10;;;
71021;71031;0;10858;VERDADERO;VERDADERO;-10;;;
71053;71052;0;10859;VERDADERO;VERDADERO;1;;;
71053;71052;0;10860;VERDADERO;VERDADERO;1;;;
71053;71052;0;10861;VERDADERO;VERDADERO;1;;;
71053;71072;0;10862;VERDADERO;VERDADERO;-19;;;
71085;71072;0;10863;VERDADERO;VERDADERO;13;;;
71085;71092;0;10864;VERDADERO;VERDADERO;-7;;;
71085;71092;0;10865;VERDADERO;VERDADERO;-7;;;
71085;71092;0;10866;VERDADERO;VERDADERO;-7;;;
71085;71112;0;10867;VERDADERO;VERDADERO;-27;;;
71085;71112;0;10868;VERDADERO;VERDADERO;-27;;;
71121;71132;0;10869;VERDADERO;VERDADERO;-11;;;
71121;71132;0;10870;VERDADERO;VERDADERO;-11;;;
71121;71152;0;10871;VERDADERO;VERDADERO;-31;;;
71121;71152;0;10872;VERDADERO;VERDADERO;-31;;;
71121;71152;0;10873;VERDADERO;VERDADERO;-31;;;
71153;71172;1;10874;VERDADERO;VERDADERO;-19;;;
71153;71172;0;10875;VERDADERO;VERDADERO;-19;;;
71153;71192;1;10876;VERDADERO;VERDADERO;-39;;;
71153;71192;0;10877;VERDADERO;VERDADERO;-39;;;
71153;71192;0;10878;VERDADERO;VERDADERO;-39;;;
71184;71212;1;10879;VERDADERO;VERDADERO;-28;;;
71184;71212;0;10880;VERDADERO;VERDADERO;-28;;;
71184;71212;0;10881;VERDADERO;VERDADERO;-28;;;
71184;71212;0;10882;VERDADERO;VERDADERO;-28;;;
71184;71212;0;10883;VERDADERO;VERDADERO;-28;;;
71184;71232;0;10884;VERDADERO;VERDADERO;-48;;;
71221;71232;0;10885;VERDADERO;VERDADERO;-11;;;
71221;71252;0;10886;VERDADERO;VERDADERO;-31;;;
71221;71252;0;10887;VERDADERO;VERDADERO;-31;;;
71221;71252;0;10888;VERDADERO;VERDADERO;-31;;;
71221;71252;0;10889;VERDADERO;VERDADERO;-31;;;
71252;71252;0;10890;VERDADERO;VERDADERO;0;;;
71252;71272;0;10891;VERDADERO;VERDADERO;-20;;;
71252;71272;0;10892;VERDADERO;VERDADERO;-20;;;
71252;71272;0;10893;VERDADERO;VERDADERO;-20;;;
71252;71293;0;10894;VERDADERO;VERDADERO;-41;;;
71285;71293;0;10895;VERDADERO;VERDADERO;-8;;;
71285;71313;0;10896;VERDADERO;VERDADERO;-28;;;
71285;71313;0;10897;VERDADERO;VERDADERO;-28;;;
71285;71313;0;10898;VERDADERO;VERDADERO;-28;;;
71285;71333;0;10899;VERDADERO;VERDADERO;-48;;;
71316;71333;0;10900;VERDADERO;VERDADERO;-17;;;
71316;71353;0;10901;VERDADERO;VERDADERO;-37;;;
71316;71353;0;10902;VERDADERO;VERDADERO;-37;;;
71316;71353;0;10903;VERDADERO;VERDADERO;-37;;;
71316;71353;0;10904;VERDADERO;VERDADERO;-37;;;
71350;71353;0;10905;VERDADERO;VERDADERO;-3;;;
71350;71373;0;10906;VERDADERO;VERDADERO;-23;;;
71350;71373;0;10907;VERDADERO;VERDADERO;-23;;;
71350;71393;0;10908;VERDADERO;VERDADERO;-43;;;
71350;71393;0;10909;VERDADERO;VERDADERO;-43;;;
71385;71393;0;10910;VERDADERO;VERDADERO;-8;;;
71385;71393;0;10911;VERDADERO;VERDADERO;-8;;;
71385;71393;0;10912;VERDADERO;VERDADERO;-8;;;
71385;71413;0;10913;VERDADERO;VERDADERO;-28;;;
71385;71413;0;10914;VERDADERO;VERDADERO;-28;;;
71416;71413;0;10915;VERDADERO;VERDADERO;3;;;
71416;71434;0;10916;VERDADERO;VERDADERO;-18;;;
71416;71434;0;10917;VERDADERO;VERDADERO;-18;;;
71416;71454;0;10918;VERDADERO;VERDADERO;-38;;;
71416;71454;0;10919;VERDADERO;VERDADERO;-38;;;
71416;71454;0;10920;VERDADERO;VERDADERO;-38;;;
71452;71474;0;10921;VERDADERO;VERDADERO;-22;;;
71452;71474;0;10922;VERDADERO;VERDADERO;-22;;;
71452;71494;0;10923;VERDADERO;VERDADERO;-42;;;
71452;71494;0;10924;VERDADERO;VERDADERO;-42;;;
71452;71494;0;10925;VERDADERO;VERDADERO;-42;;;
71486;71494;0;10926;VERDADERO;VERDADERO;-8;;;
71486;71494;0;10927;VERDADERO;VERDADERO;-8;;;
71486;71514;0;10928;VERDADERO;VERDADERO;-28;;;
71486;71514;0;10929;VERDADERO;VERDADERO;-28;;;
71486;71534;0;10930;VERDADERO;VERDADERO;-48;;;
71486;71534;0;10931;VERDADERO;VERDADERO;-48;;;
71521;71534;0;10932;VERDADERO;VERDADERO;-13;;;
71521;71534;0;10933;VERDADERO;VERDADERO;-13;;;
71521;71534;0;10934;VERDADERO;VERDADERO;-13;;;
71521;71554;0;10935;VERDADERO;VERDADERO;-33;;;
71521;71554;0;10936;VERDADERO;VERDADERO;-33;;;
71552;71574;0;10937;VERDADERO;VERDADERO;-22;;;
71552;71574;0;10938;VERDADERO;VERDADERO;-22;;;
71552;71574;0;10939;VERDADERO;VERDADERO;-22;;;
71552;71594;1;10940;VERDADERO;VERDADERO;-42;;;
71552;71594;0;10941;VERDADERO;VERDADERO;-42;;;
71584;71614;1;10942;VERDADERO;VERDADERO;-30;;;
71584;71614;0;10943;VERDADERO;VERDADERO;-30;;;
71584;71614;0;10944;VERDADERO;VERDADERO;-30;;;
71584;71634;1;10945;VERDADERO;FALSO;-50;;;
71584;71634;0;10946;VERDADERO;FALSO;-50;;;
71584;71634;0;10947;VERDADERO;FALSO;-50;;;
71621;71654;0;10948;VERDADERO;VERDADERO;-33;;;
71621;71654;0;10949;VERDADERO;VERDADERO;-33;;;
71621;71654;0;10950;VERDADERO;VERDADERO;-33;;;
71621;71674;0;10951;VERDADERO;FALSO;-53;;;
71621;71674;0;10952;VERDADERO;FALSO;-53;;;
71653;71674;0;10953;VERDADERO;VERDADERO;-21;;;
71653;71674;0;10954;VERDADERO;VERDADERO;-21;;;
71653;71694;0;10955;VERDADERO;VERDADERO;-41;;;
71653;71694;0;10956;VERDADERO;VERDADERO;-41;;;
71653;71694;0;10957;VERDADERO;VERDADERO;-41;;;
71685;71714;0;10958;VERDADERO;VERDADERO;-29;;;
71685;71714;0;10959;VERDADERO;VERDADERO;-29;;;
71685;71714;0;10960;VERDADERO;VERDADERO;-29;;;
71685;71714;0;10961;VERDADERO;VERDADERO;-29;;;
71685;71714;0;10962;VERDADERO;VERDADERO;-29;;;
71721;71734;0;10963;VERDADERO;VERDADERO;-13;;;
71721;71734;0;10964;VERDADERO;VERDADERO;-13;;;
71721;71754;0;10965;VERDADERO;VERDADERO;-33;;;
71721;71754;0;10966;VERDADERO;VERDADERO;-33;;;
71721;71754;0;10967;VERDADERO;VERDADERO;-33;;;
71721;71774;1;10968;VERDADERO;FALSO;-53;;;
71753;71774;0;10969;VERDADERO;VERDADERO;-21;;;
71753;71794;0;10970;VERDADERO;VERDADERO;-41;;;
71753;71794;0;10971;VERDADERO;VERDADERO;-41;;;
71753;71794;0;10972;VERDADERO;VERDADERO;-41;;;
71753;71814;0;10973;VERDADERO;FALSO;-61;;;
71785;71814;0;10974;VERDADERO;VERDADERO;-29;;;
71785;71814;0;10975;VERDADERO;VERDADERO;-29;;;
71785;71814;0;10976;VERDADERO;VERDADERO;-29;;;
71785;71834;0;10977;VERDADERO;VERDADERO;-49;;;
71785;71834;0;10978;VERDADERO;VERDADERO;-49;;;
71821;71854;0;10979;VERDADERO;VERDADERO;-33;;;
71821;71854;0;10980;VERDADERO;VERDADERO;-33;;;
71821;71854;0;10981;VERDADERO;VERDADERO;-33;;;
71821;71854;0;10982;VERDADERO;VERDADERO;-33;;;
71821;71854;0;10983;VERDADERO;VERDADERO;-33;;;
71853;71874;0;10984;VERDADERO;VERDADERO;-21;;;
71853;71874;0;10985;VERDADERO;VERDADERO;-21;;;
71853;71874;0;10986;VERDADERO;VERDADERO;-21;;;
71853;71894;0;10987;VERDADERO;VERDADERO;-41;;;
71853;71894;0;10988;VERDADERO;VERDADERO;-41;;;
71885;71894;0;10989;VERDADERO;VERDADERO;-9;;;
71885;71894;0;10990;VERDADERO;VERDADERO;-9;;;
71885;71914;0;10991;VERDADERO;VERDADERO;-29;;;
71885;71914;0;10992;VERDADERO;VERDADERO;-29;;;
71885;71914;0;10993;VERDADERO;VERDADERO;-29;;;
71885;71934;1;10994;VERDADERO;VERDADERO;-49;;;
71921;71934;0;10995;VERDADERO;VERDADERO;-13;;;
71921;71954;0;10996;VERDADERO;VERDADERO;-33;;;
71921;71954;0;10997;VERDADERO;VERDADERO;-33;;;
71921;71954;0;10998;VERDADERO;VERDADERO;-33;;;
71921;71974;0;10999;VERDADERO;FALSO;-53;;;
71953;71974;0;11000;VERDADERO;VERDADERO;-21;;;
71953;71994;0;11001;VERDADERO;VERDADERO;-41;;;
71953;71994;0;11002;VERDADERO;VERDADERO;-41;;;
71953;71994;0;11003;VERDADERO;VERDADERO;-41;;;
71953;71994;0;11004;VERDADERO;VERDADERO;-41;;;
71985;71994;0;11005;VERDADERO;VERDADERO;-9;;;
71985;72014;0;11006;VERDADERO;VERDADERO;-29;;;
71985;72014;0;11007;VERDADERO;VERDADERO;-29;;;
71985;72034;1;11008;VERDADERO;VERDADERO;-49;;;
71985;72034;0;11009;VERDADERO;VERDADERO;-49;;;
72016;72034;0;11010;VERDADERO;VERDADERO;-18;;;
72016;72034;0;11011;VERDADERO;VERDADERO;-18;;;
72016;72034;0;11012;VERDADERO;VERDADERO;-18;;;
72016;72054;0;11013;VERDADERO;VERDADERO;-38;;;
72016;72054;0;11014;VERDADERO;VERDADERO;-38;;;
72049;72054;0;11015;VERDADERO;VERDADERO;-5;;;
72049;72074;0;11016;VERDADERO;VERDADERO;-25;;;
72049;72074;0;11017;VERDADERO;VERDADERO;-25;;;
72049;72074;0;11018;VERDADERO;VERDADERO;-25;;;
72049;72074;0;11019;VERDADERO;VERDADERO;-25;;;
72085;72074;0;11020;VERDADERO;VERDADERO;11;;;
72085;72074;0;11021;VERDADERO;VERDADERO;11;;;
72085;72094;0;11022;VERDADERO;VERDADERO;-9;;;
72085;72094;0;11023;VERDADERO;VERDADERO;-9;;;
72085;72115;0;11024;VERDADERO;VERDADERO;-30;;;
72116;72115;0;11025;VERDADERO;VERDADERO;1;;;
72116;72115;0;11026;VERDADERO;VERDADERO;1;;;
72116;72135;0;11027;VERDADERO;VERDADERO;-19;;;
72116;72135;0;11028;VERDADERO;VERDADERO;-19;;;
72116;72135;0;11029;VERDADERO;VERDADERO;-19;;;
72116;72155;0;11030;VERDADERO;VERDADERO;-39;;;
72148;72155;0;11031;VERDADERO;VERDADERO;-7;;;
72148;72175;0;11032;VERDADERO;VERDADERO;-27;;;
72148;72175;0;11033;VERDADERO;VERDADERO;-27;;;
72148;72175;0;11034;VERDADERO;VERDADERO;-27;;;
72148;72195;0;11035;VERDADERO;VERDADERO;-47;;;
72182;72195;0;11036;VERDADERO;VERDADERO;-13;;;
72182;72215;0;11037;VERDADERO;VERDADERO;-33;;;
72182;72215;0;11038;VERDADERO;VERDADERO;-33;;;
72182;72215;0;11039;VERDADERO;VERDADERO;-33;;;
72182;72235;0;11040;VERDADERO;FALSO;-53;;;
72213;72235;0;11041;VERDADERO;VERDADERO;-22;;;
72213;72235;0;11042;VERDADERO;VERDADERO;-22;;;
72213;72255;1;11043;VERDADERO;VERDADERO;-42;;;
72213;72255;0;11044;VERDADERO;VERDADERO;-42;;;
72213;72255;0;11045;VERDADERO;VERDADERO;-42;;;
72250;72275;0;11046;VERDADERO;VERDADERO;-25;;;
72250;72275;0;11047;VERDADERO;VERDADERO;-25;;;
72250;72275;0;11048;VERDADERO;VERDADERO;-25;;;
72250;72275;0;11049;VERDADERO;VERDADERO;-25;;;
72250;72275;0;11050;VERDADERO;VERDADERO;-25;;;
72281;72295;0;11051;VERDADERO;VERDADERO;-14;;;
72281;72295;0;11052;VERDADERO;VERDADERO;-14;;;
72281;72315;0;11053;VERDADERO;VERDADERO;-34;;;
72281;72315;0;11054;VERDADERO;VERDADERO;-34;;;
72281;72315;0;11055;VERDADERO;VERDADERO;-34;;;
72281;72315;0;11056;VERDADERO;VERDADERO;-34;;;
72317;72315;0;11057;VERDADERO;VERDADERO;2;;;
72317;72335;0;11058;VERDADERO;VERDADERO;-18;;;
72317;72335;0;11059;VERDADERO;VERDADERO;-18;;;
72317;72356;0;11060;VERDADERO;VERDADERO;-39;;;
72317;72356;0;11061;VERDADERO;VERDADERO;-39;;;
72348;72356;0;11062;VERDADERO;VERDADERO;-8;;;
72348;72376;1;11063;VERDADERO;VERDADERO;-28;;;
72348;72376;0;11064;VERDADERO;VERDADERO;-28;;;
72348;72396;0;11065;VERDADERO;VERDADERO;-48;;;
72348;72396;0;11066;VERDADERO;VERDADERO;-48;;;
72348;72396;0;11067;VERDADERO;VERDADERO;-48;;;
72348;72416;0;11068;VERDADERO;FALSO;-68;;;
72393;72416;0;11069;VERDADERO;VERDADERO;-23;;;
72393;72416;0;11070;VERDADERO;VERDADERO;-23;;;
72393;72416;0;11071;VERDADERO;VERDADERO;-23;;;
72393;72416;0;11072;VERDADERO;VERDADERO;-23;;;
72418;72436;0;11073;VERDADERO;VERDADERO;-18;;;
72418;72436;0;11074;VERDADERO;VERDADERO;-18;;;
72418;72436;0;11075;VERDADERO;VERDADERO;-18;;;
72418;72456;0,00E+00;11076;VERDADERO;VERDADERO;-38;;;
72418;72456;0;11077;VERDADERO;VERDADERO;-38;;;
72449;72456;0;11078;VERDADERO;VERDADERO;-7;;;
72449;72456;0;11079;VERDADERO;VERDADERO;-7;;;
72449;72456;0;11080;VERDADERO;VERDADERO;-7;;;
72449;72476;0;11081;VERDADERO;VERDADERO;-27;;;
72449;72476;0;11082;VERDADERO;VERDADERO;-27;;;
72485;72496;0;11083;VERDADERO;VERDADERO;-11;;;
72485;72496;0;11084;VERDADERO;VERDADERO;-11;;;
72485;72496;0;11085;VERDADERO;VERDADERO;-11;;;
72485;72516;0;11086;VERDADERO;VERDADERO;-31;;;
72485;72516;0;11087;VERDADERO;VERDADERO;-31;;;
72485;72516;0;11088;VERDADERO;VERDADERO;-31;;;
72521;72516;0;11089;VERDADERO;VERDADERO;5;;;
72521;72516;0;11090;VERDADERO;VERDADERO;5;;;
72521;72516;0;11091;VERDADERO;VERDADERO;5;;;
72521;72516;0;11092;VERDADERO;VERDADERO;5;;;
72521;72516;0;11093;VERDADERO;VERDADERO;5;;;
72553;72516;0;11094;VERDADERO;VERDADERO;37;;;
72553;72516;0;11095;VERDADERO;VERDADERO;37;;;
72553;72516;0;11096;VERDADERO;VERDADERO;37;;;
72553;72516;0;11097;VERDADERO;VERDADERO;37;;;
72553;72536;1;11098;VERDADERO;VERDADERO;17;;;
72584;72536;0;11099;VERDADERO;VERDADERO;48;;;
72584;72536;0;11100;VERDADERO;VERDADERO;48;;;
72584;72556;0;11101;VERDADERO;VERDADERO;28;;;
72584;72556;0;11102;VERDADERO;VERDADERO;28;;;
72584;72576;0;11103;VERDADERO;VERDADERO;8;;;
72584;72576;0;11104;VERDADERO;VERDADERO;8;;;
72621;72576;0;11105;VERDADERO;VERDADERO;45;;;
72621;72596;0,00E+00;11106;VERDADERO;VERDADERO;25;;;
72621;72596;0;11107;VERDADERO;VERDADERO;25;;;
72621;72616;0;11108;VERDADERO;VERDADERO;5;;;
72621;72616;0;11109;VERDADERO;VERDADERO;5;;;
72621;72616;0;11110;VERDADERO;VERDADERO;5;;;
72656;72636;0;11111;VERDADERO;VERDADERO;20;;;
72656;72636;0;11112;VERDADERO;VERDADERO;20;;;
72656;72656;0;11113;VERDADERO;VERDADERO;0;;;
72656;72656;0;11114;VERDADERO;VERDADERO;0;;;
72656;72656;0;11115;VERDADERO;VERDADERO;0;;;
72689;72676;1;11116;VERDADERO;VERDADERO;13;;;
72689;72676;0;11117;VERDADERO;VERDADERO;13;;;
72689;72696;0;11118;VERDADERO;VERDADERO;-7;;;
72689;72696;0;11119;VERDADERO;VERDADERO;-7;;;
72689;72716;0;11120;VERDADERO;VERDADERO;-27;;;
72725;72716;0;11121;VERDADERO;VERDADERO;9;;;
72725;72716;0;11122;VERDADERO;VERDADERO;9;;;
72725;72736;1;11123;VERDADERO;VERDADERO;-11;;;
72725;72736;0;11124;VERDADERO;VERDADERO;-11;;;
72725;72756;0;11125;VERDADERO;VERDADERO;-31;;;
72757;72756;0;11126;VERDADERO;VERDADERO;1;;;
72757;72776;0;11127;VERDADERO;VERDADERO;-19;;;
72757;72776;0;11128;VERDADERO;VERDADERO;-19;;;
72757;72776;0;11129;VERDADERO;VERDADERO;-19;;;
72757;72796;0;11130;VERDADERO;VERDADERO;-39;;;
72788;72796;0;11131;VERDADERO;VERDADERO;-8;;;
72788;72816;0;11132;VERDADERO;VERDADERO;-28;;;
72788;72816;0;11133;VERDADERO;VERDADERO;-28;;;
72788;72816;0;11134;VERDADERO;VERDADERO;-28;;;
72788;72816;0;11135;VERDADERO;VERDADERO;-28;;;
72788;72816;0;11136;VERDADERO;VERDADERO;-28;;;
72825;72836;1;11137;VERDADERO;VERDADERO;-11;;;
72825;72836;0;11138;VERDADERO;VERDADERO;-11;;;
72825;72836;0;11139;VERDADERO;VERDADERO;-11;;;
72825;72856;1;11140;VERDADERO;VERDADERO;-31;;;
72825;72856;0;11141;VERDADERO;VERDADERO;-31;;;
72857;72876;0;11142;VERDADERO;VERDADERO;-19;;;
72857;72876;0;11143;VERDADERO;VERDADERO;-19;;;
72857;72876;0;11144;VERDADERO;VERDADERO;-19;;;
72857;72896;0;11145;VERDADERO;VERDADERO;-39;;;
72857;72896;0;11146;VERDADERO;VERDADERO;-39;;;
72889;72916;0;11147;VERDADERO;VERDADERO;-27;;;
72889;72916;0;11148;VERDADERO;VERDADERO;-27;;;
72889;72916;0;11149;VERDADERO;VERDADERO;-27;;;
72889;72916;0;11150;VERDADERO;VERDADERO;-27;;;
72889;72916;0;11151;VERDADERO;VERDADERO;-27;;;
72921;72936;1;11152;VERDADERO;VERDADERO;-15;;;
72921;72936;0;11153;VERDADERO;VERDADERO;-15;;;
72921;72956;0;11154;VERDADERO;VERDADERO;-35;;;
72921;72956;0;11155;VERDADERO;VERDADERO;-35;;;
72921;72956;0;11156;VERDADERO;VERDADERO;-35;;;
72953;72956;0;11157;VERDADERO;VERDADERO;-3;;;
72953;72956;0;11158;VERDADERO;VERDADERO;-3;;;
72953;72976;0;11159;VERDADERO;VERDADERO;-23;;;
72953;72976;0;11160;VERDADERO;VERDADERO;-23;;;
72953;72997;0;11161;VERDADERO;VERDADERO;-44;;;
72989;72997;0;11162;VERDADERO;VERDADERO;-8;;;
72989;72997;0;11163;VERDADERO;VERDADERO;-8;;;
72989;73017;0;11164;VERDADERO;VERDADERO;-28;;;
72989;73017;0;11165;VERDADERO;VERDADERO;-28;;;
72989;73017;0;11166;VERDADERO;VERDADERO;-28;;;
73021;73037;0;11167;VERDADERO;VERDADERO;-16;;;
73021;73037;0;11168;VERDADERO;VERDADERO;-16;;;
73021;73037;0;11169;VERDADERO;VERDADERO;-16;;;
73021;73057;0;11170;VERDADERO;VERDADERO;-36;;;
73021;73057;0;11171;VERDADERO;VERDADERO;-36;;;
73052;73057;0;11172;VERDADERO;VERDADERO;-5;;;
73052;73057;0;11173;VERDADERO;VERDADERO;-5;;;
73052;73077;1;11174;VERDADERO;VERDADERO;-25;;;
73052;73077;0;11175;VERDADERO;VERDADERO;-25;;;
73052;73077;0;11176;VERDADERO;VERDADERO;-25;;;
73052;73098;1;11177;VERDADERO;VERDADERO;-46;;;
73088;73098;0;11178;VERDADERO;VERDADERO;-10;;;
73088;73118;1;11179;VERDADERO;VERDADERO;-30;;;
73088;73118;0;11180;VERDADERO;VERDADERO;-30;;;
73088;73118;0;11181;VERDADERO;VERDADERO;-30;;;
73088;73118;0;11182;VERDADERO;VERDADERO;-30;;;
73121;73138;0;11183;VERDADERO;VERDADERO;-17;;;
73121;73138;0;11184;VERDADERO;VERDADERO;-17;;;
73121;73158;0;11185;VERDADERO;VERDADERO;-37;;;
73121;73158;0;11186;VERDADERO;VERDADERO;-37;;;
73121;73158;0;11187;VERDADERO;VERDADERO;-37;;;
73153;73158;0;11188;VERDADERO;VERDADERO;-5;;;
73153;73158;0;11189;VERDADERO;VERDADERO;-5;;;
73153;73178;0;11190;VERDADERO;VERDADERO;-25;;;
73153;73178;0;11191;VERDADERO;VERDADERO;-25;;;
73153;73178;0;11192;VERDADERO;VERDADERO;-25;;;
73153;73198;0;11193;VERDADERO;VERDADERO;-45;;;
73189;73198;0;11194;VERDADERO;VERDADERO;-9;;;
73189;73218;0;11195;VERDADERO;VERDADERO;-29;;;
73189;73218;0;11196;VERDADERO;VERDADERO;-29;;;
73189;73218;0;11197;VERDADERO;VERDADERO;-29;;;
73189;73218;0;11198;VERDADERO;VERDADERO;-29;;;
73221;73238;1;11199;VERDADERO;VERDADERO;-17;;;
73221;73238;0;11200;VERDADERO;VERDADERO;-17;;;
73221;73258;0;11201;VERDADERO;VERDADERO;-37;;;
73221;73258;0;11202;VERDADERO;VERDADERO;-37;;;
73221;73258;0;11203;VERDADERO;VERDADERO;-37;;;
73252;73258;0;11204;VERDADERO;VERDADERO;-6;;;
73252;73258;0;11205;VERDADERO;VERDADERO;-6;;;
73252;73258;0;11206;VERDADERO;VERDADERO;-6;;;
73252;73278;0;11207;VERDADERO;VERDADERO;-26;;;
73252;73278;0;11208;VERDADERO;VERDADERO;-26;;;
73285;73298;1;11209;VERDADERO;VERDADERO;-13;;;
73285;73298;0;11210;VERDADERO;VERDADERO;-13;;;
73285;73298;0;11211;VERDADERO;VERDADERO;-13;;;
73285;73318;0;11212;VERDADERO;VERDADERO;-33;;;
73285;73318;0;11213;VERDADERO;VERDADERO;-33;;;
73317;73318;0;11214;VERDADERO;VERDADERO;-1;;;
73317;73338;0;11215;VERDADERO;VERDADERO;-21;;;
73317;73338;0;11216;VERDADERO;VERDADERO;-21;;;
73317;73358;0;11217;VERDADERO;VERDADERO;-41;;;
73317;73358;0;11218;VERDADERO;VERDADERO;-41;;;
73317;73358;0;11219;VERDADERO;VERDADERO;-41;;;
73353;73378;0;11220;VERDADERO;VERDADERO;-25;;;
73353;73378;0;11221;VERDADERO;VERDADERO;-25;;;
73353;73378;0;11222;VERDADERO;VERDADERO;-25;;;
73353;73398;1;11223;VERDADERO;VERDADERO;-45;;;
73353;73398;0;11224;VERDADERO;VERDADERO;-45;;;
73385;73418;0;11225;VERDADERO;VERDADERO;-33;;;
73385;73418;0;11226;VERDADERO;VERDADERO;-33;;;
73385;73418;0;11227;VERDADERO;VERDADERO;-33;;;
73385;73418;0;11228;VERDADERO;VERDADERO;-33;;;
73385;73418;0;11229;VERDADERO;VERDADERO;-33;;;
73417;73418;0;11230;VERDADERO;VERDADERO;-1;;;
73417;73438;0;11231;VERDADERO;VERDADERO;-21;;;
73417;73438;0;11232;VERDADERO;VERDADERO;-21;;;
73417;73438;0;11233;VERDADERO;VERDADERO;-21;;;
73417;73458;0;11234;VERDADERO;VERDADERO;-41;;;
73449;73458;0;11235;VERDADERO;VERDADERO;-9;;;
73449;73458;0;11236;VERDADERO;VERDADERO;-9;;;
73449;73458;0;11237;VERDADERO;VERDADERO;-9;;;
73449;73458;0;11238;VERDADERO;VERDADERO;-9;;;
73449;73478;0;11239;VERDADERO;VERDADERO;-29;;;
73481;73478;0;11240;VERDADERO;VERDADERO;3;;;
73481;73478;0;11241;VERDADERO;VERDADERO;3;;;
73481;73498;0;11242;VERDADERO;VERDADERO;-17;;;
73481;73498;0;11243;VERDADERO;VERDADERO;-17;;;
73481;73518;0;11244;VERDADERO;VERDADERO;-37;;;
73481;73518;0;11245;VERDADERO;VERDADERO;-37;;;
73517;73518;0;11246;VERDADERO;VERDADERO;-1;;;
73517;73538;0;11247;VERDADERO;VERDADERO;-21;;;
73517;73538;0;11248;VERDADERO;VERDADERO;-21;;;
73517;73538;0;11249;VERDADERO;VERDADERO;-21;;;
73517;73558;0;11250;VERDADERO;VERDADERO;-41;;;
73549;73558;0;11251;VERDADERO;VERDADERO;-9;;;
73549;73578;0;11252;VERDADERO;VERDADERO;-29;;;
73549;73578;0;11253;VERDADERO;VERDADERO;-29;;;
73549;73578;0;11254;VERDADERO;VERDADERO;-29;;;
73549;73578;0;11255;VERDADERO;VERDADERO;-29;;;
73581;73598;0;11256;VERDADERO;VERDADERO;-17;;;
73581;73598;0;11257;VERDADERO;VERDADERO;-17;;;
73581;73618;1;11258;VERDADERO;VERDADERO;-37;;;
73581;73618;0;11259;VERDADERO;VERDADERO;-37;;;
73581;73618;0;11260;VERDADERO;VERDADERO;-37;;;
73614;73618;0;11261;VERDADERO;VERDADERO;-4;;;
73614;73618;0;11262;VERDADERO;VERDADERO;-4;;;
73614;73618;0;11263;VERDADERO;VERDADERO;-4;;;
73614;73618;0;11264;VERDADERO;VERDADERO;-4;;;
73614;73618;0;11265;VERDADERO;VERDADERO;-4;;;
73645;73618;0;11266;VERDADERO;VERDADERO;27;;;
73645;73638;0;11267;VERDADERO;VERDADERO;7;;;
73645;73638;0;11268;VERDADERO;VERDADERO;7;;;
73645;73658;0;11269;VERDADERO;VERDADERO;-13;;;
73645;73658;0;11270;VERDADERO;VERDADERO;-13;;;
73645;73678;0;11271;VERDADERO;VERDADERO;-33;;;
73680;73678;0;11272;VERDADERO;VERDADERO;2;;;
73680;73678;0;11273;VERDADERO;VERDADERO;2;;;
73680;73678;0;11274;VERDADERO;VERDADERO;2;;;
73680;73698;0;11275;VERDADERO;VERDADERO;-18;;;
73680;73698;0;11276;VERDADERO;VERDADERO;-18;;;
73713;73718;0;11277;VERDADERO;VERDADERO;-5;;;
73713;73718;0;11278;VERDADERO;VERDADERO;-5;;;
73713;73738;0;11279;VERDADERO;VERDADERO;-25;;;
73713;73738;0;11280;VERDADERO;VERDADERO;-25;;;
73713;73738;0;11281;VERDADERO;VERDADERO;-25;;;
73750;73738;0;11282;VERDADERO;VERDADERO;12;;;
73750;73758;0;11283;VERDADERO;VERDADERO;-8;;;
73750;73758;0;11284;VERDADERO;VERDADERO;-8;;;
73750;73779;0;11285;VERDADERO;VERDADERO;-29;;;
73750;73779;0;11286;VERDADERO;VERDADERO;-29;;;
73781;73779;0;11287;VERDADERO;VERDADERO;2;;;
73781;73799;0;11288;VERDADERO;VERDADERO;-18;;;
73781;73799;0;11289;VERDADERO;VERDADERO;-18;;;
73781;73799;0;11290;VERDADERO;VERDADERO;-18;;;
73781;73819;0;11291;VERDADERO;VERDADERO;-38;;;
73781;73819;0;11292;VERDADERO;VERDADERO;-38;;;
73781;73839;0;11293;VERDADERO;FALSO;-58;;;
73821;73839;0;11294;VERDADERO;VERDADERO;-18;;;
73821;73839;0;11295;VERDADERO;VERDADERO;-18;;;
73821;73859;0;11296;VERDADERO;VERDADERO;-38;;;
73821;73859;0;11297;VERDADERO;VERDADERO;-38;;;
73849;73879;0;11298;VERDADERO;VERDADERO;-30;;;
73849;73879;0;11299;VERDADERO;VERDADERO;-30;;;
73849;73879;0;11300;VERDADERO;VERDADERO;-30;;;
73849;73899;0;11301;VERDADERO;FALSO;-50;;;
73849;73899;0;11302;VERDADERO;FALSO;-50;;;
73881;73899;0;11303;VERDADERO;VERDADERO;-18;;;
73881;73899;0;11304;VERDADERO;VERDADERO;-18;;;
73881;73899;0;11305;VERDADERO;VERDADERO;-18;;;
73881;73899;0;11306;VERDADERO;VERDADERO;-18;;;
73881;73919;0;11307;VERDADERO;VERDADERO;-38;;;
73881;73919;0;11308;VERDADERO;VERDADERO;-38;;;
73916;73939;0;11309;VERDADERO;VERDADERO;-23;;;
73916;73939;0;11310;VERDADERO;VERDADERO;-23;;;
73916;73939;0;11311;VERDADERO;VERDADERO;-23;;;
73916;73939;0;11312;VERDADERO;VERDADERO;-23;;;
73916;73939;0;11313;VERDADERO;VERDADERO;-23;;;
73916;73939;0;11314;VERDADERO;VERDADERO;-23;;;
73916;73939;0;11315;VERDADERO;VERDADERO;-23;;;
73959;73939;0;11316;VERDADERO;VERDADERO;20;;;
73959;73959;0;11317;VERDADERO;VERDADERO;0;;;
73959;73959;0;11318;VERDADERO;VERDADERO;0;;;
73959;73979;0;11319;VERDADERO;VERDADERO;-20;;;
73985;73979;0;11320;VERDADERO;VERDADERO;6;;;
73985;73979;0;11321;VERDADERO;VERDADERO;6;;;
73985;73999;0;11322;VERDADERO;VERDADERO;-14;;;
73985;73999;0;11323;VERDADERO;VERDADERO;-14;;;
73985;74019;0;11324;VERDADERO;VERDADERO;-34;;;
74017;74019;0;11325;VERDADERO;VERDADERO;-2;;;
74017;74019;0;11326;VERDADERO;VERDADERO;-2;;;
74017;74039;0;11327;VERDADERO;VERDADERO;-22;;;
74017;74039;0;11328;VERDADERO;VERDADERO;-22;;;
74017;74059;0;11329;VERDADERO;VERDADERO;-42;;;
74049;74059;0;11330;VERDADERO;VERDADERO;-10;;;
74049;74059;0;11331;VERDADERO;VERDADERO;-10;;;
74049;74079;0;11332;VERDADERO;VERDADERO;-30;;;
74049;74079;0;11333;VERDADERO;VERDADERO;-30;;;
74049;74079;0;11334;VERDADERO;VERDADERO;-30;;;
74082;74099;0;11335;VERDADERO;VERDADERO;-17;;;
74082;74099;0;11336;VERDADERO;VERDADERO;-17;;;
74082;74099;0;11337;VERDADERO;VERDADERO;-17;;;
74082;74099;0;11338;VERDADERO;VERDADERO;-17;;;
74082;74099;0;11339;VERDADERO;VERDADERO;-17;;;
74082;74119;0;11340;VERDADERO;VERDADERO;-37;;;
74116;74119;0;11341;VERDADERO;VERDADERO;-3;;;
74116;74139;1;11342;VERDADERO;VERDADERO;-23;;;
74116;74139;0;11343;VERDADERO;VERDADERO;-23;;;
74116;74139;0;11344;VERDADERO;VERDADERO;-23;;;
74116;74159;0;11345;VERDADERO;VERDADERO;-43;;;
74149;74159;0;11346;VERDADERO;VERDADERO;-10;;;
74149;74159;0;11347;VERDADERO;VERDADERO;-10;;;
74149;74179;1;11348;VERDADERO;VERDADERO;-30;;;
74149;74179;0;11349;VERDADERO;VERDADERO;-30;;;
74149;74199;0;11350;VERDADERO;FALSO;-50;;;
74181;74199;0;11351;VERDADERO;VERDADERO;-18;;;
74181;74199;0;11352;VERDADERO;VERDADERO;-18;;;
74181;74199;0;11353;VERDADERO;VERDADERO;-18;;;
74181;74199;0;11354;VERDADERO;VERDADERO;-18;;;
74181;74199;0;11355;VERDADERO;VERDADERO;-18;;;
74212;74199;0;11356;VERDADERO;VERDADERO;13;;;
74212;74219;0;11357;VERDADERO;VERDADERO;-7;;;
74212;74219;0;11358;VERDADERO;VERDADERO;-7;;;
74212;74239;0;11359;VERDADERO;VERDADERO;-27;;;
74212;74239;0;11360;VERDADERO;VERDADERO;-27;;;
74246;74239;0;11361;VERDADERO;VERDADERO;7;;;
74246;74259;1;11362;VERDADERO;VERDADERO;-13;;;
74246;74259;0;11363;VERDADERO;VERDADERO;-13;;;
74246;74259;0;11364;VERDADERO;VERDADERO;-13;;;
74246;74279;1;11365;VERDADERO;VERDADERO;-33;;;
74246;74279;0;11366;VERDADERO;VERDADERO;-33;;;
74281;74299;0;11367;VERDADERO;VERDADERO;-18;;;
74281;74299;0;11368;VERDADERO;VERDADERO;-18;;;
74281;74299;0;11369;VERDADERO;VERDADERO;-18;;;
74281;74319;0;11370;VERDADERO;VERDADERO;-38;;;
74281;74319;0;11371;VERDADERO;VERDADERO;-38;;;
74313;74339;0;11372;VERDADERO;VERDADERO;-26;;;
74313;74339;0;11373;VERDADERO;VERDADERO;-26;;;
74313;74339;0;11374;VERDADERO;VERDADERO;-26;;;
74313;74359;0;11375;VERDADERO;VERDADERO;-46;;;
74313;74359;0;11376;VERDADERO;VERDADERO;-46;;;
74348;74359;0;11377;VERDADERO;VERDADERO;-11;;;
74348;74359;0;11378;VERDADERO;VERDADERO;-11;;;
74348;74359;0;11379;VERDADERO;VERDADERO;-11;;;
74348;74379;1;11380;VERDADERO;VERDADERO;-31;;;
74348;74379;0;11381;VERDADERO;VERDADERO;-31;;;
74381;74379;0;11382;VERDADERO;VERDADERO;2;;;
74381;74399;0;11383;VERDADERO;VERDADERO;-18;;;
74381;74399;0;11384;VERDADERO;VERDADERO;-18;;;
74381;74419;0;11385;VERDADERO;VERDADERO;-38;;;
74381;74419;0;11386;VERDADERO;VERDADERO;-38;;;
74381;74419;0;11387;VERDADERO;VERDADERO;-38;;;
74417;74419;0;11388;VERDADERO;VERDADERO;-2;;;
74417;74439;0;11389;VERDADERO;VERDADERO;-22;;;
74417;74439;0;11390;VERDADERO;VERDADERO;-22;;;
74417;74439;0;11391;VERDADERO;VERDADERO;-22;;;
74417;74459;0;11392;VERDADERO;VERDADERO;-42;;;
74448;74459;0;11393;VERDADERO;VERDADERO;-11;;;
74448;74459;0;11394;VERDADERO;VERDADERO;-11;;;
74448;74459;0;11395;VERDADERO;VERDADERO;-11;;;
74448;74459;0;11396;VERDADERO;VERDADERO;-11;;;
74448;74479;1;11397;VERDADERO;VERDADERO;-31;;;
74481;74479;0;11398;VERDADERO;VERDADERO;2;;;
74481;74479;0;11399;VERDADERO;VERDADERO;2;;;
74481;74499;0;11400;VERDADERO;VERDADERO;-18;;;
74481;74499;0;11401;VERDADERO;VERDADERO;-18;;;
74481;74519;0;11402;VERDADERO;VERDADERO;-38;;;
74481;74519;0;11403;VERDADERO;VERDADERO;-38;;;
74516;74519;0;11404;VERDADERO;VERDADERO;-3;;;
74516;74519;0;11405;VERDADERO;VERDADERO;-3;;;
74516;74519;0;11406;VERDADERO;VERDADERO;-3;;;
74516;74539;0;11407;VERDADERO;VERDADERO;-23;;;
74516;74539;0;11408;VERDADERO;VERDADERO;-23;;;
74549;74559;1;11409;VERDADERO;VERDADERO;-10;;;
74549;74559;0;11410;VERDADERO;VERDADERO;-10;;;
74549;74559;0;11411;VERDADERO;VERDADERO;-10;;;
74549;74579;1;11412;VERDADERO;VERDADERO;-30;;;
74549;74579;0;11413;VERDADERO;VERDADERO;-30;;;
74585;74599;0;11414;VERDADERO;VERDADERO;-14;;;
74585;74599;0;11415;VERDADERO;VERDADERO;-14;;;
74585;74599;0;11416;VERDADERO;VERDADERO;-14;;;
74585;74619;0;11417;VERDADERO;VERDADERO;-34;;;
74585;74619;0;11418;VERDADERO;VERDADERO;-34;;;
74613;74639;0;11419;VERDADERO;VERDADERO;-26;;;
74613;74639;0;11420;VERDADERO;VERDADERO;-26;;;
74613;74639;0;11421;VERDADERO;VERDADERO;-26;;;
74613;74659;0;11422;VERDADERO;VERDADERO;-46;;;
74613;74659;0;11423;VERDADERO;VERDADERO;-46;;;
74644;74679;1;11424;VERDADERO;VERDADERO;-35;;;
74644;74679;0;11425;VERDADERO;VERDADERO;-35;;;
74644;74679;0;11426;VERDADERO;VERDADERO;-35;;;
74644;74679;0;11427;VERDADERO;VERDADERO;-35;;;
74644;74679;0;11428;VERDADERO;VERDADERO;-35;;;
74644;74679;0;11429;VERDADERO;VERDADERO;-35;;;
74681;74699;0;11430;VERDADERO;VERDADERO;-18;;;
74681;74699;0;11431;VERDADERO;VERDADERO;-18;;;
74681;74719;0;11432;VERDADERO;VERDADERO;-38;;;
74681;74719;0;11433;VERDADERO;VERDADERO;-38;;;
74681;74719;0;11434;VERDADERO;VERDADERO;-38;;;
74713;74719;0;11435;VERDADERO;VERDADERO;-6;;;
74713;74719;0;11436;VERDADERO;VERDADERO;-6;;;
74713;74719;0;11437;VERDADERO;VERDADERO;-6;;;
74713;74719;0;11438;VERDADERO;VERDADERO;-6;;;
74713;74719;0;11439;VERDADERO;VERDADERO;-6;;;
74713;74719;0;11440;VERDADERO;VERDADERO;-6;;;
74749;74719;0;11441;VERDADERO;VERDADERO;30;;;
74749;74739;0;11442;VERDADERO;VERDADERO;10;;;
74749;74739;0;11443;VERDADERO;VERDADERO;10;;;
74749;74759;1;11444;VERDADERO;VERDADERO;-10;;;
74749;74759;0;11445;VERDADERO;VERDADERO;-10;;;
74780;74759;0;11446;VERDADERO;VERDADERO;21;;;
74780;74779;0;11447;VERDADERO;VERDADERO;1;;;
74780;74779;0;11448;VERDADERO;VERDADERO;1;;;
74780;74779;0;11449;VERDADERO;VERDADERO;1;;;
74780;74779;0;11450;VERDADERO;VERDADERO;1;;;
74817;74779;0;11451;VERDADERO;VERDADERO;38;;;
74817;74779;0;11452;VERDADERO;VERDADERO;38;;;
74817;74779;0;11453;VERDADERO;VERDADERO;38;;;
74817;74779;0;11454;VERDADERO;VERDADERO;38;;;
74817;74779;0;11455;VERDADERO;VERDADERO;38;;;
74817;74799;0;11456;VERDADERO;VERDADERO;18;;;
74849;74799;0;11457;FALSO;VERDADERO;50;;;
74849;74799;0;11458;FALSO;VERDADERO;50;;;
74849;74819;0;11459;VERDADERO;VERDADERO;30;;;
74849;74819;0;11460;VERDADERO;VERDADERO;30;;;
74849;74839;0;11461;VERDADERO;VERDADERO;10;;;
74885;74839;0;11462;VERDADERO;VERDADERO;46;;;
74885;74839;0;11463;VERDADERO;VERDADERO;46;;;
74885;74859;0;11464;VERDADERO;VERDADERO;26;;;
74885;74859;0;11465;VERDADERO;VERDADERO;26;;;
74885;74859;0;11466;VERDADERO;VERDADERO;26;;;
74917;74859;0;11467;FALSO;VERDADERO;58;;;
74917;74859;0;11468;FALSO;VERDADERO;58;;;
74917;74859;0;11469;FALSO;VERDADERO;58;;;
74917;74859;0;11470;FALSO;VERDADERO;58;;;
74917;74859;0;11471;FALSO;VERDADERO;58;;;
74917;74859;0;11472;FALSO;VERDADERO;58;;;
74948;74859;0;11473;FALSO;VERDADERO;89;;;
74948;74859;0;11474;FALSO;VERDADERO;89;;;
74948;74859;0;11475;FALSO;VERDADERO;89;;;
74948;74859;0;11476;FALSO;VERDADERO;89;;;
74948;74859;0;11477;FALSO;VERDADERO;89;;;
74948;74859;0;11478;FALSO;VERDADERO;89;;;
74985;74859;0;11479;FALSO;VERDADERO;126;;;
74985;74859;0;11480;FALSO;VERDADERO;126;;;
74985;74859;0;11481;FALSO;VERDADERO;126;;;
74985;74859;0;11482;FALSO;VERDADERO;126;;;
74985;74879;0;11483;FALSO;VERDADERO;106;;;
75017;74879;0;11484;FALSO;VERDADERO;138;;;
75017;74899;0;11485;FALSO;VERDADERO;118;;;
75017;74899;0;11486;FALSO;VERDADERO;118;;;
75017;74919;0;11487;FALSO;VERDADERO;98;;;
75017;74919;0;11488;FALSO;VERDADERO;98;;;
75048;74919;0;11489;FALSO;VERDADERO;129;;;
75048;74939;1;11490;FALSO;VERDADERO;109;;;
75048;74939;0;11491;FALSO;VERDADERO;109;;;
75048;74959;0;11492;FALSO;VERDADERO;89;;;
75048;74959;0;11493;FALSO;VERDADERO;89;;;
75048;74959;0;11494;FALSO;VERDADERO;89;;;
75085;74979;0;11495;FALSO;VERDADERO;106;;;
75085;74979;0;11496;FALSO;VERDADERO;106;;;
75085;74999;1;11497;FALSO;VERDADERO;86;;;
75085;74999;0;11498;FALSO;VERDADERO;86;;;
75085;74999;0;11499;FALSO;VERDADERO;86;;;
75117;75019;0;11500;FALSO;VERDADERO;98;;;
75117;75019;0;11501;FALSO;VERDADERO;98;;;
75117;75039;0;11502;FALSO;VERDADERO;78;;;
75117;75039;0;11503;FALSO;VERDADERO;78;;;
75117;75039;0;11504;FALSO;VERDADERO;78;;;
75149;75059;0;11505;FALSO;VERDADERO;90;;;
75149;75059;0;11506;FALSO;VERDADERO;90;;;
75149;75079;0;11507;FALSO;VERDADERO;70;;;
75149;75079;0;11508;FALSO;VERDADERO;70;;;
75149;75079;0;11509;FALSO;VERDADERO;70;;;
75185;75099;0;11510;FALSO;VERDADERO;86;;;
75185;75099;0;11511;FALSO;VERDADERO;86;;;
75185;75119;1;11512;FALSO;VERDADERO;66;;;
75185;75119;0;11513;FALSO;VERDADERO;66;;;
75185;75139;0;11514;VERDADERO;VERDADERO;46;;;
75217;75139;0;11515;FALSO;VERDADERO;78;;;
75217;75139;0;11516;FALSO;VERDADERO;78;;;
75217;75159;0;11517;FALSO;VERDADERO;58;;;
75217;75159;0;11518;FALSO;VERDADERO;58;;;
75217;75179;1;11519;VERDADERO;VERDADERO;38;;;
75249;75179;0;11520;FALSO;VERDADERO;70;;;
75249;75179;0;11521;FALSO;VERDADERO;70;;;
75249;75199;0;11522;FALSO;VERDADERO;50;;;
75249;75199;0;11523;FALSO;VERDADERO;50;;;
75249;75219;0;11524;VERDADERO;VERDADERO;30;;;
75249;75219;0;11525;VERDADERO;VERDADERO;30;;;
75285;75219;0;11526;FALSO;VERDADERO;66;;;
75285;75239;0;11527;VERDADERO;VERDADERO;46;;;
75285;75239;0;11528;VERDADERO;VERDADERO;46;;;
75285;75259;0;11529;VERDADERO;VERDADERO;26;;;
75285;75259;0;11530;VERDADERO;VERDADERO;26;;;
75316;75259;0;11531;FALSO;VERDADERO;57;;;
75316;75279;0;11532;VERDADERO;VERDADERO;37;;;
75316;75279;0;11533;VERDADERO;VERDADERO;37;;;
75316;75299;0;11534;VERDADERO;VERDADERO;17;;;
75316;75299;0;11535;VERDADERO;VERDADERO;17;;;
75348;75299;0;11536;VERDADERO;VERDADERO;49;;;
75348;75319;1;11537;VERDADERO;VERDADERO;29;;;
75348;75319;0;11538;VERDADERO;VERDADERO;29;;;
75348;75339;0;11539;VERDADERO;VERDADERO;9;;;
75348;75339;0;11540;VERDADERO;VERDADERO;9;;;
75381;75339;0;11541;VERDADERO;VERDADERO;42;;;
75381;75359;0;11542;VERDADERO;VERDADERO;22;;;
75381;75359;0;11543;VERDADERO;VERDADERO;22;;;
75381;75379;1;11544;VERDADERO;VERDADERO;2;;;
75381;75379;0;11545;VERDADERO;VERDADERO;2;;;
75413;75379;0;11546;VERDADERO;VERDADERO;34;;;
75413;75399;0;11547;VERDADERO;VERDADERO;14;;;
75413;75399;0;11548;VERDADERO;VERDADERO;14;;;
75413;75419;0;11549;VERDADERO;VERDADERO;-6;;;
75413;75419;0;11550;VERDADERO;VERDADERO;-6;;;
75444;75419;0;11551;VERDADERO;VERDADERO;25;;;
75444;75439;0;11552;VERDADERO;VERDADERO;5;;;
75444;75439;0;11553;VERDADERO;VERDADERO;5;;;
75444;75459;1;11554;VERDADERO;VERDADERO;-15;;;
75444;75459;0;11555;VERDADERO;VERDADERO;-15;;;
75476;75459;0;11556;VERDADERO;VERDADERO;17;;;
75476;75479;0;11557;VERDADERO;VERDADERO;-3;;;
75476;75479;0;11558;VERDADERO;VERDADERO;-3;;;
75476;75499;0;11559;VERDADERO;VERDADERO;-23;;;
75476;75499;0;11560;VERDADERO;VERDADERO;-23;;;
75476;75499;0;11561;VERDADERO;VERDADERO;-23;;;
75513;75519;1;11562;VERDADERO;VERDADERO;-6;;;
75513;75519;0;11563;VERDADERO;VERDADERO;-6;;;
75513;75539;0;11564;VERDADERO;VERDADERO;-26;;;
75513;75539;0;11565;VERDADERO;VERDADERO;-26;;;
75513;75539;0;11566;VERDADERO;VERDADERO;-26;;;
75545;75559;0;11567;VERDADERO;VERDADERO;-14;;;
75545;75559;0;11568;VERDADERO;VERDADERO;-14;;;
75545;75579;1;11569;VERDADERO;VERDADERO;-34;;;
75545;75579;0;11570;VERDADERO;VERDADERO;-34;;;
75577;75579;0;11571;VERDADERO;VERDADERO;-2;;;
75577;75599;0;11572;VERDADERO;VERDADERO;-22;;;
75577;75599;0;11573;VERDADERO;VERDADERO;-22;;;
75577;75619;0;11574;VERDADERO;VERDADERO;-42;;;
75577;75619;0;11575;VERDADERO;VERDADERO;-42;;;
75577;75619;0;11576;VERDADERO;VERDADERO;-42;;;
75612;75639;0;11577;VERDADERO;VERDADERO;-27;;;
75612;75639;0;11578;VERDADERO;VERDADERO;-27;;;
75612;75639;0;11579;VERDADERO;VERDADERO;-27;;;
75612;75659;0;11580;VERDADERO;VERDADERO;-47;;;
75612;75659;0;11581;VERDADERO;VERDADERO;-47;;;
75645;75659;0;11582;VERDADERO;VERDADERO;-14;;;
75645;75679;0;11583;VERDADERO;VERDADERO;-34;;;
75645;75679;0;11584;VERDADERO;VERDADERO;-34;;;
75645;75679;0;11585;VERDADERO;VERDADERO;-34;;;
75645;75679;0;11586;VERDADERO;VERDADERO;-34;;;
75645;75679;0;11587;VERDADERO;VERDADERO;-34;;;
75681;75679;0;11588;VERDADERO;VERDADERO;2;;;
75681;75679;0;11589;VERDADERO;VERDADERO;2;;;
75681;75679;0;11590;VERDADERO;VERDADERO;2;;;
75681;75699;0;11591;VERDADERO;VERDADERO;-18;;;
75681;75699;0;11592;VERDADERO;VERDADERO;-18;;;
75681;75719;0;11593;VERDADERO;VERDADERO;-38;;;
75716;75719;0;11594;VERDADERO;VERDADERO;-3;;;
75716;75719;0;11595;VERDADERO;VERDADERO;-3;;;
75716;75739;0;11596;VERDADERO;VERDADERO;-23;;;
75716;75739;0;11597;VERDADERO;VERDADERO;-23;;;
75716;75739;0;11598;VERDADERO;VERDADERO;-23;;;
75749;75759;0;11599;VERDADERO;VERDADERO;-10;;;
75749;75759;0;11600;VERDADERO;VERDADERO;-10;;;
75749;75779;0;11601;VERDADERO;VERDADERO;-30;;;
75749;75779;0;11602;VERDADERO;VERDADERO;-30;;;
75749;75779;0;11603;VERDADERO;VERDADERO;-30;;;
75780;75799;0;11604;VERDADERO;VERDADERO;-19;;;
75780;75799;0;11605;VERDADERO;VERDADERO;-19;;;
75780;75819;0;11606;VERDADERO;VERDADERO;-39;;;
75780;75819;0;11607;VERDADERO;VERDADERO;-39;;;
75780;75819;0;11608;VERDADERO;VERDADERO;-39;;;
75817;75839;0;11609;VERDADERO;VERDADERO;-22;;;
75817;75839;0;11610;VERDADERO;VERDADERO;-22;;;
75817;75839;0;11611;VERDADERO;VERDADERO;-22;;;
75817;75839;0;11612;VERDADERO;VERDADERO;-22;;;
75817;75839;0;11613;VERDADERO;VERDADERO;-22;;;
75817;75839;0;11614;VERDADERO;VERDADERO;-22;;;
75851;75859;1;11615;VERDADERO;VERDADERO;-8;;;
75851;75859;0;11616;VERDADERO;VERDADERO;-8;;;
75851;75879;0;11617;VERDADERO;VERDADERO;-28;;;
75851;75879;0;11618;VERDADERO;VERDADERO;-28;;;
75851;75879;0;11619;VERDADERO;VERDADERO;-28;;;
75885;75899;0;11620;VERDADERO;VERDADERO;-14;;;
75885;75899;0;11621;VERDADERO;VERDADERO;-14;;;
75885;75899;0;11622;VERDADERO;VERDADERO;-14;;;
75885;75919;0;11623;VERDADERO;VERDADERO;-34;;;
75885;75919;0;11624;VERDADERO;VERDADERO;-34;;;
75917;75939;0;11625;VERDADERO;VERDADERO;-22;;;
75917;75939;0;11626;VERDADERO;VERDADERO;-22;;;
75917;75939;0;11627;VERDADERO;VERDADERO;-22;;;
75917;75939;0;11628;VERDADERO;VERDADERO;-22;;;
75917;75939;0;11629;VERDADERO;VERDADERO;-22;;;
75949;75939;0;11630;VERDADERO;VERDADERO;10;;;
75949;75959;0;11631;VERDADERO;VERDADERO;-10;;;
75949;75959;0;11632;VERDADERO;VERDADERO;-10;;;
75949;75959;0;11633;VERDADERO;VERDADERO;-10;;;
75949;75979;0;11634;VERDADERO;VERDADERO;-30;;;
75981;75979;0;11635;VERDADERO;VERDADERO;2;;;
75981;75999;0;11636;VERDADERO;VERDADERO;-18;;;
75981;75999;0;11637;VERDADERO;VERDADERO;-18;;;
75981;75999;0;11638;VERDADERO;VERDADERO;-18;;;
75981;76019;0;11639;VERDADERO;VERDADERO;-38;;;
76013;76019;0;11640;VERDADERO;VERDADERO;-6;;;
76013;76019;0;11641;VERDADERO;VERDADERO;-6;;;
76013;76039;0;11642;VERDADERO;VERDADERO;-26;;;
76013;76039;0;11643;VERDADERO;VERDADERO;-26;;;
76013;76059;0;11644;VERDADERO;VERDADERO;-46;;;
76013;76059;0;11645;VERDADERO;VERDADERO;-46;;;
76049;76059;0;11646;VERDADERO;VERDADERO;-10;;;
76049;76079;0;11647;VERDADERO;VERDADERO;-30;;;
76049;76079;0;11648;VERDADERO;VERDADERO;-30;;;
76049;76079;0;11649;VERDADERO;VERDADERO;-30;;;
76049;76099;0;11650;VERDADERO;FALSO;-50;;;
76081;76099;0;11651;VERDADERO;VERDADERO;-18;;;
76081;76099;0;11652;VERDADERO;VERDADERO;-18;;;
76081;76099;0;11653;VERDADERO;VERDADERO;-18;;;
76081;76099;0;11654;VERDADERO;VERDADERO;-18;;;
76081;76099;0;11655;VERDADERO;VERDADERO;-18;;;
76081;76119;0;11656;VERDADERO;VERDADERO;-38;;;
76117;76119;0;11657;VERDADERO;VERDADERO;-2;;;
76117;76139;0;11658;VERDADERO;VERDADERO;-22;;;
76117;76139;0;11659;VERDADERO;VERDADERO;-22;;;
76117;76139;0;11660;VERDADERO;VERDADERO;-22;;;
76144;76159;0;11661;VERDADERO;VERDADERO;-15;;;
76144;76159;0;11662;VERDADERO;VERDADERO;-15;;;
76144;76179;0;11663;VERDADERO;VERDADERO;-35;;;
76144;76179;0;11664;VERDADERO;VERDADERO;-35;;;
76144;76199;0;11665;VERDADERO;FALSO;-55;;;
76176;76199;0;11666;VERDADERO;VERDADERO;-23;;;
76176;76199;0;11667;VERDADERO;VERDADERO;-23;;;
76176;76199;0;11668;VERDADERO;VERDADERO;-23;;;
76176;76199;0;11669;VERDADERO;VERDADERO;-23;;;
76176;76219;0;11670;VERDADERO;VERDADERO;-43;;;
76208;76219;0;11671;VERDADERO;VERDADERO;-11;;;
76208;76219;0;11672;VERDADERO;VERDADERO;-11;;;
76208;76239;0;11673;VERDADERO;VERDADERO;-31;;;
76208;76239;0;11674;VERDADERO;VERDADERO;-31;;;
76208;76239;0;11675;VERDADERO;VERDADERO;-31;;;
76240;76239;0;11676;VERDADERO;VERDADERO;1;;;
76240;76259;0;11677;VERDADERO;VERDADERO;-19;;;
76240;76259;0;11678;VERDADERO;VERDADERO;-19;;;
76240;76259;0;11679;VERDADERO;VERDADERO;-19;;;
76240;76280;0;11680;VERDADERO;VERDADERO;-40;;;
76240;76280;0;11681;VERDADERO;VERDADERO;-40;;;
76277;76300;1;11682;VERDADERO;VERDADERO;-23;;;
76277;76300;0;11683;VERDADERO;VERDADERO;-23;;;
76277;76300;0;11684;VERDADERO;VERDADERO;-23;;;
76277;76320;0;11685;VERDADERO;VERDADERO;-43;;;
76277;76320;0;11686;VERDADERO;VERDADERO;-43;;;
76309;76340;0;11687;VERDADERO;VERDADERO;-31;;;
76309;76340;0;11688;VERDADERO;VERDADERO;-31;;;
76309;76340;0;11689;VERDADERO;VERDADERO;-31;;;
76309;76340;0;11690;VERDADERO;VERDADERO;-31;;;
76309;76360;0;11691;VERDADERO;FALSO;-51;;;
76342;76360;0;11692;VERDADERO;VERDADERO;-18;;;
76342;76360;0;11693;VERDADERO;VERDADERO;-18;;;
76342;76380;0;11694;VERDADERO;VERDADERO;-38;;;
76342;76380;0;11695;VERDADERO;VERDADERO;-38;;;
76342;76380;0;11696;VERDADERO;VERDADERO;-38;;;
76342;76380;0;11697;VERDADERO;VERDADERO;-38;;;
76377;76380;0;11698;VERDADERO;VERDADERO;-3;;;
76377;76380;0;11699;VERDADERO;VERDADERO;-3;;;
76377;76380;0;11700;VERDADERO;VERDADERO;-3;;;
76377;76380;0;11701;VERDADERO;VERDADERO;-3;;;
76377;76380;0;11702;VERDADERO;VERDADERO;-3;;;
76408;76400;0;11703;VERDADERO;VERDADERO;8;;;
76408;76400;0;11704;VERDADERO;VERDADERO;8;;;
76408;76420;0;11705;VERDADERO;VERDADERO;-12;;;
76408;76420;0;11706;VERDADERO;VERDADERO;-12;;;
76408;76420;0;11707;VERDADERO;VERDADERO;-12;;;
76408;76420;0;11708;VERDADERO;VERDADERO;-12;;;
76445;76440;0;11709;VERDADERO;VERDADERO;5;;;
76445;76440;0;11710;VERDADERO;VERDADERO;5;;;
76445;76440;0;11711;VERDADERO;VERDADERO;5;;;
76445;76461;0;11712;VERDADERO;VERDADERO;-16;;;
76445;76461;0;11713;VERDADERO;VERDADERO;-16;;;
76477;76461;0;11714;VERDADERO;VERDADERO;16;;;
76477;76481;0;11715;VERDADERO;VERDADERO;-4;;;
76477;76481;0;11716;VERDADERO;VERDADERO;-4;;;
76477;76501;0;11717;VERDADERO;VERDADERO;-24;;;
76477;76501;0;11718;VERDADERO;VERDADERO;-24;;;
76477;76501;0;11719;VERDADERO;VERDADERO;-24;;;
76513;76521;1;11720;VERDADERO;VERDADERO;-8;;;
76513;76521;0;11721;VERDADERO;VERDADERO;-8;;;
76513;76521;0;11722;VERDADERO;VERDADERO;-8;;;
76513;76541;1;11723;VERDADERO;VERDADERO;-28;;;
76513;76541;0;11724;VERDADERO;VERDADERO;-28;;;
76545;76541;0;11725;VERDADERO;VERDADERO;4;;;
76545;76541;0;11726;VERDADERO;VERDADERO;4;;;
76545;76541;0;11727;VERDADERO;VERDADERO;4;;;
76545;76561;0;11728;VERDADERO;VERDADERO;-16;;;
76545;76561;0;11729;VERDADERO;VERDADERO;-16;;;
76581;76561;0;11730;VERDADERO;VERDADERO;20;;;
76581;76581;1;11731;VERDADERO;VERDADERO;0;;;
76581;76581;0;11732;VERDADERO;VERDADERO;0;;;
76581;76601;1;11733;VERDADERO;VERDADERO;-20;;;
76581;76601;0;11734;VERDADERO;VERDADERO;-20;;;
76613;76601;0;11735;VERDADERO;VERDADERO;12;;;
76613;76621;0;11736;VERDADERO;VERDADERO;-8;;;
76613;76621;0;11737;VERDADERO;VERDADERO;-8;;;
76613;76641;0;11738;VERDADERO;VERDADERO;-28;;;
76613;76641;0;11739;VERDADERO;VERDADERO;-28;;;
76613;76641;0;11740;VERDADERO;VERDADERO;-28;;;
76613;76661;0;11741;VERDADERO;VERDADERO;-48;;;
76613;76661;0;11742;VERDADERO;VERDADERO;-48;;;
76613;76661;0;11743;VERDADERO;VERDADERO;-48;;;
76613;76661;0;11744;VERDADERO;VERDADERO;-48;;;
76613;76681;0;11745;VERDADERO;FALSO;-68;;;
76680;76681;0;11746;VERDADERO;VERDADERO;-1;;;
76680;76681;0;11747;VERDADERO;VERDADERO;-1;;;
76680;76701;1;11748;VERDADERO;VERDADERO;-21;;;
76680;76701;0;11749;VERDADERO;VERDADERO;-21;;;
76680;76721;0;11750;VERDADERO;VERDADERO;-41;;;
76713;76721;0;11751;VERDADERO;VERDADERO;-8;;;
76713;76721;0;11752;VERDADERO;VERDADERO;-8;;;
76713;76741;0;11753;VERDADERO;VERDADERO;-28;;;
76713;76741;0;11754;VERDADERO;VERDADERO;-28;;;
76713;76761;0;11755;VERDADERO;VERDADERO;-48;;;
76745;76761;0;11756;VERDADERO;VERDADERO;-16;;;
76745;76761;0;11757;VERDADERO;VERDADERO;-16;;;
76745;76761;0;11758;VERDADERO;VERDADERO;-16;;;
76745;76761;0;11759;VERDADERO;VERDADERO;-16;;;
76745;76781;0;11760;VERDADERO;VERDADERO;-36;;;
76777;76781;0;11761;VERDADERO;VERDADERO;-4;;;
76777;76781;0;11762;VERDADERO;VERDADERO;-4;;;
76777;76801;0;11763;VERDADERO;VERDADERO;-24;;;
76777;76801;0;11764;VERDADERO;VERDADERO;-24;;;
76777;76821;0;11765;VERDADERO;VERDADERO;-44;;;
76810;76821;0;11766;VERDADERO;VERDADERO;-11;;;
76810;76821;0;11767;VERDADERO;VERDADERO;-11;;;
76810;76841;0;11768;VERDADERO;VERDADERO;-31;;;
76810;76841;0;11769;VERDADERO;VERDADERO;-31;;;
76810;76861;0;11770;VERDADERO;FALSO;-51;;;
76810;76861;0;11771;VERDADERO;FALSO;-51;;;
76845;76861;0;11772;VERDADERO;VERDADERO;-16;;;
76845;76861;0;11773;VERDADERO;VERDADERO;-16;;;
76845;76861;0;11774;VERDADERO;VERDADERO;-16;;;
76845;76881;0;11775;VERDADERO;VERDADERO;-36;;;
76845;76881;0;11776;VERDADERO;VERDADERO;-36;;;
76876;76901;0;11777;VERDADERO;VERDADERO;-25;;;
76876;76901;0;11778;VERDADERO;VERDADERO;-25;;;
76876;76901;0;11779;VERDADERO;VERDADERO;-25;;;
76876;76901;0;11780;VERDADERO;VERDADERO;-25;;;
76876;76901;0;11781;VERDADERO;VERDADERO;-25;;;
76876;76901;0;11782;VERDADERO;VERDADERO;-25;;;
76913;76901;0;11783;VERDADERO;VERDADERO;12;;;
76913;76921;0;11784;VERDADERO;VERDADERO;-8;;;
76913;76921;0;11785;VERDADERO;VERDADERO;-8;;;
76913;76942;0;11786;VERDADERO;VERDADERO;-29;;;
76913;76942;0;11787;VERDADERO;VERDADERO;-29;;;
76945;76942;0;11788;VERDADERO;VERDADERO;3;;;
76945;76962;0;11789;VERDADERO;VERDADERO;-17;;;
76945;76962;0;11790;VERDADERO;VERDADERO;-17;;;
76945;76982;0;11791;VERDADERO;VERDADERO;-37;;;
76945;76982;0;11792;VERDADERO;VERDADERO;-37;;;
76981;76982;0;11793;VERDADERO;VERDADERO;-1;;;
76981;77002;0;11794;VERDADERO;VERDADERO;-21;;;
76981;77002;0;11795;VERDADERO;VERDADERO;-21;;;
76981;77002;0;11796;VERDADERO;VERDADERO;-21;;;
76981;77002;0;11797;VERDADERO;VERDADERO;-21;;;
77013;77002;0;11798;VERDADERO;VERDADERO;11;;;
77013;77022;0;11799;VERDADERO;VERDADERO;-9;;;
77013;77022;0;11800;VERDADERO;VERDADERO;-9;;;
77013;77042;0;11801;VERDADERO;VERDADERO;-29;;;
77013;77042;0;11802;VERDADERO;VERDADERO;-29;;;
77013;77042;0;11803;VERDADERO;VERDADERO;-29;;;
77049;77062;0;11804;VERDADERO;VERDADERO;-13;;;
77049;77062;0;11805;VERDADERO;VERDADERO;-13;;;
77049;77062;0;11806;VERDADERO;VERDADERO;-13;;;
77049;77082;1;11807;VERDADERO;VERDADERO;-33;;;
77049;77082;0;11808;VERDADERO;VERDADERO;-33;;;
77080;77102;0;11809;VERDADERO;VERDADERO;-22;;;
77080;77102;0;11810;VERDADERO;VERDADERO;-22;;;
77080;77102;0;11811;VERDADERO;VERDADERO;-22;;;
77080;77102;0;11812;VERDADERO;VERDADERO;-22;;;
77080;77102;0;11813;VERDADERO;VERDADERO;-22;;;
77080;77102;0;11814;VERDADERO;VERDADERO;-22;;;
77117;77122;0;11815;VERDADERO;VERDADERO;-5;;;
77117;77122;0;11816;VERDADERO;VERDADERO;-5;;;
77117;77122;0;11817;VERDADERO;VERDADERO;-5;;;
77117;77142;0;11818;VERDADERO;VERDADERO;-25;;;
77117;77142;0;11819;VERDADERO;VERDADERO;-25;;;
77148;77162;0;11820;VERDADERO;VERDADERO;-14;;;
77148;77162;0;11821;VERDADERO;VERDADERO;-14;;;
77148;77162;0;11822;VERDADERO;VERDADERO;-14;;;
77148;77182;1;11823;VERDADERO;VERDADERO;-34;;;
77148;77182;0;11824;VERDADERO;VERDADERO;-34;;;
77148;77202;0;11825;VERDADERO;FALSO;-54;;;
77180;77202;0;11826;VERDADERO;VERDADERO;-22;;;
77180;77202;0;11827;VERDADERO;VERDADERO;-22;;;
77180;77202;0;11828;VERDADERO;VERDADERO;-22;;;
77180;77202;0;11829;VERDADERO;VERDADERO;-22;;;
77213;77202;0;11830;VERDADERO;VERDADERO;11;;;
77213;77202;0;11831;VERDADERO;VERDADERO;11;;;
77213;77202;0;11832;VERDADERO;VERDADERO;11;;;
77213;77202;0;11833;VERDADERO;VERDADERO;11;;;
77213;77222;1;11834;VERDADERO;VERDADERO;-9;;;
77213;77222;0;11835;VERDADERO;VERDADERO;-9;;;
77245;77242;0;11836;VERDADERO;VERDADERO;3;;;
77245;77242;0;11837;VERDADERO;VERDADERO;3;;;
77245;77242;0;11838;VERDADERO;VERDADERO;3;;;
77245;77262;0;11839;VERDADERO;VERDADERO;-17;;;
77245;77262;0;11840;VERDADERO;VERDADERO;-17;;;
77281;77262;0;11841;VERDADERO;VERDADERO;19;;;
77281;77262;0;11842;VERDADERO;VERDADERO;19;;;
77281;77282;0;11843;VERDADERO;VERDADERO;-1;;;
77281;77282;0;11844;VERDADERO;VERDADERO;-1;;;
77281;77282;0;11845;VERDADERO;VERDADERO;-1;;;
77281;77302;0;11846;VERDADERO;VERDADERO;-21;;;
77313;77302;0;11847;VERDADERO;VERDADERO;11;;;
77313;77322;0;11848;VERDADERO;VERDADERO;-9;;;
77313;77322;0;11849;VERDADERO;VERDADERO;-9;;;
77313;77322;0;11850;VERDADERO;VERDADERO;-9;;;
77345;77342;1;11851;VERDADERO;VERDADERO;3;;;
77345;77342;0;11852;VERDADERO;VERDADERO;3;;;
77345;77362;0;11853;VERDADERO;VERDADERO;-17;;;
77345;77362;0;11854;VERDADERO;VERDADERO;-17;;;
77345;77362;0;11855;VERDADERO;VERDADERO;-17;;;
77345;77382;0;11856;VERDADERO;VERDADERO;-37;;;
77381;77382;0;11857;VERDADERO;VERDADERO;-1;;;
77381;77402;0;11858;VERDADERO;VERDADERO;-21;;;
77381;77402;0;11859;VERDADERO;VERDADERO;-21;;;
77381;77402;0;11860;VERDADERO;VERDADERO;-21;;;
77381;77422;0;11861;VERDADERO;VERDADERO;-41;;;
77413;77422;0;11862;VERDADERO;VERDADERO;-9;;;
77413;77442;0,00E+00;11863;VERDADERO;VERDADERO;-29;;;
77413;77442;0;11864;VERDADERO;VERDADERO;-29;;;
77413;77442;0;11865;VERDADERO;VERDADERO;-29;;;
77413;77462;0;11866;VERDADERO;VERDADERO;-49;;;
77445;77462;0;11867;VERDADERO;VERDADERO;-17;;;
77445;77482;0;11868;VERDADERO;VERDADERO;-37;;;
77445;77482;0;11869;VERDADERO;VERDADERO;-37;;;
77445;77482;0;11870;VERDADERO;VERDADERO;-37;;;
77445;77482;0;11871;VERDADERO;VERDADERO;-37;;;
77476;77482;0;11872;VERDADERO;VERDADERO;-6;;;
77476;77482;0;11873;VERDADERO;VERDADERO;-6;;;
77476;77502;0;11874;VERDADERO;VERDADERO;-26;;;
77476;77502;0;11875;VERDADERO;VERDADERO;-26;;;
77476;77522;0;11876;VERDADERO;VERDADERO;-46;;;
77509;77522;0;11877;VERDADERO;VERDADERO;-13;;;
77509;77522;0;11878;VERDADERO;VERDADERO;-13;;;
77509;77522;0;11879;VERDADERO;VERDADERO;-13;;;
77509;77522;0;11880;VERDADERO;VERDADERO;-13;;;
77509;77522;0;11881;VERDADERO;VERDADERO;-13;;;
77509;77522;0;11882;VERDADERO;VERDADERO;-13;;;
77545;77542;0;11883;VERDADERO;VERDADERO;3;;;
77545;77542;0;11884;VERDADERO;VERDADERO;3;;;
77545;77542;0;11885;VERDADERO;VERDADERO;3;;;
77545;77562;0;11886;VERDADERO;VERDADERO;-17;;;
77545;77562;0;11887;VERDADERO;VERDADERO;-17;;;
77577;77582;0;11888;VERDADERO;VERDADERO;-5;;;
77577;77582;0;11889;VERDADERO;VERDADERO;-5;;;
77577;77602;0;11890;VERDADERO;VERDADERO;-25;;;
77577;77602;0;11891;VERDADERO;VERDADERO;-25;;;
77577;77602;0;11892;VERDADERO;VERDADERO;-25;;;
77609;77622;1;11893;VERDADERO;VERDADERO;-13;;;
77609;77622;0;11894;VERDADERO;VERDADERO;-13;;;
77609;77642;0;11895;VERDADERO;VERDADERO;-33;;;
77609;77642;0;11896;VERDADERO;VERDADERO;-33;;;
77609;77642;0;11897;VERDADERO;VERDADERO;-33;;;
77609;77642;0;11898;VERDADERO;VERDADERO;-33;;;
77646;77662;1;11899;VERDADERO;VERDADERO;-16;;;
77646;77662;0;11900;VERDADERO;VERDADERO;-16;;;
77646;77682;0;11901;VERDADERO;VERDADERO;-36;;;
77646;77682;0;11902;VERDADERO;VERDADERO;-36;;;
77673;77682;0;11903;VERDADERO;VERDADERO;-9;;;
77673;77682;0;11904;VERDADERO;VERDADERO;-9;;;
77673;77682;0;11905;VERDADERO;VERDADERO;-9;;;
77673;77702;1;11906;VERDADERO;VERDADERO;-29;;;
77673;77702;0;11907;VERDADERO;VERDADERO;-29;;;
77673;77722;0;11908;VERDADERO;VERDADERO;-49;;;
77709;77722;0;11909;VERDADERO;VERDADERO;-13;;;
77709;77722;0;11910;VERDADERO;VERDADERO;-13;;;
77709;77742;0;11911;VERDADERO;VERDADERO;-33;;;
77709;77742;0;11912;VERDADERO;VERDADERO;-33;;;
77709;77742;0;11913;VERDADERO;VERDADERO;-33;;;
77740;77742;0;11914;VERDADERO;VERDADERO;-2;;;
77740;77762;0;11915;VERDADERO;VERDADERO;-22;;;
77740;77762;0;11916;VERDADERO;VERDADERO;-22;;;
77740;77782;1;11917;VERDADERO;VERDADERO;-42;;;
77740;77782;0;11918;VERDADERO;VERDADERO;-42;;;
77777;77782;0;11919;VERDADERO;VERDADERO;-5;;;
77777;77782;0;11920;VERDADERO;VERDADERO;-5;;;
77777;77782;0;11921;VERDADERO;VERDADERO;-5;;;
77777;77782;0;11922;VERDADERO;VERDADERO;-5;;;
77777;77802;0;11923;VERDADERO;VERDADERO;-25;;;
77777;77802;0;11924;VERDADERO;VERDADERO;-25;;;
77808;77822;0;11925;VERDADERO;VERDADERO;-14;;;
77808;77822;0;11926;VERDADERO;VERDADERO;-14;;;
77808;77822;0;11927;VERDADERO;VERDADERO;-14;;;
77808;77842;0;11928;VERDADERO;VERDADERO;-34;;;
77808;77842;0;11929;VERDADERO;VERDADERO;-34;;;
77808;77842;0;11930;VERDADERO;VERDADERO;-34;;;
77849;77862;1;11931;VERDADERO;VERDADERO;-13;;;
77849;77862;0;11932;VERDADERO;VERDADERO;-13;;;
77849;77882;0;11933;VERDADERO;VERDADERO;-33;;;
77849;77882;0;11934;VERDADERO;VERDADERO;-33;;;
77877;77882;0;11935;VERDADERO;VERDADERO;-5;;;
77877;77902;1;11936;VERDADERO;VERDADERO;-25;;;
77877;77902;0;11937;VERDADERO;VERDADERO;-25;;;
77877;77902;0;11938;VERDADERO;VERDADERO;-25;;;
77877;77922;0;11939;VERDADERO;VERDADERO;-45;;;
77909;77922;0;11940;VERDADERO;VERDADERO;-13;;;
77909;77942;0;11941;VERDADERO;VERDADERO;-33;;;
77909;77942;0;11942;VERDADERO;VERDADERO;-33;;;
77909;77942;0;11943;VERDADERO;VERDADERO;-33;;;
77909;77942;0;11944;VERDADERO;VERDADERO;-33;;;
77909;77942;0;11945;VERDADERO;VERDADERO;-33;;;
77945;77942;0;11946;VERDADERO;VERDADERO;3;;;
77945;77962;0;11947;VERDADERO;VERDADERO;-17;;;
77945;77962;0;11948;VERDADERO;VERDADERO;-17;;;
77945;77982;0;11949;VERDADERO;VERDADERO;-37;;;
77945;77982;0;11950;VERDADERO;VERDADERO;-37;;;
77981;77982;0;11951;VERDADERO;VERDADERO;-1;;;
77981;77982;0;11952;VERDADERO;VERDADERO;-1;;;
77981;77982;0;11953;VERDADERO;VERDADERO;-1;;;
77981;77982;0;11954;VERDADERO;VERDADERO;-1;;;
77981;78002;0;11955;VERDADERO;VERDADERO;-21;;;
77981;78002;0;11956;VERDADERO;VERDADERO;-21;;;
78013;78023;1;11957;VERDADERO;VERDADERO;-10;;;
78013;78023;0;11958;VERDADERO;VERDADERO;-10;;;
78013;78043;1;11959;VERDADERO;VERDADERO;-30;;;
78013;78043;0;11960;VERDADERO;VERDADERO;-30;;;
78013;78043;0;11961;VERDADERO;VERDADERO;-30;;;
78045;78043;0;11962;VERDADERO;VERDADERO;2;;;
78045;78063;0;11963;VERDADERO;VERDADERO;-18;;;
78045;78063;0;11964;VERDADERO;VERDADERO;-18;;;
78045;78083;1;11965;VERDADERO;VERDADERO;-38;;;
78045;78083;0;11966;VERDADERO;VERDADERO;-38;;;
78045;78083;0;11967;VERDADERO;VERDADERO;-38;;;
78081;78083;0;11968;VERDADERO;VERDADERO;-2;;;
78081;78083;0;11969;VERDADERO;VERDADERO;-2;;;
78081;78083;0;11970;VERDADERO;VERDADERO;-2;;;
78081;78083;0;11971;VERDADERO;VERDADERO;-2;;;
78081;78083;0;11972;VERDADERO;VERDADERO;-2;;;
78113;78103;0;11973;VERDADERO;VERDADERO;10;;;
78113;78103;0;11974;VERDADERO;VERDADERO;10;;;
78113;78124;0;11975;VERDADERO;VERDADERO;-11;;;
78113;78124;0;11976;VERDADERO;VERDADERO;-11;;;
78113;78124;0;11977;VERDADERO;VERDADERO;-11;;;
78144;78144;1;11978;VERDADERO;VERDADERO;0;;;
78144;78144;0;11979;VERDADERO;VERDADERO;0;;;
78144;78164;0;11980;VERDADERO;VERDADERO;-20;;;
78144;78164;0;11981;VERDADERO;VERDADERO;-20;;;
78144;78164;0;11982;VERDADERO;VERDADERO;-20;;;
78180;78184;0;11983;VERDADERO;VERDADERO;-4;;;
78180;78184;0;11984;VERDADERO;VERDADERO;-4;;;
78180;78204;0;11985;VERDADERO;VERDADERO;-24;;;
78180;78204;0;11986;VERDADERO;VERDADERO;-24;;;
78180;78204;0;11987;VERDADERO;VERDADERO;-24;;;
78180;78224;0;11988;VERDADERO;VERDADERO;-44;;;
78213;78224;0;11989;VERDADERO;VERDADERO;-11;;;
78213;78224;0;11990;VERDADERO;VERDADERO;-11;;;
78213;78244;0;11991;VERDADERO;VERDADERO;-31;;;
78213;78244;0;11992;VERDADERO;VERDADERO;-31;;;
78213;78264;0;11993;VERDADERO;FALSO;-51;;;
78245;78264;0;11994;VERDADERO;VERDADERO;-19;;;
78245;78264;0;11995;VERDADERO;VERDADERO;-19;;;
78245;78284;0;11996;VERDADERO;VERDADERO;-39;;;
78245;78284;0;11997;VERDADERO;VERDADERO;-39;;;
78245;78284;0;11998;VERDADERO;VERDADERO;-39;;;
78281;78304;0;11999;VERDADERO;VERDADERO;-23;;;
78281;78304;0;12000;VERDADERO;VERDADERO;-23;;;
78281;78304;0;12001;VERDADERO;VERDADERO;-23;;;
78281;78304;0;12002;VERDADERO;VERDADERO;-23;;;
78281;78304;0;12003;VERDADERO;VERDADERO;-23;;;
78281;78324;0;12004;VERDADERO;VERDADERO;-43;;;
78313;78324;0;12005;VERDADERO;VERDADERO;-11;;;
78313;78344;0;12006;VERDADERO;VERDADERO;-31;;;
78313;78344;0;12007;VERDADERO;VERDADERO;-31;;;
78313;78344;0;12008;VERDADERO;VERDADERO;-31;;;
78313;78364;0;12009;VERDADERO;FALSO;-51;;;
78348;78364;0;12010;VERDADERO;VERDADERO;-16;;;
78348;78384;0;12011;VERDADERO;VERDADERO;-36;;;
78348;78384;0;12012;VERDADERO;VERDADERO;-36;;;
78348;78384;0;12013;VERDADERO;VERDADERO;-36;;;
78348;78404;0;12014;VERDADERO;FALSO;-56;;;
78380;78404;0;12015;VERDADERO;VERDADERO;-24;;;
78380;78404;0;12016;VERDADERO;VERDADERO;-24;;;
78380;78404;0;12017;VERDADERO;VERDADERO;-24;;;
78380;78424;0;12018;VERDADERO;VERDADERO;-44;;;
78380;78424;0;12019;VERDADERO;VERDADERO;-44;;;
78413;78444;0;12020;VERDADERO;VERDADERO;-31;;;
78413;78444;0;12021;VERDADERO;VERDADERO;-31;;;
78413;78444;0;12022;VERDADERO;VERDADERO;-31;;;
78413;78444;0;12023;VERDADERO;VERDADERO;-31;;;
78413;78444;0;12024;VERDADERO;VERDADERO;-31;;;
78413;78444;0;12025;VERDADERO;VERDADERO;-31;;;
78449;78444;0;12026;VERDADERO;VERDADERO;5;;;
78449;78444;0;12027;VERDADERO;VERDADERO;5;;;
78449;78464;1;12028;VERDADERO;VERDADERO;-15;;;
78449;78464;0;12029;VERDADERO;VERDADERO;-15;;;
78449;78464;0;12030;VERDADERO;VERDADERO;-15;;;
78481;78484;0;12031;VERDADERO;VERDADERO;-3;;;
78481;78484;0;12032;VERDADERO;VERDADERO;-3;;;
78481;78504;0;12033;VERDADERO;VERDADERO;-23;;;
78481;78504;0;12034;VERDADERO;VERDADERO;-23;;;
78481;78504;0,00E+00;12035;VERDADERO;VERDADERO;-23;;;
78512;78524;1;12036;VERDADERO;VERDADERO;-12;;;
78512;78524;0;12037;VERDADERO;VERDADERO;-12;;;
78512;78544;1;12038;VERDADERO;VERDADERO;-32;;;
78512;78544;0;12039;VERDADERO;VERDADERO;-32;;;
78512;78544;0;12040;VERDADERO;VERDADERO;-32;;;
78544;78564;0;12041;VERDADERO;VERDADERO;-20;;;
78544;78564;0;12042;VERDADERO;VERDADERO;-20;;;
78544;78564;0;12043;VERDADERO;VERDADERO;-20;;;
78544;78564;0;12044;VERDADERO;VERDADERO;-20;;;
78544;78584;0;12045;VERDADERO;VERDADERO;-40;;;
78577;78584;0;12046;VERDADERO;VERDADERO;-7;;;
78577;78584;0;12047;VERDADERO;VERDADERO;-7;;;
78577;78604;0;12048;VERDADERO;VERDADERO;-27;;;
78577;78604;0;12049;VERDADERO;VERDADERO;-27;;;
78577;78604;0;12050;VERDADERO;VERDADERO;-27;;;
78577;78604;0;12051;VERDADERO;VERDADERO;-27;;;
78613;78604;0;12052;VERDADERO;VERDADERO;9;;;
78613;78624;0;12053;VERDADERO;VERDADERO;-11;;;
78613;78624;0;12054;VERDADERO;VERDADERO;-11;;;
78613;78644;0;12055;VERDADERO;VERDADERO;-31;;;
78613;78644;0;12056;VERDADERO;VERDADERO;-31;;;
78645;78644;0;12057;VERDADERO;VERDADERO;1;;;
78645;78664;0;12058;VERDADERO;VERDADERO;-19;;;
78645;78664;0;12059;VERDADERO;VERDADERO;-19;;;
78645;78684;0;12060;VERDADERO;VERDADERO;-39;;;
78645;78684;0;12061;VERDADERO;VERDADERO;-39;;;
78676;78684;0;12062;VERDADERO;VERDADERO;-8;;;
78713;78724;1;12063;VERDADERO;VERDADERO;-11;;;
78745;78764;0;12064;VERDADERO;VERDADERO;-19;;;
78777;78784;1;12065;VERDADERO;VERDADERO;-7;;;
78812;78824;0;12066;VERDADERO;VERDADERO;-12;;;
78845;78864;1;12067;VERDADERO;VERDADERO;-19;;;
78877;78884;1;12068;VERDADERO;VERDADERO;-7;;;
78913;78924;1;12069;VERDADERO;VERDADERO;-11;;;
78945;78964;0;12070;VERDADERO;VERDADERO;-19;;;
78977;78984;1;12071;VERDADERO;VERDADERO;-7;;;
79009;79024;1;12072;VERDADERO;VERDADERO;-15;;;
79040;79044;1;12073;VERDADERO;VERDADERO;-4;;;
79082;79084;1;12074;VERDADERO;VERDADERO;-2;;;
79109;79124;1;12075;VERDADERO;VERDADERO;-15;;;
79141;79144;1;12076;VERDADERO;VERDADERO;-3;;;
79177;79184;1;12077;VERDADERO;VERDADERO;-7;;;
79212;79224;1;12078;VERDADERO;VERDADERO;-12;;;
79245;79264;1;12079;VERDADERO;VERDADERO;-19;;;
79277;79284;1;12080;VERDADERO;VERDADERO;-7;;;
79313;79324;1;12081;VERDADERO;VERDADERO;-11;;;
79345;79364;1;12082;VERDADERO;VERDADERO;-19;;;
79377;79384;0;12083;VERDADERO;VERDADERO;-7;;;
79413;79424;0;12084;VERDADERO;VERDADERO;-11;;;
79413;79424;0;12085;VERDADERO;VERDADERO;-11;;;
79413;79424;0;12086;VERDADERO;VERDADERO;-11;;;
79413;79424;0;12087;VERDADERO;VERDADERO;-11;;;
79445;79444;0;12088;VERDADERO;VERDADERO;1;;;
79445;79444;0;12089;VERDADERO;VERDADERO;1;;;
79445;79464;0;12090;VERDADERO;VERDADERO;-19;;;
79445;79464;0;12091;VERDADERO;VERDADERO;-19;;;
79445;79484;0;12092;VERDADERO;VERDADERO;-39;;;
79476;79484;0;12093;VERDADERO;VERDADERO;-8;;;
79476;79484;0;12094;VERDADERO;VERDADERO;-8;;;
79476;79504;0;12095;VERDADERO;VERDADERO;-28;;;
79476;79504;0;12096;VERDADERO;VERDADERO;-28;;;
79476;79524;0;12097;VERDADERO;VERDADERO;-48;;;
79509;79524;0;12098;VERDADERO;VERDADERO;-15;;;
79509;79524;0;12099;VERDADERO;VERDADERO;-15;;;
79509;79524;0;12100;VERDADERO;VERDADERO;-15;;;
79509;79524;0;12101;VERDADERO;VERDADERO;-15;;;
79509;79524;0;12102;VERDADERO;VERDADERO;-15;;;
79509;79544;0;12103;VERDADERO;VERDADERO;-35;;;
79541;79544;0;12104;VERDADERO;VERDADERO;-3;;;
79541;79544;0;12105;VERDADERO;VERDADERO;-3;;;
79541;79564;0;12106;VERDADERO;VERDADERO;-23;;;
79541;79564;0;12107;VERDADERO;VERDADERO;-23;;;
79541;79584;0;12108;VERDADERO;VERDADERO;-43;;;
79573;79584;0;12109;VERDADERO;VERDADERO;-11;;;
79573;79584;0;12110;VERDADERO;VERDADERO;-11;;;
79573;79604;0;12111;VERDADERO;VERDADERO;-31;;;
79573;79604;0;12112;VERDADERO;VERDADERO;-31;;;
79573;79624;0;12113;VERDADERO;FALSO;-51;;;
79605;79624;0;12114;VERDADERO;VERDADERO;-19;;;
79605;79624;0;12115;VERDADERO;VERDADERO;-19;;;
79605;79624;0;12116;VERDADERO;VERDADERO;-19;;;
79605;79624;0;12117;VERDADERO;VERDADERO;-19;;;
79605;79624;0;12118;VERDADERO;VERDADERO;-19;;;
79641;79624;0;12119;VERDADERO;VERDADERO;17;;;
79641;79624;0;12120;VERDADERO;VERDADERO;17;;;
79641;79644;0;12121;VERDADERO;VERDADERO;-3;;;
79641;79644;0;12122;VERDADERO;VERDADERO;-3;;;
79641;79644;0;12123;VERDADERO;VERDADERO;-3;;;
79641;79664;0;12124;VERDADERO;VERDADERO;-23;;;
79673;79664;0;12125;VERDADERO;VERDADERO;9;;;
79673;79684;0;12126;VERDADERO;VERDADERO;-11;;;
79673;79684;0;12127;VERDADERO;VERDADERO;-11;;;
79673;79684;0;12128;VERDADERO;VERDADERO;-11;;;
79705;79704;0;12129;VERDADERO;VERDADERO;1;;;
79705;79704;0;12130;VERDADERO;VERDADERO;1;;;
79705;79724;0;12131;VERDADERO;VERDADERO;-19;;;
79705;79724;0;12132;VERDADERO;VERDADERO;-19;;;
79705;79744;0;12133;VERDADERO;VERDADERO;-39;;;
79705;79744;0;12134;VERDADERO;VERDADERO;-39;;;
79741;79744;0;12135;VERDADERO;VERDADERO;-3;;;
79741;79744;0;12136;VERDADERO;VERDADERO;-3;;;
79741;79764;0;12137;VERDADERO;VERDADERO;-23;;;
79741;79764;0;12138;VERDADERO;VERDADERO;-23;;;
79741;79764;0;12139;VERDADERO;VERDADERO;-23;;;
79772;79784;0;12140;VERDADERO;VERDADERO;-12;;;
79772;79784;0;12141;VERDADERO;VERDADERO;-12;;;
79772;79784;0;12142;VERDADERO;VERDADERO;-12;;;
79772;79784;0;12143;VERDADERO;VERDADERO;-12;;;
79772;79784;0;12144;VERDADERO;VERDADERO;-12;;;
79772;79804;0;12145;VERDADERO;VERDADERO;-32;;;
79809;79804;0;12146;VERDADERO;VERDADERO;5;;;
79809;79804;0;12147;VERDADERO;VERDADERO;5;;;
79809;79825;1;12148;VERDADERO;VERDADERO;-16;;;
79809;79825;0;12149;VERDADERO;VERDADERO;-16;;;
79809;79845;0;12150;VERDADERO;VERDADERO;-36;;;
79841;79845;0;12151;VERDADERO;VERDADERO;-4;;;
79841;79865;0;12152;VERDADERO;VERDADERO;-24;;;
79841;79865;0;12153;VERDADERO;VERDADERO;-24;;;
79841;79865;0;12154;VERDADERO;VERDADERO;-24;;;
79841;79885;1;12155;VERDADERO;VERDADERO;-44;;;
79877;79885;0;12156;VERDADERO;VERDADERO;-8;;;
79877;79885;0;12157;VERDADERO;VERDADERO;-8;;;
79877;79885;0;12158;VERDADERO;VERDADERO;-8;;;
79877;79905;0;12159;VERDADERO;VERDADERO;-28;;;
79877;79905;0;12160;VERDADERO;VERDADERO;-28;;;
79909;79905;0;12161;VERDADERO;VERDADERO;4;;;
79909;79926;0;12162;VERDADERO;VERDADERO;-17;;;
79909;79926;0;12163;VERDADERO;VERDADERO;-17;;;
79909;79946;1;12164;VERDADERO;VERDADERO;-37;;;
79909;79946;0;12165;VERDADERO;VERDADERO;-37;;;
79909;79946;0;12166;VERDADERO;VERDADERO;-37;;;
79944;79946;0;12167;VERDADERO;VERDADERO;-2;;;
79944;79966;0;12168;VERDADERO;VERDADERO;-22;;;
79944;79966;0;12169;VERDADERO;VERDADERO;-22;;;
79944;79986;0;12170;VERDADERO;VERDADERO;-42;;;
79944;79986;0;12171;VERDADERO;VERDADERO;-42;;;
79977;79986;0;12172;VERDADERO;VERDADERO;-9;;;
79977;79986;0;12173;VERDADERO;VERDADERO;-9;;;
79977;79986;0;12174;VERDADERO;VERDADERO;-9;;;
79977;79986;0;12175;VERDADERO;VERDADERO;-9;;;
79977;80006;0;12176;VERDADERO;VERDADERO;-29;;;
79977;80006;0;12177;VERDADERO;VERDADERO;-29;;;
80012;80026;0;12178;VERDADERO;VERDADERO;-14;;;
80012;80026;0;12179;VERDADERO;VERDADERO;-14;;;
80012;80026;0;12180;VERDADERO;VERDADERO;-14;;;
80012;80046;0;12181;VERDADERO;VERDADERO;-34;;;
80012;80046;0;12182;VERDADERO;VERDADERO;-34;;;
80045;80046;0;12183;VERDADERO;VERDADERO;-1;;;
80045;80066;0;12184;VERDADERO;VERDADERO;-21;;;
80045;80066;0;12185;VERDADERO;VERDADERO;-21;;;
80045;80066;0;12186;VERDADERO;VERDADERO;-21;;;
80045;80086;0;12187;VERDADERO;VERDADERO;-41;;;
80077;80086;0;12188;VERDADERO;VERDADERO;-9;;;
80077;80106;1;12189;VERDADERO;VERDADERO;-29;;;
80077;80106;0;12190;VERDADERO;VERDADERO;-29;;;
80077;80106;0;12191;VERDADERO;VERDADERO;-29;;;
80077;80126;0;12192;VERDADERO;VERDADERO;-49;;;
80077;80126;0;12193;VERDADERO;VERDADERO;-49;;;
80111;80146;0;12194;VERDADERO;VERDADERO;-35;;;
80111;80146;0;12195;VERDADERO;VERDADERO;-35;;;
80111;80146;0;12196;VERDADERO;VERDADERO;-35;;;
80111;80146;0;12197;VERDADERO;VERDADERO;-35;;;
80111;80146;0;12198;VERDADERO;VERDADERO;-35;;;
80145;80146;0;12199;VERDADERO;VERDADERO;-1;;;
80145;80166;0;12200;VERDADERO;VERDADERO;-21;;;
80145;80166;0;12201;VERDADERO;VERDADERO;-21;;;
80145;80166;0;12202;VERDADERO;VERDADERO;-21;;;
80145;80186;0;12203;VERDADERO;VERDADERO;-41;;;
80176;80186;0;12204;VERDADERO;VERDADERO;-10;;;
80176;80206;0;12205;VERDADERO;VERDADERO;-30;;;
80176;80206;0;12206;VERDADERO;VERDADERO;-30;;;
80176;80206;0;12207;VERDADERO;VERDADERO;-30;;;
80176;80206;0;12208;VERDADERO;VERDADERO;-30;;;
80209;80226;1;12209;VERDADERO;VERDADERO;-17;;;
80209;80226;0;12210;VERDADERO;VERDADERO;-17;;;
80209;80226;0;12211;VERDADERO;VERDADERO;-17;;;
80209;80246;0;12212;VERDADERO;VERDADERO;-37;;;
80209;80246;0;12213;VERDADERO;VERDADERO;-37;;;
80209;80246;0;12214;VERDADERO;VERDADERO;-37;;;
80248;80246;0;12215;VERDADERO;VERDADERO;2;;;
80248;80266;0;12216;VERDADERO;VERDADERO;-18;;;
80248;80266;0;12217;VERDADERO;VERDADERO;-18;;;
80248;80266;0;12218;VERDADERO;VERDADERO;-18;;;
80272;80286;0;12219;VERDADERO;VERDADERO;-14;;;
80272;80286;0;12220;VERDADERO;VERDADERO;-14;;;
80272;80306;0;12221;VERDADERO;VERDADERO;-34;;;
80272;80306;0;12222;VERDADERO;VERDADERO;-34;;;
80272;80306;0;12223;VERDADERO;VERDADERO;-34;;;
80272;80306;0;12224;VERDADERO;VERDADERO;-34;;;
80309;80326;0;12225;VERDADERO;VERDADERO;-17;;;
80309;80326;0;12226;VERDADERO;VERDADERO;-17;;;
80309;80346;0;12227;VERDADERO;VERDADERO;-37;;;
80309;80346;0;12228;VERDADERO;VERDADERO;-37;;;
80309;80346;0;12229;VERDADERO;VERDADERO;-37;;;
80340;80346;0;12230;VERDADERO;VERDADERO;-6;;;
80340;80346;0;12231;VERDADERO;VERDADERO;-6;;;
80340;80366;0;12232;VERDADERO;VERDADERO;-26;;;
80340;80366;0;12233;VERDADERO;VERDADERO;-26;;;
80340;80366;0;12234;VERDADERO;VERDADERO;-26;;;
80373;80386;1;12235;VERDADERO;VERDADERO;-13;;;
80373;80386;0;12236;VERDADERO;VERDADERO;-13;;;
80373;80406;0;12237;VERDADERO;VERDADERO;-33;;;
80373;80406;0;12238;VERDADERO;VERDADERO;-33;;;
80373;80406;0;12239;VERDADERO;VERDADERO;-33;;;
80373;80426;0;12240;VERDADERO;FALSO;-53;;;
80409;80426;0;12241;VERDADERO;VERDADERO;-17;;;
80409;80446;0;12242;VERDADERO;VERDADERO;-37;;;
80409;80446;0;12243;VERDADERO;VERDADERO;-37;;;
80409;80446;0;12244;VERDADERO;VERDADERO;-37;;;
80437;80446;0;12245;VERDADERO;VERDADERO;-9;;;
80437;80446;0;12246;VERDADERO;VERDADERO;-9;;;
80437;80466;0;12247;VERDADERO;VERDADERO;-29;;;
80437;80466;0;12248;VERDADERO;VERDADERO;-29;;;
80437;80486;1;12249;VERDADERO;VERDADERO;-49;;;
80437;80486;0;12250;VERDADERO;VERDADERO;-49;;;
80473;80486;0;12251;VERDADERO;VERDADERO;-13;;;
80473;80486;0;12252;VERDADERO;VERDADERO;-13;;;
80473;80486;0;12253;VERDADERO;VERDADERO;-13;;;
80473;80486;0;12254;VERDADERO;VERDADERO;-13;;;
80473;80486;0;12255;VERDADERO;VERDADERO;-13;;;
80505;80486;0;12256;VERDADERO;VERDADERO;19;;;
80505;80506;0;12257;VERDADERO;VERDADERO;-1;;;
80505;80506;0;12258;VERDADERO;VERDADERO;-1;;;
80505;80526;0;12259;VERDADERO;VERDADERO;-21;;;
80505;80526;0;12260;VERDADERO;VERDADERO;-21;;;
80505;80526;0;12261;VERDADERO;VERDADERO;-21;;;
80541;80546;0;12262;VERDADERO;VERDADERO;-5;;;
80541;80546;0;12263;VERDADERO;VERDADERO;-5;;;
80541;80566;0;12264;VERDADERO;VERDADERO;-25;;;
80541;80566;0;12265;VERDADERO;VERDADERO;-25;;;
80541;80566;0;12266;VERDADERO;VERDADERO;-25;;;
80573;80586;0;12267;VERDADERO;VERDADERO;-13;;;
80573;80586;0;12268;VERDADERO;VERDADERO;-13;;;
80573;80606;0;12269;VERDADERO;VERDADERO;-33;;;
80573;80606;0;12270;VERDADERO;VERDADERO;-33;;;
80573;80606;0;12271;VERDADERO;VERDADERO;-33;;;
80609;80606;0;12272;VERDADERO;VERDADERO;3;;;
80609;80626;0;12273;VERDADERO;VERDADERO;-17;;;
80609;80626;0;12274;VERDADERO;VERDADERO;-17;;;
80609;80626;0;12275;VERDADERO;VERDADERO;-17;;;
80609;80646;0;12276;VERDADERO;VERDADERO;-37;;;
80640;80646;0;12277;VERDADERO;VERDADERO;-6;;;
80640;80666;0;12278;VERDADERO;VERDADERO;-26;;;
80640;80666;0;12279;VERDADERO;VERDADERO;-26;;;
80640;80666;0;12280;VERDADERO;VERDADERO;-26;;;
80640;80686;0;12281;VERDADERO;VERDADERO;-46;;;
80673;80686;0;12282;VERDADERO;VERDADERO;-13;;;
80673;80706;0;12283;VERDADERO;VERDADERO;-33;;;
80673;80706;0;12284;VERDADERO;VERDADERO;-33;;;
80673;80706;0;12285;VERDADERO;VERDADERO;-33;;;
80673;80706;0;12286;VERDADERO;VERDADERO;-33;;;
80673;80706;0;12287;VERDADERO;VERDADERO;-33;;;
80709;80706;0;12288;VERDADERO;VERDADERO;3;;;
80709;80726;0;12289;VERDADERO;VERDADERO;-17;;;
80709;80726;0;12290;VERDADERO;VERDADERO;-17;;;
80709;80746;0;12291;VERDADERO;VERDADERO;-37;;;
80709;80746;0;12292;VERDADERO;VERDADERO;-37;;;
80741;80746;0;12293;VERDADERO;VERDADERO;-5;;;
80741;80766;0;12294;VERDADERO;VERDADERO;-25;;;
80741;80766;0;12295;VERDADERO;VERDADERO;-25;;;
80741;80766;0;12296;VERDADERO;VERDADERO;-25;;;
80741;80786;0;12297;VERDADERO;VERDADERO;-45;;;
80773;80786;0;12298;VERDADERO;VERDADERO;-13;;;
80773;80806;0;12299;VERDADERO;VERDADERO;-33;;;
80773;80806;0;12300;VERDADERO;VERDADERO;-33;;;
80773;80806;0;12301;VERDADERO;VERDADERO;-33;;;
80773;80806;0;12302;VERDADERO;VERDADERO;-33;;;
80773;80806;0;12303;VERDADERO;VERDADERO;-33;;;
80808;80806;0;12304;VERDADERO;VERDADERO;2;;;
80808;80826;0;12305;VERDADERO;VERDADERO;-18;;;
80808;80826;0;12306;VERDADERO;VERDADERO;-18;;;
80808;80846;0;12307;VERDADERO;VERDADERO;-38;;;
80808;80846;0;12308;VERDADERO;VERDADERO;-38;;;
80841;80846;0;12309;VERDADERO;VERDADERO;-5;;;
80841;80866;0;12310;VERDADERO;VERDADERO;-25;;;
80841;80866;0;12311;VERDADERO;VERDADERO;-25;;;
80841;80866;0;12312;VERDADERO;VERDADERO;-25;;;
80841;80886;0;12313;VERDADERO;VERDADERO;-45;;;
80872;80886;0;12314;VERDADERO;VERDADERO;-14;;;
80872;80906;0;12315;VERDADERO;VERDADERO;-34;;;
80872;80906;0;12316;VERDADERO;VERDADERO;-34;;;
80872;80906;0;12317;VERDADERO;VERDADERO;-34;;;
80872;80906;0;12318;VERDADERO;VERDADERO;-34;;;
80909;80906;0;12319;VERDADERO;VERDADERO;3;;;
80909;80926;0;12320;VERDADERO;VERDADERO;-17;;;
80909;80926;0;12321;VERDADERO;VERDADERO;-17;;;
80909;80946;1;12322;VERDADERO;VERDADERO;-37;;;
80909;80946;0;12323;VERDADERO;VERDADERO;-37;;;
80941;80946;0;12324;VERDADERO;VERDADERO;-5;;;
80941;80966;0;12325;VERDADERO;VERDADERO;-25;;;
80941;80966;0;12326;VERDADERO;VERDADERO;-25;;;
80941;80986;0;12327;VERDADERO;VERDADERO;-45;;;
80941;80986;0;12328;VERDADERO;VERDADERO;-45;;;
80941;80986;0;12329;VERDADERO;VERDADERO;-45;;;
80973;81006;1;12330;VERDADERO;VERDADERO;-33;;;
80973;81006;0;12331;VERDADERO;VERDADERO;-33;;;
80973;81006;0;12332;VERDADERO;VERDADERO;-33;;;
80973;81006;0;12333;VERDADERO;VERDADERO;-33;;;
80973;81006;0;12334;VERDADERO;VERDADERO;-33;;;
81005;81006;0;12335;VERDADERO;VERDADERO;-1;;;
81005;81006;0;12336;VERDADERO;VERDADERO;-1;;;
81005;81006;0;12337;VERDADERO;VERDADERO;-1;;;
81005;81006;0;12338;VERDADERO;VERDADERO;-1;;;
81005;81006;0;12339;VERDADERO;VERDADERO;-1;;;
81037;81006;0;12340;VERDADERO;VERDADERO;31;;;
81037;81026;0;12341;VERDADERO;VERDADERO;11;;;
81037;81026;0;12342;VERDADERO;VERDADERO;11;;;
81037;81046;1;12343;VERDADERO;VERDADERO;-9;;;
81037;81046;0;12344;VERDADERO;VERDADERO;-9;;;
81037;81046;0;12345;VERDADERO;VERDADERO;-9;;;
81073;81046;0;12346;VERDADERO;VERDADERO;27;;;
81073;81046;0;12347;VERDADERO;VERDADERO;27;;;
81073;81066;0;12348;VERDADERO;VERDADERO;7;;;
81073;81066;0;12349;VERDADERO;VERDADERO;7;;;
81073;81066;0;12350;VERDADERO;VERDADERO;7;;;
81104;81086;0;12351;VERDADERO;VERDADERO;18;;;
81104;81086;0;12352;VERDADERO;VERDADERO;18;;;
81104;81106;0;12353;VERDADERO;VERDADERO;-2;;;
81104;81106;0;12354;VERDADERO;VERDADERO;-2;;;
81104;81106;0;12355;VERDADERO;VERDADERO;-2;;;
81137;81126;0;12356;VERDADERO;VERDADERO;11;;;
81137;81126;0;12357;VERDADERO;VERDADERO;11;;;
81137;81146;0;12358;VERDADERO;VERDADERO;-9;;;
81137;81146;0;12359;VERDADERO;VERDADERO;-9;;;
81137;81167;0;12360;VERDADERO;VERDADERO;-30;;;
81168;81167;0;12361;VERDADERO;VERDADERO;1;;;
81168;81167;0;12362;VERDADERO;VERDADERO;1;;;
81168;81187;0;12363;VERDADERO;VERDADERO;-19;;;
81168;81187;0;12364;VERDADERO;VERDADERO;-19;;;
81168;81207;0;12365;VERDADERO;VERDADERO;-39;;;
81202;81207;0;12366;VERDADERO;VERDADERO;-5;;;
81202;81207;0;12367;VERDADERO;VERDADERO;-5;;;
81202;81227;0;12368;VERDADERO;VERDADERO;-25;;;
81202;81227;0;12369;VERDADERO;VERDADERO;-25;;;
81202;81247;0;12370;VERDADERO;VERDADERO;-45;;;
81237;81247;0;12371;VERDADERO;VERDADERO;-10;;;
81237;81247;0;12372;VERDADERO;VERDADERO;-10;;;
81237;81267;0;12373;VERDADERO;VERDADERO;-30;;;
81237;81267;0;12374;VERDADERO;VERDADERO;-30;;;
81237;81267;0;12375;VERDADERO;VERDADERO;-30;;;
81237;81267;0;12376;VERDADERO;VERDADERO;-30;;;
81269;81267;0;12377;VERDADERO;VERDADERO;2;;;
81269;81287;0;12378;VERDADERO;VERDADERO;-18;;;
81269;81287;0;12379;VERDADERO;VERDADERO;-18;;;
81269;81307;0;12380;VERDADERO;VERDADERO;-38;;;
81269;81307;0;12381;VERDADERO;VERDADERO;-38;;;
81305;81307;0;12382;VERDADERO;VERDADERO;-2;;;
81305;81327;0;12383;VERDADERO;VERDADERO;-22;;;
81305;81327;0;12384;VERDADERO;VERDADERO;-22;;;
81305;81327;0;12385;VERDADERO;VERDADERO;-22;;;
81305;81347;0;12386;VERDADERO;VERDADERO;-42;;;
81305;81347;0;12387;VERDADERO;VERDADERO;-42;;;
81337;81347;0;12388;VERDADERO;VERDADERO;-10;;;
81337;81367;0;12389;VERDADERO;VERDADERO;-30;;;
81337;81367;0;12390;VERDADERO;VERDADERO;-30;;;
81337;81367;0;12391;VERDADERO;VERDADERO;-30;;;
81337;81367;0;12392;VERDADERO;VERDADERO;-30;;;
81373;81367;0;12393;VERDADERO;VERDADERO;6;;;
81373;81387;0;12394;VERDADERO;VERDADERO;-14;;;
81373;81387;0;12395;VERDADERO;VERDADERO;-14;;;
81373;81387;0;12396;VERDADERO;VERDADERO;-14;;;
81373;81407;0;12397;VERDADERO;VERDADERO;-34;;;
81406;81407;0;12398;VERDADERO;VERDADERO;-1;;;
81406;81427;0;12399;VERDADERO;VERDADERO;-21;;;
81406;81427;0;12400;VERDADERO;VERDADERO;-21;;;
81406;81427;0;12401;VERDADERO;VERDADERO;-21;;;
81406;81447;0;12402;VERDADERO;VERDADERO;-41;;;
81437;81447;0;12403;VERDADERO;VERDADERO;-10;;;
81437;81447;0;12404;VERDADERO;VERDADERO;-10;;;
81437;81467;0;12405;VERDADERO;VERDADERO;-30;;;
81437;81467;0;12406;VERDADERO;VERDADERO;-30;;;
81437;81467;0;12407;VERDADERO;VERDADERO;-30;;;
81437;81467;0;12408;VERDADERO;VERDADERO;-30;;;
81472;81467;0;12409;VERDADERO;VERDADERO;5;;;
81472;81487;0;12410;VERDADERO;VERDADERO;-15;;;
81472;81487;0;12411;VERDADERO;VERDADERO;-15;;;
81472;81487;0;12412;VERDADERO;VERDADERO;-15;;;
81472;81507;0;12413;VERDADERO;VERDADERO;-35;;;
81504;81507;0;12414;VERDADERO;VERDADERO;-3;;;
81504;81527;0;12415;VERDADERO;VERDADERO;-23;;;
81504;81527;0;12416;VERDADERO;VERDADERO;-23;;;
81504;81527;0;12417;VERDADERO;VERDADERO;-23;;;
81504;81527;0;12418;VERDADERO;VERDADERO;-23;;;
81504;81527;0;12419;VERDADERO;VERDADERO;-23;;;
81541;81547;0;12420;VERDADERO;VERDADERO;-6;;;
81541;81547;0;12421;VERDADERO;VERDADERO;-6;;;
81541;81567;0;12422;VERDADERO;VERDADERO;-26;;;
81541;81567;0;12423;VERDADERO;VERDADERO;-26;;;
81541;81567;0;12424;VERDADERO;VERDADERO;-26;;;
81574;81567;0;12425;VERDADERO;VERDADERO;7;;;
81574;81567;0;12426;VERDADERO;VERDADERO;7;;;
81574;81587;0;12427;VERDADERO;VERDADERO;-13;;;
81574;81587;0;12428;VERDADERO;VERDADERO;-13;;;
81574;81587;0;12429;VERDADERO;VERDADERO;-13;;;
81574;81607;0;12430;VERDADERO;VERDADERO;-33;;;
81609;81607;0;12431;VERDADERO;VERDADERO;2;;;
81609;81627;0;12432;VERDADERO;VERDADERO;-18;;;
81609;81627;0;12433;VERDADERO;VERDADERO;-18;;;
81609;81627;0;12434;VERDADERO;VERDADERO;-18;;;
81609;81647;0;12435;VERDADERO;VERDADERO;-38;;;
81641;81647;0;12436;VERDADERO;VERDADERO;-6;;;
81641;81667;0;12437;VERDADERO;VERDADERO;-26;;;
81641;81667;0;12438;VERDADERO;VERDADERO;-26;;;
81641;81667;0;12439;VERDADERO;VERDADERO;-26;;;
81641;81687;0;12440;VERDADERO;VERDADERO;-46;;;
81677;81687;0;12441;VERDADERO;VERDADERO;-10;;;
81677;81687;0;12442;VERDADERO;VERDADERO;-10;;;
81677;81707;0;12443;VERDADERO;VERDADERO;-30;;;
81677;81707;0;12444;VERDADERO;VERDADERO;-30;;;
81677;81707;0;12445;VERDADERO;VERDADERO;-30;;;
81677;81727;0;12446;VERDADERO;FALSO;-50;;;
81713;81727;0;12447;VERDADERO;VERDADERO;-14;;;
81713;81747;0;12448;VERDADERO;VERDADERO;-34;;;
81713;81747;0;12449;VERDADERO;VERDADERO;-34;;;
81713;81747;0;12450;VERDADERO;VERDADERO;-34;;;
81713;81747;0;12451;VERDADERO;VERDADERO;-34;;;
81745;81767;0;12452;VERDADERO;VERDADERO;-22;;;
81745;81767;0;12453;VERDADERO;VERDADERO;-22;;;
81745;81787;0;12454;VERDADERO;VERDADERO;-42;;;
81745;81787;0;12455;VERDADERO;VERDADERO;-42;;;
81745;81787;0;12456;VERDADERO;VERDADERO;-42;;;
81777;81787;0;12457;VERDADERO;VERDADERO;-10;;;
81777;81787;0;12458;VERDADERO;VERDADERO;-10;;;
81777;81807;0;12459;VERDADERO;VERDADERO;-30;;;
81777;81807;0;12460;VERDADERO;VERDADERO;-30;;;
81777;81827;0;12461;VERDADERO;FALSO;-50;;;
81809;81827;0;12462;VERDADERO;VERDADERO;-18;;;
81809;81827;0;12463;VERDADERO;VERDADERO;-18;;;
81809;81827;0;12464;VERDADERO;VERDADERO;-18;;;
81809;81827;0;12465;VERDADERO;VERDADERO;-18;;;
81809;81827;0;12466;VERDADERO;VERDADERO;-18;;;
81843;81827;0;12467;VERDADERO;VERDADERO;16;;;
81843;81827;0;12468;VERDADERO;VERDADERO;16;;;
81843;81847;0;12469;VERDADERO;VERDADERO;-4;;;
81843;81847;0;12470;VERDADERO;VERDADERO;-4;;;
81843;81867;0;12471;VERDADERO;VERDADERO;-24;;;
81873;81867;0;12472;VERDADERO;VERDADERO;6;;;
81873;81867;0;12473;VERDADERO;VERDADERO;6;;;
81873;81887;0;12474;VERDADERO;VERDADERO;-14;;;
81873;81887;0;12475;VERDADERO;VERDADERO;-14;;;
81873;81907;0;12476;VERDADERO;VERDADERO;-34;;;
81873;81907;0;12477;VERDADERO;VERDADERO;-34;;;
81909;81907;0;12478;VERDADERO;VERDADERO;2;;;
81909;81927;0;12479;VERDADERO;VERDADERO;-18;;;
81909;81927;0;12480;VERDADERO;VERDADERO;-18;;;
81909;81947;0;12481;VERDADERO;VERDADERO;-38;;;
81909;81947;0;12482;VERDADERO;VERDADERO;-38;;;
81941;81947;0;12483;VERDADERO;VERDADERO;-6;;;
81941;81967;0;12484;VERDADERO;VERDADERO;-26;;;
81941;81967;0;12485;VERDADERO;VERDADERO;-26;;;
81941;81987;0;12486;VERDADERO;VERDADERO;-46;;;
81941;81987;0;12487;VERDADERO;VERDADERO;-46;;;
81976;81987;0;12488;VERDADERO;VERDADERO;-11;;;
81976;81987;0;12489;VERDADERO;VERDADERO;-11;;;
81976;81987;0;12490;VERDADERO;VERDADERO;-11;;;
81976;82007;0;12491;VERDADERO;VERDADERO;-31;;;
81976;82007;0;12492;VERDADERO;VERDADERO;-31;;;
82004;82007;0;12493;VERDADERO;VERDADERO;-3;;;
82004;82027;1;12494;VERDADERO;VERDADERO;-23;;;
82004;82027;0;12495;VERDADERO;VERDADERO;-23;;;
82004;82027;0;12496;VERDADERO;VERDADERO;-23;;;
82004;82027;0;12497;VERDADERO;VERDADERO;-23;;;
82037;82027;0;12498;VERDADERO;VERDADERO;10;;;
82037;82047;0;12499;VERDADERO;VERDADERO;-10;;;
82037;82047;0;12500;VERDADERO;VERDADERO;-10;;;
82037;82047;0;12501;VERDADERO;VERDADERO;-10;;;
82037;82068;0;12502;VERDADERO;VERDADERO;-31;;;
82069;82068;0;12503;VERDADERO;VERDADERO;1;;;
82069;82088;0;12504;VERDADERO;VERDADERO;-19;;;
82069;82088;0;12505;VERDADERO;VERDADERO;-19;;;
82069;82088;0;12506;VERDADERO;VERDADERO;-19;;;
82069;82108;0;12507;VERDADERO;VERDADERO;-39;;;
82101;82108;0;12508;VERDADERO;VERDADERO;-7;;;
82101;82128;0;12509;VERDADERO;VERDADERO;-27;;;
82101;82128;0;12510;VERDADERO;VERDADERO;-27;;;
82101;82128;0;12511;VERDADERO;VERDADERO;-27;;;
82101;82128;0;12512;VERDADERO;VERDADERO;-27;;;
82101;82128;0;12513;VERDADERO;VERDADERO;-27;;;
82137;82128;0;12514;VERDADERO;VERDADERO;9;;;
82137;82148;0;12515;VERDADERO;VERDADERO;-11;;;
82137;82148;0;12516;VERDADERO;VERDADERO;-11;;;
82137;82168;0;12517;VERDADERO;VERDADERO;-31;;;
82137;82168;0;12518;VERDADERO;VERDADERO;-31;;;
82137;82168;0;12519;VERDADERO;VERDADERO;-31;;;
82173;82188;0;12520;VERDADERO;VERDADERO;-15;;;
82173;82188;0;12521;VERDADERO;VERDADERO;-15;;;
82173;82208;0;12522;VERDADERO;VERDADERO;-35;;;
82173;82208;0;12523;VERDADERO;VERDADERO;-35;;;
82173;82228;0;12524;VERDADERO;FALSO;-55;;;
82205;82228;0;12525;VERDADERO;VERDADERO;-23;;;
82205;82228;0;12526;VERDADERO;VERDADERO;-23;;;
82205;82228;0;12527;VERDADERO;VERDADERO;-23;;;
82205;82228;0;12528;VERDADERO;VERDADERO;-23;;;
82205;82228;0;12529;VERDADERO;VERDADERO;-23;;;
82237;82228;0;12530;VERDADERO;VERDADERO;9;;;
82237;82228;0;12531;VERDADERO;VERDADERO;9;;;
82237;82248;0;12532;VERDADERO;VERDADERO;-11;;;
82237;82248;0;12533;VERDADERO;VERDADERO;-11;;;
82237;82268;0;12534;VERDADERO;VERDADERO;-31;;;
82273;82268;0;12535;VERDADERO;VERDADERO;5;;;
82273;82288;0;12536;VERDADERO;VERDADERO;-15;;;
82273;82288;0;12537;VERDADERO;VERDADERO;-15;;;
82273;82288;0;12538;VERDADERO;VERDADERO;-15;;;
82273;82308;0;12539;VERDADERO;VERDADERO;-35;;;
82305;82308;0;12540;VERDADERO;VERDADERO;-3;;;
82305;82328;1;12541;VERDADERO;VERDADERO;-23;;;
82305;82328;0;12542;VERDADERO;VERDADERO;-23;;;
82305;82328;0;12543;VERDADERO;VERDADERO;-23;;;
82305;82328;0;12544;VERDADERO;VERDADERO;-23;;;
82305;82328;0;12545;VERDADERO;VERDADERO;-23;;;
82341;82328;0;12546;VERDADERO;VERDADERO;13;;;
82341;82328;0;12547;VERDADERO;VERDADERO;13;;;
82341;82348;0;12548;VERDADERO;VERDADERO;-7;;;
82341;82348;0;12549;VERDADERO;VERDADERO;-7;;;
82341;82348;0;12550;VERDADERO;VERDADERO;-7;;;
82373;82369;0;12551;VERDADERO;VERDADERO;4;;;
82373;82369;0;12552;VERDADERO;VERDADERO;4;;;
82373;82389;0;12553;VERDADERO;VERDADERO;-16;;;
82373;82389;0;12554;VERDADERO;VERDADERO;-16;;;
82373;82389;0;12555;VERDADERO;VERDADERO;-16;;;
82404;82409;0;12556;VERDADERO;VERDADERO;-5;;;
82404;82409;0;12557;VERDADERO;VERDADERO;-5;;;
82404;82429;0;12558;VERDADERO;VERDADERO;-25;;;
82404;82429;0;12559;VERDADERO;VERDADERO;-25;;;
82404;82429;0;12560;VERDADERO;VERDADERO;-25;;;
82404;82449;0;12561;VERDADERO;VERDADERO;-45;;;
82441;82449;0;12562;VERDADERO;VERDADERO;-8;;;
82441;82449;0;12563;VERDADERO;VERDADERO;-8;;;
82441;82449;0;12564;VERDADERO;VERDADERO;-8;;;
82441;82449;0;12565;VERDADERO;VERDADERO;-8;;;
82441;82469;0;12566;VERDADERO;VERDADERO;-28;;;
82441;82469;0;12567;VERDADERO;VERDADERO;-28;;;
82477;82489;0;12568;VERDADERO;VERDADERO;-12;;;
82477;82489;0;12569;VERDADERO;VERDADERO;-12;;;
82477;82489;0;12570;VERDADERO;VERDADERO;-12;;;
82477;82489;0;12571;VERDADERO;VERDADERO;-12;;;
82477;82489;0;12572;VERDADERO;VERDADERO;-12;;;
82509;82509;0;12573;VERDADERO;VERDADERO;0;;;
82509;82509;0;12574;VERDADERO;VERDADERO;0;;;
82509;82509;0;12575;VERDADERO;VERDADERO;0;;;
82509;82529;0;12576;VERDADERO;VERDADERO;-20;;;
82509;82529;0;12577;VERDADERO;VERDADERO;-20;;;
82541;82549;0;12578;VERDADERO;VERDADERO;-8;;;
82541;82549;0;12579;VERDADERO;VERDADERO;-8;;;
82541;82549;0;12580;VERDADERO;VERDADERO;-8;;;
82541;82569;0;12581;VERDADERO;VERDADERO;-28;;;
82541;82569;0;12582;VERDADERO;VERDADERO;-28;;;
82541;82569;0;12583;VERDADERO;VERDADERO;-28;;;
82577;82590;0;12584;VERDADERO;VERDADERO;-13;;;
82577;82590;0;12585;VERDADERO;VERDADERO;-13;;;
82577;82590;0;12586;VERDADERO;VERDADERO;-13;;;
82577;82610;0;12587;VERDADERO;VERDADERO;-33;;;
82577;82610;0;12588;VERDADERO;VERDADERO;-33;;;
82608;82630;0;12589;VERDADERO;VERDADERO;-22;;;
82608;82630;0;12590;VERDADERO;VERDADERO;-22;;;
82608;82630;0;12591;VERDADERO;VERDADERO;-22;;;
82608;82650;0;12592;VERDADERO;VERDADERO;-42;;;
82608;82650;0;12593;VERDADERO;VERDADERO;-42;;;
82640;82670;0;12594;VERDADERO;VERDADERO;-30;;;
82640;82670;0;12595;VERDADERO;VERDADERO;-30;;;
82640;82670;0;12596;VERDADERO;VERDADERO;-30;;;
82640;82690;0;12597;VERDADERO;FALSO;-50;;;
82640;82690;0;12598;VERDADERO;FALSO;-50;;;
82677;82690;0;12599;VERDADERO;VERDADERO;-13;;;
82677;82710;0;12600;VERDADERO;VERDADERO;-33;;;
82677;82710;0;12601;VERDADERO;VERDADERO;-33;;;
82677;82710;0;12602;VERDADERO;VERDADERO;-33;;;
82677;82710;0;12603;VERDADERO;VERDADERO;-33;;;
82709;82710;0;12604;VERDADERO;VERDADERO;-1;;;
82709;82730;0;12605;VERDADERO;VERDADERO;-21;;;
82709;82730;0;12606;VERDADERO;VERDADERO;-21;;;
82709;82750;1;12607;VERDADERO;VERDADERO;-41;;;
82709;82750;0;12608;VERDADERO;VERDADERO;-41;;;
82709;82750;0;12609;VERDADERO;VERDADERO;-41;;;
82742;82750;0;12610;VERDADERO;VERDADERO;-8;;;
82742;82750;0;12611;VERDADERO;VERDADERO;-8;;;
82742;82770;1;12612;VERDADERO;VERDADERO;-28;;;
82742;82770;0;12613;VERDADERO;VERDADERO;-28;;;
82742;82791;0;12614;VERDADERO;VERDADERO;-49;;;
82777;82791;0;12615;VERDADERO;VERDADERO;-14;;;
82777;82791;0;12616;VERDADERO;VERDADERO;-14;;;
82777;82811;0;12617;VERDADERO;VERDADERO;-34;;;
82777;82811;0;12618;VERDADERO;VERDADERO;-34;;;
82777;82831;0;12619;VERDADERO;FALSO;-54;;;
82809;82831;0;12620;VERDADERO;VERDADERO;-22;;;
82809;82831;0;12621;VERDADERO;VERDADERO;-22;;;
82809;82851;0;12622;VERDADERO;VERDADERO;-42;;;
82809;82851;0;12623;VERDADERO;VERDADERO;-42;;;
82809;82851;0;12624;VERDADERO;VERDADERO;-42;;;
82840;82851;0;12625;VERDADERO;VERDADERO;-11;;;
82840;82851;0;12626;VERDADERO;VERDADERO;-11;;;
82840;82851;0;12627;VERDADERO;VERDADERO;-11;;;
82840;82871;0;12628;VERDADERO;VERDADERO;-31;;;
82840;82871;0;12629;VERDADERO;VERDADERO;-31;;;
82873;82891;0;12630;VERDADERO;VERDADERO;-18;;;
82873;82891;0;12631;VERDADERO;VERDADERO;-18;;;
82873;82891;0;12632;VERDADERO;VERDADERO;-18;;;
82873;82891;0;12633;VERDADERO;VERDADERO;-18;;;
82873;82891;0;12634;VERDADERO;VERDADERO;-18;;;
82905;82911;1;12635;VERDADERO;VERDADERO;-6;;;
82905;82911;0;12636;VERDADERO;VERDADERO;-6;;;
82905;82911;0;12637;VERDADERO;VERDADERO;-6;;;
82905;82931;0;12638;VERDADERO;VERDADERO;-26;;;
82905;82931;0;12639;VERDADERO;VERDADERO;-26;;;
82905;82951;1;12640;VERDADERO;VERDADERO;-46;;;
82940;82951;0;12641;VERDADERO;VERDADERO;-11;;;
82940;82951;0;12642;VERDADERO;VERDADERO;-11;;;
82940;82951;0;12643;VERDADERO;VERDADERO;-11;;;
82940;82951;0;12644;VERDADERO;VERDADERO;-11;;;
82940;82951;0;12645;VERDADERO;VERDADERO;-11;;;
82973;82971;0;12646;VERDADERO;VERDADERO;2;;;
82973;82971;0;12647;VERDADERO;VERDADERO;2;;;
82973;82991;0;12648;VERDADERO;VERDADERO;-18;;;
82973;82991;0;12649;VERDADERO;VERDADERO;-18;;;
82973;82991;0;12650;VERDADERO;VERDADERO;-18;;;
83005;82991;0;12651;VERDADERO;VERDADERO;14;;;
83005;82991;0;12652;VERDADERO;VERDADERO;14;;;
83005;83011;0;12653;VERDADERO;VERDADERO;-6;;;
83005;83011;0;12654;VERDADERO;VERDADERO;-6;;;
83005;83011;0;12655;VERDADERO;VERDADERO;-6;;;
83005;83031;0;12656;VERDADERO;VERDADERO;-26;;;
83040;83031;0;12657;VERDADERO;VERDADERO;9;;;
83040;83051;0;12658;VERDADERO;VERDADERO;-11;;;
83040;83051;0;12659;VERDADERO;VERDADERO;-11;;;
83040;83051;0;12660;VERDADERO;VERDADERO;-11;;;
83040;83071;0;12661;VERDADERO;VERDADERO;-31;;;
83072;83071;0;12662;VERDADERO;VERDADERO;1;;;
83072;83091;0;12663;VERDADERO;VERDADERO;-19;;;
83072;83091;0;12664;VERDADERO;VERDADERO;-19;;;
83072;83091;0;12665;VERDADERO;VERDADERO;-19;;;
83072;83111;0;12666;VERDADERO;VERDADERO;-39;;;
83104;83111;0;12667;VERDADERO;VERDADERO;-7;;;
83104;83111;0;12668;VERDADERO;VERDADERO;-7;;;
83104;83111;0;12669;VERDADERO;VERDADERO;-7;;;
83104;83131;0;12670;VERDADERO;VERDADERO;-27;;;
83104;83131;0;12671;VERDADERO;VERDADERO;-27;;;
83137;83151;0;12672;VERDADERO;VERDADERO;-14;;;
83137;83151;0;12673;VERDADERO;VERDADERO;-14;;;
83137;83151;0;12674;VERDADERO;VERDADERO;-14;;;
83137;83171;0;12675;VERDADERO;VERDADERO;-34;;;
83137;83171;0;12676;VERDADERO;VERDADERO;-34;;;
83169;83171;0;12677;VERDADERO;VERDADERO;-2;;;
83169;83171;0;12678;VERDADERO;VERDADERO;-2;;;
83169;83191;0;12679;VERDADERO;VERDADERO;-22;;;
83169;83191;0;12680;VERDADERO;VERDADERO;-22;;;
83169;83211;0;12681;VERDADERO;VERDADERO;-42;;;
83205;83211;0;12682;VERDADERO;VERDADERO;-6;;;
83205;83211;0;12683;VERDADERO;VERDADERO;-6;;;
83205;83211;0;12684;VERDADERO;VERDADERO;-6;;;
83205;83211;0;12685;VERDADERO;VERDADERO;-6;;;
83205;83231;0;12686;VERDADERO;VERDADERO;-26;;;
83236;83231;0;12687;VERDADERO;VERDADERO;5;;;
83236;83252;0;12688;VERDADERO;VERDADERO;-16;;;
83236;83252;0;12689;VERDADERO;VERDADERO;-16;;;
83236;83252;0;12690;VERDADERO;VERDADERO;-16;;;
83236;83272;0;12691;VERDADERO;VERDADERO;-36;;;
83269;83272;0;12692;VERDADERO;VERDADERO;-3;;;
83269;83292;0;12693;VERDADERO;VERDADERO;-23;;;
83269;83292;0;12694;VERDADERO;VERDADERO;-23;;;
83269;83292;0;12695;VERDADERO;VERDADERO;-23;;;
83269;83312;0;12696;VERDADERO;VERDADERO;-43;;;
83269;83312;0;12697;VERDADERO;VERDADERO;-43;;;
83269;83332;0;12698;VERDADERO;FALSO;-63;;;
83311;83332;0;12699;VERDADERO;VERDADERO;-21;;;
83311;83332;0;12700;VERDADERO;VERDADERO;-21;;;
83311;83352;0;12701;VERDADERO;VERDADERO;-41;;;
83311;83352;0;12702;VERDADERO;VERDADERO;-41;;;
83338;83372;0;12703;VERDADERO;VERDADERO;-34;;;
83338;83372;0;12704;VERDADERO;VERDADERO;-34;;;
83338;83372;0;12705;VERDADERO;VERDADERO;-34;;;
83338;83372;0;12706;VERDADERO;VERDADERO;-34;;;
83338;83372;0;12707;VERDADERO;VERDADERO;-34;;;
83369;83372;0;12708;VERDADERO;VERDADERO;-3;;;
83369;83392;0;12709;VERDADERO;VERDADERO;-23;;;
83369;83392;0;12710;VERDADERO;VERDADERO;-23;;;
83369;83412;0;12711;VERDADERO;VERDADERO;-43;;;
83369;83412;0;12712;VERDADERO;VERDADERO;-43;;;
83405;83412;0;12713;VERDADERO;VERDADERO;-7;;;
83405;83412;0;12714;VERDADERO;VERDADERO;-7;;;
83405;83432;0;12715;VERDADERO;VERDADERO;-27;;;
83405;83432;0;12716;VERDADERO;VERDADERO;-27;;;
83405;83452;0;12717;VERDADERO;VERDADERO;-47;;;
83441;83452;0;12718;VERDADERO;VERDADERO;-11;;;
83441;83452;0;12719;VERDADERO;VERDADERO;-11;;;
83441;83472;0;12720;VERDADERO;VERDADERO;-31;;;
83441;83472;0;12721;VERDADERO;VERDADERO;-31;;;
83441;83472;0;12722;VERDADERO;VERDADERO;-31;;;
83473;83472;0;12723;VERDADERO;VERDADERO;1;;;
83473;83492;0;12724;VERDADERO;VERDADERO;-19;;;
83473;83492;0;12725;VERDADERO;VERDADERO;-19;;;
83473;83512;0;12726;VERDADERO;VERDADERO;-39;;;
83473;83512;0;12727;VERDADERO;VERDADERO;-39;;;
83473;83512;0;12728;VERDADERO;VERDADERO;-39;;;
83505;83512;0;12729;VERDADERO;VERDADERO;-7;;;
83505;83512;0;12730;VERDADERO;VERDADERO;-7;;;
83505;83532;0;12731;VERDADERO;VERDADERO;-27;;;
83505;83532;0;12732;VERDADERO;VERDADERO;-27;;;
83505;83552;0;12733;VERDADERO;VERDADERO;-47;;;
83540;83552;0;12734;VERDADERO;VERDADERO;-12;;;
83540;83552;0;12735;VERDADERO;VERDADERO;-12;;;
83540;83572;0;12736;VERDADERO;VERDADERO;-32;;;
83540;83572;0;12737;VERDADERO;VERDADERO;-32;;;
83540;83572;0;12738;VERDADERO;VERDADERO;-32;;;
83540;83592;0;12739;VERDADERO;FALSO;-52;;;
83573;83592;0;12740;VERDADERO;VERDADERO;-19;;;
83573;83612;0;12741;VERDADERO;VERDADERO;-39;;;
83573;83612;0;12742;VERDADERO;VERDADERO;-39;;;
83573;83612;0;12743;VERDADERO;VERDADERO;-39;;;
83573;83612;0;12744;VERDADERO;VERDADERO;-39;;;
83605;83612;0;12745;VERDADERO;VERDADERO;-7;;;
83605;83632;0;12746;VERDADERO;VERDADERO;-27;;;
83605;83632;0;12747;VERDADERO;VERDADERO;-27;;;
83605;83652;0;12748;VERDADERO;VERDADERO;-47;;;
83605;83652;0;12749;VERDADERO;VERDADERO;-47;;;
83605;83652;0;12750;VERDADERO;VERDADERO;-47;;;
83605;83652;0;12751;VERDADERO;VERDADERO;-47;;;
83605;83652;0;12752;VERDADERO;VERDADERO;-47;;;
83605;83652;0;12753;VERDADERO;VERDADERO;-47;;;
83605;83672;0;12754;VERDADERO;FALSO;-67;;;
83673;83672;0;12755;VERDADERO;VERDADERO;1;;;
83673;83672;0;12756;VERDADERO;VERDADERO;1;;;
83673;83692;0;12757;VERDADERO;VERDADERO;-19;;;
83673;83692;0;12758;VERDADERO;VERDADERO;-19;;;
83673;83692;0;12759;VERDADERO;VERDADERO;-19;;;
83673;83712;0;12760;VERDADERO;VERDADERO;-39;;;
83705;83712;0;12761;VERDADERO;VERDADERO;-7;;;
83705;83732;0;12762;VERDADERO;VERDADERO;-27;;;
83705;83732;0;12763;VERDADERO;VERDADERO;-27;;;
83705;83732;0;12764;VERDADERO;VERDADERO;-27;;;
83705;83752;0;12765;VERDADERO;VERDADERO;-47;;;
83737;83752;0;12766;VERDADERO;VERDADERO;-15;;;
83737;83752;0;12767;VERDADERO;VERDADERO;-15;;;
83737;83752;0;12768;VERDADERO;VERDADERO;-15;;;
83737;83752;0;12769;VERDADERO;VERDADERO;-15;;;
83737;83752;0;12770;VERDADERO;VERDADERO;-15;;;
83768;83772;0;12771;VERDADERO;VERDADERO;-4;;;
83768;83772;0;12772;VERDADERO;VERDADERO;-4;;;
83768;83792;0;12773;VERDADERO;VERDADERO;-24;;;
83768;83792;0;12774;VERDADERO;VERDADERO;-24;;;
83768;83792;0;12775;VERDADERO;VERDADERO;-24;;;
83804;83812;0;12776;VERDADERO;VERDADERO;-8;;;
83804;83812;0;12777;VERDADERO;VERDADERO;-8;;;
83804;83832;0;12778;VERDADERO;VERDADERO;-28;;;
83804;83832;0;12779;VERDADERO;VERDADERO;-28;;;
83804;83832;0;12780;VERDADERO;VERDADERO;-28;;;
83836;83852;0;12781;VERDADERO;VERDADERO;-16;;;
83836;83852;0;12782;VERDADERO;VERDADERO;-16;;;
83836;83872;0;12783;VERDADERO;VERDADERO;-36;;;
83836;83872;0;12784;VERDADERO;VERDADERO;-36;;;
83836;83872;0;12785;VERDADERO;VERDADERO;-36;;;
83836;83872;0;12786;VERDADERO;VERDADERO;-36;;;
83873;83872;0;12787;VERDADERO;VERDADERO;1;;;
83873;83872;0;12788;VERDADERO;VERDADERO;1;;;
83873;83872;0;12789;VERDADERO;VERDADERO;1;;;
83873;83872;0;12790;VERDADERO;VERDADERO;1;;;
83873;83892;0;12791;VERDADERO;VERDADERO;-19;;;
83905;83892;0;12792;VERDADERO;VERDADERO;13;;;
83905;83892;0;12793;VERDADERO;VERDADERO;13;;;
83905;83912;0;12794;VERDADERO;VERDADERO;-7;;;
83905;83912;0;12795;VERDADERO;VERDADERO;-7;;;
83905;83912;0;12796;VERDADERO;VERDADERO;-7;;;
83937;83912;0;12797;VERDADERO;VERDADERO;25;;;
83937;83932;0;12798;VERDADERO;VERDADERO;5;;;
83937;83932;0;12799;VERDADERO;VERDADERO;5;;;
83937;83932;0;12800;VERDADERO;VERDADERO;5;;;
83937;83952;0;12801;VERDADERO;VERDADERO;-15;;;
83937;83952;0;12802;VERDADERO;VERDADERO;-15;;;
83973;83972;1;12803;VERDADERO;VERDADERO;1;;;
83973;83972;0;12804;VERDADERO;VERDADERO;1;;;
83973;83992;1;12805;VERDADERO;VERDADERO;-19;;;
83973;83992;0;12806;VERDADERO;VERDADERO;-19;;;
83973;83992;0;12807;VERDADERO;VERDADERO;-19;;;
84005;84012;0;12808;VERDADERO;VERDADERO;-7;;;
84005;84012;0;12809;VERDADERO;VERDADERO;-7;;;
84005;84032;0;12810;VERDADERO;VERDADERO;-27;;;
84005;84032;0;12811;VERDADERO;VERDADERO;-27;;;
84005;84032;0;12812;VERDADERO;VERDADERO;-27;;;
84037;84032;0;12813;VERDADERO;VERDADERO;5;;;
84037;84052;0;12814;VERDADERO;VERDADERO;-15;;;
84037;84052;0;12815;VERDADERO;VERDADERO;-15;;;
84037;84072;0;12816;VERDADERO;VERDADERO;-35;;;
84037;84072;0;12817;VERDADERO;VERDADERO;-35;;;
84073;84072;0;12818;VERDADERO;VERDADERO;1;;;
84073;84092;0;12819;VERDADERO;VERDADERO;-19;;;
84073;84092;0;12820;VERDADERO;VERDADERO;-19;;;
84073;84092;0;12821;VERDADERO;VERDADERO;-19;;;
84073;84112;1;12822;VERDADERO;VERDADERO;-39;;;
84105;84112;0;12823;VERDADERO;VERDADERO;-7;;;
84105;84132;0;12824;VERDADERO;VERDADERO;-27;;;
84105;84132;0;12825;VERDADERO;VERDADERO;-27;;;
84105;84132;0;12826;VERDADERO;VERDADERO;-27;;;
84105;84132;0;12827;VERDADERO;VERDADERO;-27;;;
84105;84132;0;12828;VERDADERO;VERDADERO;-27;;;
84137;84132;0;12829;VERDADERO;VERDADERO;5;;;
84137;84152;0;12830;VERDADERO;VERDADERO;-15;;;
84137;84152;0;12831;VERDADERO;VERDADERO;-15;;;
84137;84152;0;12832;VERDADERO;VERDADERO;-15;;;
84137;84173;0;12833;VERDADERO;VERDADERO;-36;;;
84173;84173;0;12834;VERDADERO;VERDADERO;0;;;
84173;84193;0;12835;VERDADERO;VERDADERO;-20;;;
84173;84193;0;12836;VERDADERO;VERDADERO;-20;;;
84173;84193;0;12837;VERDADERO;VERDADERO;-20;;;
84173;84213;0;12838;VERDADERO;VERDADERO;-40;;;
84205;84213;0;12839;VERDADERO;VERDADERO;-8;;;
84205;84233;0;12840;VERDADERO;VERDADERO;-28;;;
84205;84233;0;12841;VERDADERO;VERDADERO;-28;;;
84205;84233;0;12842;VERDADERO;VERDADERO;-28;;;
84205;84233;0;12843;VERDADERO;VERDADERO;-28;;;
84237;84233;0;12844;VERDADERO;VERDADERO;4;;;
84237;84233;0;12845;VERDADERO;VERDADERO;4;;;
84237;84253;0;12846;VERDADERO;VERDADERO;-16;;;
84237;84253;0;12847;VERDADERO;VERDADERO;-16;;;
84237;84273;0;12848;VERDADERO;VERDADERO;-36;;;
84268;84273;0;12849;VERDADERO;VERDADERO;-5;;;
84268;84273;0;12850;VERDADERO;VERDADERO;-5;;;
84268;84293;1;12851;VERDADERO;VERDADERO;-25;;;
84268;84293;0;12852;VERDADERO;VERDADERO;-25;;;
84268;84313;0;12853;VERDADERO;VERDADERO;-45;;;
84300;84313;0;12854;VERDADERO;VERDADERO;-13;;;
84300;84313;0;12855;VERDADERO;VERDADERO;-13;;;
84300;84333;0;12856;VERDADERO;VERDADERO;-33;;;
84300;84333;0;12857;VERDADERO;VERDADERO;-33;;;
84300;84333;0;12858;VERDADERO;VERDADERO;-33;;;
84333;84333;0;12859;VERDADERO;VERDADERO;0;;;
84333;84333;0;12860;VERDADERO;VERDADERO;0;;;
84333;84333;0;12861;VERDADERO;VERDADERO;0;;;
84333;84353;1;12862;VERDADERO;VERDADERO;-20;;;
84333;84353;0;12863;VERDADERO;VERDADERO;-20;;;
84364;84373;0;12864;VERDADERO;VERDADERO;-9;;;
84364;84373;0;12865;VERDADERO;VERDADERO;-9;;;
84364;84373;0;12866;VERDADERO;VERDADERO;-9;;;
84364;84393;0;12867;VERDADERO;VERDADERO;-29;;;
84364;84393;0;12868;VERDADERO;VERDADERO;-29;;;
84364;84393;0;12869;VERDADERO;VERDADERO;-29;;;
84401;84413;1;12870;VERDADERO;VERDADERO;-12;;;
84401;84413;0;12871;VERDADERO;VERDADERO;-12;;;
84401;84413;0;12872;VERDADERO;VERDADERO;-12;;;
84401;84433;0;12873;VERDADERO;VERDADERO;-32;;;
84401;84433;0;12874;VERDADERO;VERDADERO;-32;;;
84433;84453;0;12875;VERDADERO;VERDADERO;-20;;;
84433;84453;0;12876;VERDADERO;VERDADERO;-20;;;
84433;84453;0;12877;VERDADERO;VERDADERO;-20;;;
84433;84473;0;12878;VERDADERO;VERDADERO;-40;;;
84433;84473;0;12879;VERDADERO;VERDADERO;-40;;;
84464;84473;0;12880;VERDADERO;VERDADERO;-9;;;
84464;84493;0;12881;VERDADERO;VERDADERO;-29;;;
84464;84493;0;12882;VERDADERO;VERDADERO;-29;;;
84464;84493;0;12883;VERDADERO;VERDADERO;-29;;;
84464;84493;0;12884;VERDADERO;VERDADERO;-29;;;
84464;84493;0;12885;VERDADERO;VERDADERO;-29;;;
84502;84493;0;12886;VERDADERO;VERDADERO;9;;;
84502;84493;0;12887;VERDADERO;VERDADERO;9;;;
84502;84493;0;12888;VERDADERO;VERDADERO;9;;;
84502;84513;0;12889;VERDADERO;VERDADERO;-11;;;
84502;84513;0;12890;VERDADERO;VERDADERO;-11;;;
84502;84513;0;12891;VERDADERO;VERDADERO;-11;;;
84502;84533;0;12892;VERDADERO;VERDADERO;-31;;;
84502;84533;0;12893;VERDADERO;VERDADERO;-31;;;
84502;84553;0;12894;VERDADERO;FALSO;-51;;;
84502;84553;0;12895;VERDADERO;FALSO;-51;;;
84565;84553;0;12896;VERDADERO;VERDADERO;12;;;
84565;84573;0;12897;VERDADERO;VERDADERO;-8;;;
84565;84573;0;12898;VERDADERO;VERDADERO;-8;;;
84565;84593;0;12899;VERDADERO;VERDADERO;-28;;;
84565;84593;0;12900;VERDADERO;VERDADERO;-28;;;
84565;84593;0;12901;VERDADERO;VERDADERO;-28;;;
84601;84613;1;12902;VERDADERO;VERDADERO;-12;;;
84601;84613;0;12903;VERDADERO;VERDADERO;-12;;;
84601;84633;1;12904;VERDADERO;VERDADERO;-32;;;
84601;84633;0;12905;VERDADERO;VERDADERO;-32;;;
84601;84633;0;12906;VERDADERO;VERDADERO;-32;;;
84638;84653;0;12907;VERDADERO;VERDADERO;-15;;;
84638;84653;0;12908;VERDADERO;VERDADERO;-15;;;
84638;84653;0;12909;VERDADERO;VERDADERO;-15;;;
84638;84653;0;12910;VERDADERO;VERDADERO;-15;;;
84638;84673;0;12911;VERDADERO;VERDADERO;-35;;;
84669;84673;0;12912;VERDADERO;VERDADERO;-4;;;
84669;84673;0;12913;VERDADERO;VERDADERO;-4;;;
84669;84693;0;12914;VERDADERO;VERDADERO;-24;;;
84669;84693;0;12915;VERDADERO;VERDADERO;-24;;;
84669;84713;0;12916;VERDADERO;VERDADERO;-44;;;
84701;84713;0;12917;VERDADERO;VERDADERO;-12;;;
84701;84713;0;12918;VERDADERO;VERDADERO;-12;;;
84701;84733;0;12919;VERDADERO;VERDADERO;-32;;;
84701;84733;0;12920;VERDADERO;VERDADERO;-32;;;
84701;84733;0;12921;VERDADERO;VERDADERO;-32;;;
84701;84753;0;12922;VERDADERO;FALSO;-52;;;
84736;84753;0;12923;VERDADERO;VERDADERO;-17;;;
84736;84753;0;12924;VERDADERO;VERDADERO;-17;;;
84736;84753;0;12925;VERDADERO;VERDADERO;-17;;;
84736;84753;0;12926;VERDADERO;VERDADERO;-17;;;
84736;84773;0;12927;VERDADERO;VERDADERO;-37;;;
84769;84773;0;12928;VERDADERO;VERDADERO;-4;;;
84769;84773;0;12929;VERDADERO;VERDADERO;-4;;;
84769;84793;0;12930;VERDADERO;VERDADERO;-24;;;
84769;84793;0;12931;VERDADERO;VERDADERO;-24;;;
84769;84813;0;12932;VERDADERO;VERDADERO;-44;;;
84769;84813;0;12933;VERDADERO;VERDADERO;-44;;;
84805;84813;0;12934;VERDADERO;VERDADERO;-8;;;
84805;84813;0;12935;VERDADERO;VERDADERO;-8;;;
84805;84833;0;12936;VERDADERO;VERDADERO;-28;;;
84805;84833;0;12937;VERDADERO;VERDADERO;-28;;;
84805;84853;0;12938;VERDADERO;VERDADERO;-48;;;
84837;84853;0;12939;VERDADERO;VERDADERO;-16;;;
84837;84853;0;12940;VERDADERO;VERDADERO;-16;;;
84837;84853;0;12941;VERDADERO;VERDADERO;-16;;;
84837;84853;0;12942;VERDADERO;VERDADERO;-16;;;
84837;84873;0;12943;VERDADERO;VERDADERO;-36;;;
84837;84873;0;12944;VERDADERO;VERDADERO;-36;;;
84873;84893;0;12945;VERDADERO;VERDADERO;-20;;;
84873;84893;0;12946;VERDADERO;VERDADERO;-20;;;
84873;84893;0;12947;VERDADERO;VERDADERO;-20;;;
84873;84913;0;12948;VERDADERO;VERDADERO;-40;;;
84873;84913;0;12949;VERDADERO;VERDADERO;-40;;;
84905;84933;0;12950;VERDADERO;VERDADERO;-28;;;
84905;84933;0;12951;VERDADERO;VERDADERO;-28;;;
84905;84933;0;12952;VERDADERO;VERDADERO;-28;;;
84905;84953;0;12953;VERDADERO;VERDADERO;-48;;;
84905;84953;0;12954;VERDADERO;VERDADERO;-48;;;
84936;84953;0;12955;VERDADERO;VERDADERO;-17;;;
84936;84953;0;12956;VERDADERO;VERDADERO;-17;;;
84936;84973;0;12957;VERDADERO;VERDADERO;-37;;;
84936;84973;0;12958;VERDADERO;VERDADERO;-37;;;
84936;84993;0;12959;VERDADERO;FALSO;-57;;;
84973;84993;0;12960;VERDADERO;VERDADERO;-20;;;
84973;84993;0;12961;VERDADERO;VERDADERO;-20;;;
84973;84993;0;12962;VERDADERO;VERDADERO;-20;;;
84973;84993;0;12963;VERDADERO;VERDADERO;-20;;;
84973;84993;0;12964;VERDADERO;VERDADERO;-20;;;
84973;85013;0;12965;VERDADERO;VERDADERO;-40;;;
85004;85013;0;12966;VERDADERO;VERDADERO;-9;;;
85004;85033;0;12967;VERDADERO;VERDADERO;-29;;;
85004;85033;0;12968;VERDADERO;VERDADERO;-29;;;
85004;85033;0;12969;VERDADERO;VERDADERO;-29;;;
85004;85053;0;12970;VERDADERO;VERDADERO;-49;;;
85036;85053;0;12971;VERDADERO;VERDADERO;-17;;;
85036;85073;0;12972;VERDADERO;VERDADERO;-37;;;
85036;85073;0;12973;VERDADERO;VERDADERO;-37;;;
85036;85073;0;12974;VERDADERO;VERDADERO;-37;;;
85036;85093;1;12975;VERDADERO;FALSO;-57;;;
85069;85093;0;12976;VERDADERO;VERDADERO;-24;;;
85069;85093;0;12977;VERDADERO;VERDADERO;-24;;;
85069;85093;0;12978;VERDADERO;VERDADERO;-24;;;
85069;85093;0;12979;VERDADERO;VERDADERO;-24;;;
85069;85093;0;12980;VERDADERO;VERDADERO;-24;;;
85101;85113;0;12981;VERDADERO;VERDADERO;-12;;;
85101;85113;0;12982;VERDADERO;VERDADERO;-12;;;
85101;85133;0;12983;VERDADERO;VERDADERO;-32;;;
85101;85133;0;12984;VERDADERO;VERDADERO;-32;;;
85101;85133;0;12985;VERDADERO;VERDADERO;-32;;;
85137;85153;0;12986;VERDADERO;VERDADERO;-16;;;
85137;85153;0;12987;VERDADERO;VERDADERO;-16;;;
85137;85173;0;12988;VERDADERO;VERDADERO;-36;;;
85137;85173;0;12989;VERDADERO;VERDADERO;-36;;;
85137;85173;0;12990;VERDADERO;VERDADERO;-36;;;
85169;85193;0;12991;VERDADERO;VERDADERO;-24;;;
85169;85193;0;12992;VERDADERO;VERDADERO;-24;;;
85169;85193;0;12993;VERDADERO;VERDADERO;-24;;;
85169;85193;0;12994;VERDADERO;VERDADERO;-24;;;
85169;85193;0;12995;VERDADERO;VERDADERO;-24;;;
85200;85193;0;12996;VERDADERO;VERDADERO;7;;;
85200;85213;0;12997;VERDADERO;VERDADERO;-13;;;
85200;85213;0;12998;VERDADERO;VERDADERO;-13;;;
85200;85213;0;12999;VERDADERO;VERDADERO;-13;;;
85200;85233;0;13000;VERDADERO;VERDADERO;-33;;;
85200;85233;0;13001;VERDADERO;VERDADERO;-33;;;
85233;85253;0;13002;VERDADERO;VERDADERO;-20;;;
85233;85253;0;13003;VERDADERO;VERDADERO;-20;;;
85233;85253;0;13004;VERDADERO;VERDADERO;-20;;;
85233;85273;0;13005;VERDADERO;VERDADERO;-40;;;
85265;85273;0;13006;VERDADERO;VERDADERO;-8;;;
85265;85293;0;13007;VERDADERO;VERDADERO;-28;;;
85265;85293;0;13008;VERDADERO;VERDADERO;-28;;;
85265;85293;0;13009;VERDADERO;VERDADERO;-28;;;
85265;85293;0;13010;VERDADERO;VERDADERO;-28;;;
85265;85293;0;13011;VERDADERO;VERDADERO;-28;;;
85300;85293;0;13012;VERDADERO;VERDADERO;7;;;
85300;85313;0;13013;VERDADERO;VERDADERO;-13;;;
85300;85313;0;13014;VERDADERO;VERDADERO;-13;;;
85300;85313;0;13015;VERDADERO;VERDADERO;-13;;;
85300;85333;0;13016;VERDADERO;VERDADERO;-33;;;
85333;85333;0;13017;VERDADERO;VERDADERO;0;;;
85333;85353;0;13018;VERDADERO;VERDADERO;-20;;;
85333;85353;0;13019;VERDADERO;VERDADERO;-20;;;
85333;85353;0;13020;VERDADERO;VERDADERO;-20;;;
85333;85373;0;13021;VERDADERO;VERDADERO;-40;;;
85365;85373;0;13022;VERDADERO;VERDADERO;-8;;;
85365;85393;1;13023;VERDADERO;VERDADERO;-28;;;
85365;85393;0;13024;VERDADERO;VERDADERO;-28;;;
85365;85393;0;13025;VERDADERO;VERDADERO;-28;;;
85365;85393;0;13026;VERDADERO;VERDADERO;-28;;;
85397;85393;0;13027;VERDADERO;VERDADERO;4;;;
85397;85413;0;13028;VERDADERO;VERDADERO;-16;;;
85397;85413;0;13029;VERDADERO;VERDADERO;-16;;;
85397;85413;0;13030;VERDADERO;VERDADERO;-16;;;
85397;85433;0;13031;VERDADERO;VERDADERO;-36;;;
85429;85433;0;13032;VERDADERO;VERDADERO;-4;;;
85429;85433;0;13033;VERDADERO;VERDADERO;-4;;;
85429;85453;0;13034;VERDADERO;VERDADERO;-24;;;
85429;85453;0;13035;VERDADERO;VERDADERO;-24;;;
85429;85473;0;13036;VERDADERO;VERDADERO;-44;;;
85429;85473;0;13037;VERDADERO;VERDADERO;-44;;;
85465;85493;0;13038;VERDADERO;VERDADERO;-28;;;
85465;85493;0;13039;VERDADERO;VERDADERO;-28;;;
85465;85493;0;13040;VERDADERO;VERDADERO;-28;;;
85465;85493;0;13041;VERDADERO;VERDADERO;-28;;;
85465;85493;0;13042;VERDADERO;VERDADERO;-28;;;
85496;85493;0;13043;VERDADERO;VERDADERO;3;;;
85496;85513;0;13044;VERDADERO;VERDADERO;-17;;;
85496;85513;0;13045;VERDADERO;VERDADERO;-17;;;
85496;85513;0;13046;VERDADERO;VERDADERO;-17;;;
85496;85533;0;13047;VERDADERO;VERDADERO;-37;;;
85496;85533;0;13048;VERDADERO;VERDADERO;-37;;;
85533;85553;1;13049;VERDADERO;VERDADERO;-20;;;
85533;85553;0;13050;VERDADERO;VERDADERO;-20;;;
85533;85553;0;13051;VERDADERO;VERDADERO;-20;;;
85533;85573;1;13052;VERDADERO;VERDADERO;-40;;;
85564;85573;0;13053;VERDADERO;VERDADERO;-9;;;
85564;85593;0;13054;VERDADERO;VERDADERO;-29;;;
85564;85593;0;13055;VERDADERO;VERDADERO;-29;;;
85564;85593;0;13056;VERDADERO;VERDADERO;-29;;;
85564;85593;0;13057;VERDADERO;VERDADERO;-29;;;
85564;85613;0;13058;VERDADERO;VERDADERO;-49;;;
85601;85613;0;13059;VERDADERO;VERDADERO;-12;;;
85601;85613;0;13060;VERDADERO;VERDADERO;-12;;;
85601;85633;0;13061;VERDADERO;VERDADERO;-32;;;
85601;85633;0;13062;VERDADERO;VERDADERO;-32;;;
85601;85633;0;13063;VERDADERO;VERDADERO;-32;;;
85601;85633;0;13064;VERDADERO;VERDADERO;-32;;;
85633;85633;0;13065;VERDADERO;VERDADERO;0;;;
85633;85653;0;13066;VERDADERO;VERDADERO;-20;;;
85633;85653;0;13067;VERDADERO;VERDADERO;-20;;;
85633;85673;0;13068;VERDADERO;VERDADERO;-40;;;
85633;85673;0;13069;VERDADERO;VERDADERO;-40;;;
85668;85693;0;13070;VERDADERO;VERDADERO;-25;;;
85668;85693;0;13071;VERDADERO;VERDADERO;-25;;;
85668;85693;0;13072;VERDADERO;VERDADERO;-25;;;
85668;85713;0;13073;VERDADERO;VERDADERO;-45;;;
85668;85713;0;13074;VERDADERO;VERDADERO;-45;;;
85701;85733;0;13075;VERDADERO;VERDADERO;-32;;;
85701;85733;0;13076;VERDADERO;VERDADERO;-32;;;
85701;85733;0;13077;VERDADERO;VERDADERO;-32;;;
85701;85733;0;13078;VERDADERO;VERDADERO;-32;;;
85701;85733;0;13079;VERDADERO;VERDADERO;-32;;;
85701;85733;0;13080;VERDADERO;VERDADERO;-32;;;
85737;85753;0;13081;VERDADERO;VERDADERO;-16;;;
85737;85753;0;13082;VERDADERO;VERDADERO;-16;;;
85737;85773;0;13083;VERDADERO;VERDADERO;-36;;;
85737;85773;0;13084;VERDADERO;VERDADERO;-36;;;
85737;85773;0;13085;VERDADERO;VERDADERO;-36;;;
85771;85773;0;13086;VERDADERO;VERDADERO;-2;;;
85771;85773;0;13087;VERDADERO;VERDADERO;-2;;;
85771;85793;0;13088;VERDADERO;VERDADERO;-22;;;
85771;85793;0;13089;VERDADERO;VERDADERO;-22;;;
85771;85793;0;13090;VERDADERO;VERDADERO;-22;;;
85771;85814;0;13091;VERDADERO;VERDADERO;-43;;;
85805;85814;0;13092;VERDADERO;VERDADERO;-9;;;
85805;85834;0;13093;VERDADERO;VERDADERO;-29;;;
85805;85834;0;13094;VERDADERO;VERDADERO;-29;;;
85805;85834;0;13095;VERDADERO;VERDADERO;-29;;;
85805;85834;0;13096;VERDADERO;VERDADERO;-29;;;
85837;85854;0;13097;VERDADERO;VERDADERO;-17;;;
85837;85854;0;13098;VERDADERO;VERDADERO;-17;;;
85837;85874;0;13099;VERDADERO;VERDADERO;-37;;;
85837;85874;0;13100;VERDADERO;VERDADERO;-37;;;
85837;85874;0;13101;VERDADERO;VERDADERO;-37;;;
85869;85874;0;13102;VERDADERO;VERDADERO;-5;;;
85869;85874;0;13103;VERDADERO;VERDADERO;-5;;;
85869;85894;1;13104;VERDADERO;VERDADERO;-25;;;
85869;85894;0;13105;VERDADERO;VERDADERO;-25;;;
85869;85894;0;13106;VERDADERO;VERDADERO;-25;;;
85904;85914;0;13107;VERDADERO;VERDADERO;-10;;;
85904;85914;0;13108;VERDADERO;VERDADERO;-10;;;
85904;85934;0;13109;VERDADERO;VERDADERO;-30;;;
85904;85934;0;13110;VERDADERO;VERDADERO;-30;;;
85904;85934;0;13111;VERDADERO;VERDADERO;-30;;;
85932;85954;0;13112;VERDADERO;VERDADERO;-22;;;
85932;85954;0;13113;VERDADERO;VERDADERO;-22;;;
85932;85954;0;13114;VERDADERO;VERDADERO;-22;;;
85932;85974;0;13115;VERDADERO;VERDADERO;-42;;;
85932;85974;0;13116;VERDADERO;VERDADERO;-42;;;
85969;85974;0;13117;VERDADERO;VERDADERO;-5;;;
85969;85974;0;13118;VERDADERO;VERDADERO;-5;;;
85969;85974;0;13119;VERDADERO;VERDADERO;-5;;;
85969;85974;0;13120;VERDADERO;VERDADERO;-5;;;
85969;85994;0;13121;VERDADERO;VERDADERO;-25;;;
86000;85994;0;13122;VERDADERO;VERDADERO;6;;;
86000;86015;0;13123;VERDADERO;VERDADERO;-15;;;
86000;86015;0;13124;VERDADERO;VERDADERO;-15;;;
86000;86015;0;13125;VERDADERO;VERDADERO;-15;;;
86000;86035;0;13126;VERDADERO;VERDADERO;-35;;;
86000;86035;0;13127;VERDADERO;VERDADERO;-35;;;
86035;86035;0;13128;VERDADERO;VERDADERO;0;;;
86035;86055;0;13129;VERDADERO;VERDADERO;-20;;;
86035;86055;0;13130;VERDADERO;VERDADERO;-20;;;
86035;86075;0;13131;VERDADERO;VERDADERO;-40;;;
86035;86075;0;13132;VERDADERO;VERDADERO;-40;;;
86064;86075;0;13133;VERDADERO;VERDADERO;-11;;;
86064;86095;1;13134;VERDADERO;VERDADERO;-31;;;
86064;86095;0;13135;VERDADERO;VERDADERO;-31;;;
86064;86115;0;13136;VERDADERO;FALSO;-51;;;
86064;86115;0;13137;VERDADERO;FALSO;-51;;;
86096;86115;0;13138;VERDADERO;VERDADERO;-19;;;
86096;86135;1;13139;VERDADERO;VERDADERO;-39;;;
86096;86135;0;13140;VERDADERO;VERDADERO;-39;;;
86096;86135;0;13141;VERDADERO;VERDADERO;-39;;;
86096;86135;0;13142;VERDADERO;VERDADERO;-39;;;
86133;86135;0;13143;VERDADERO;VERDADERO;-2;;;
86133;86135;0;13144;VERDADERO;VERDADERO;-2;;;
86133;86155;0;13145;VERDADERO;VERDADERO;-22;;;
86133;86155;0;13146;VERDADERO;VERDADERO;-22;;;
86133;86175;0;13147;VERDADERO;VERDADERO;-42;;;
86133;86175;0;13148;VERDADERO;VERDADERO;-42;;;
86169;86175;0;13149;VERDADERO;VERDADERO;-6;;;
86169;86175;0;13150;VERDADERO;VERDADERO;-6;;;
86169;86175;0;13151;VERDADERO;VERDADERO;-6;;;
86169;86175;0;13152;VERDADERO;VERDADERO;-6;;;
86169;86175;0;13153;VERDADERO;VERDADERO;-6;;;
86201;86195;0;13154;VERDADERO;VERDADERO;6;;;
86201;86195;0;13155;VERDADERO;VERDADERO;6;;;
86201;86195;0;13156;VERDADERO;VERDADERO;6;;;
86201;86215;0;13157;VERDADERO;VERDADERO;-14;;;
86201;86215;0;13158;VERDADERO;VERDADERO;-14;;;
86233;86235;0;13159;VERDADERO;VERDADERO;-2;;;
86233;86235;0;13160;VERDADERO;VERDADERO;-2;;;
86233;86235;0;13161;VERDADERO;VERDADERO;-2;;;
86233;86255;0;13162;VERDADERO;VERDADERO;-22;;;
86233;86255;0;13163;VERDADERO;VERDADERO;-22;;;
86233;86275;0;13164;VERDADERO;VERDADERO;-42;;;
86269;86275;0;13165;VERDADERO;VERDADERO;-6;;;
86269;86295;0;13166;VERDADERO;VERDADERO;-26;;;
86269;86295;0;13167;VERDADERO;VERDADERO;-26;;;
86269;86295;0;13168;VERDADERO;VERDADERO;-26;;;
86269;86315;0;13169;VERDADERO;VERDADERO;-46;;;
86301;86315;0;13170;VERDADERO;VERDADERO;-14;;;
86301;86315;0;13171;VERDADERO;VERDADERO;-14;;;
86301;86335;0;13172;VERDADERO;VERDADERO;-34;;;
86301;86335;0;13173;VERDADERO;VERDADERO;-34;;;
86301;86335;0;13174;VERDADERO;VERDADERO;-34;;;
86337;86335;0;13175;VERDADERO;VERDADERO;2;;;
86337;86335;0;13176;VERDADERO;VERDADERO;2;;;
86337;86335;0;13177;VERDADERO;VERDADERO;2;;;
86337;86335;0;13178;VERDADERO;VERDADERO;2;;;
86337;86335;0;13179;VERDADERO;VERDADERO;2;;;
86369;86355;0;13180;VERDADERO;VERDADERO;14;;;
86369;86355;0;13181;VERDADERO;VERDADERO;14;;;
86369;86375;0;13182;VERDADERO;VERDADERO;-6;;;
86369;86375;0;13183;VERDADERO;VERDADERO;-6;;;
86369;86375;0;13184;VERDADERO;VERDADERO;-6;;;
86369;86395;0;13185;VERDADERO;VERDADERO;-26;;;
86405;86395;0;13186;VERDADERO;VERDADERO;10;;;
86405;86415;0;13187;VERDADERO;VERDADERO;-10;;;
86405;86415;0;13188;VERDADERO;VERDADERO;-10;;;
86405;86415;0;13189;VERDADERO;VERDADERO;-10;;;
86405;86435;0;13190;VERDADERO;VERDADERO;-30;;;
86437;86435;0;13191;VERDADERO;VERDADERO;2;;;
86437;86455;0;13192;VERDADERO;VERDADERO;-18;;;
86437;86455;0;13193;VERDADERO;VERDADERO;-18;;;
86437;86455;0;13194;VERDADERO;VERDADERO;-18;;;
86437;86475;0;13195;VERDADERO;VERDADERO;-38;;;
86469;86475;0;13196;VERDADERO;VERDADERO;-6;;;
86469;86495;0;13197;VERDADERO;VERDADERO;-26;;;
86469;86495;0;13198;VERDADERO;VERDADERO;-26;;;
86469;86495;0;13199;VERDADERO;VERDADERO;-26;;;
86469;86495;0;13200;VERDADERO;VERDADERO;-26;;;
86501;86495;0;13201;VERDADERO;VERDADERO;6;;;
86501;86515;0;13202;VERDADERO;VERDADERO;-14;;;
86501;86515;0;13203;VERDADERO;VERDADERO;-14;;;
86501;86515;0;13204;VERDADERO;VERDADERO;-14;;;
86501;86535;1;13205;VERDADERO;VERDADERO;-34;;;
86533;86535;0;13206;VERDADERO;VERDADERO;-2;;;
86533;86555;0;13207;VERDADERO;VERDADERO;-22;;;
86533;86555;0;13208;VERDADERO;VERDADERO;-22;;;
86533;86555;0;13209;VERDADERO;VERDADERO;-22;;;
86533;86575;0;13210;VERDADERO;VERDADERO;-42;;;
86565;86575;0;13211;VERDADERO;VERDADERO;-10;;;
86565;86575;0;13212;VERDADERO;VERDADERO;-10;;;
86565;86595;0;13213;VERDADERO;VERDADERO;-30;;;
86565;86595;0;13214;VERDADERO;VERDADERO;-30;;;
86565;86595;0;13215;VERDADERO;VERDADERO;-30;;;
86596;86595;0;13216;VERDADERO;VERDADERO;1;;;
86596;86615;0;13217;VERDADERO;VERDADERO;-19;;;
86596;86615;0;13218;VERDADERO;VERDADERO;-19;;;
86596;86635;1;13219;VERDADERO;VERDADERO;-39;;;
86596;86635;0;13220;VERDADERO;VERDADERO;-39;;;
86596;86635;0;13221;VERDADERO;VERDADERO;-39;;;
86633;86655;1;13222;VERDADERO;VERDADERO;-22;;;
86633;86655;0;13223;VERDADERO;VERDADERO;-22;;;
86633;86655;0;13224;VERDADERO;VERDADERO;-22;;;
86633;86655;0;13225;VERDADERO;VERDADERO;-22;;;
86633;86675;0;13226;VERDADERO;VERDADERO;-42;;;
86665;86675;0;13227;VERDADERO;VERDADERO;-10;;;
86665;86675;0;13228;VERDADERO;VERDADERO;-10;;;
86665;86695;0;13229;VERDADERO;VERDADERO;-30;;;
86665;86695;0;13230;VERDADERO;VERDADERO;-30;;;
86665;86695;0;13231;VERDADERO;VERDADERO;-30;;;
86697;86695;0;13232;VERDADERO;VERDADERO;2;;;
86697;86715;0;13233;VERDADERO;VERDADERO;-18;;;
86697;86715;0;13234;VERDADERO;VERDADERO;-18;;;
86697;86715;0;13235;VERDADERO;VERDADERO;-18;;;
86697;86735;0;13236;VERDADERO;VERDADERO;-38;;;
86697;86735;0;13237;VERDADERO;VERDADERO;-38;;;
86733;86755;1;13238;VERDADERO;VERDADERO;-22;;;
86733;86755;0;13239;VERDADERO;VERDADERO;-22;;;
86733;86755;0;13240;VERDADERO;VERDADERO;-22;;;
86733;86775;0;13241;VERDADERO;VERDADERO;-42;;;
86733;86775;0;13242;VERDADERO;VERDADERO;-42;;;
86765;86775;0;13243;VERDADERO;VERDADERO;-10;;;
86765;86795;0;13244;VERDADERO;VERDADERO;-30;;;
86765;86795;0;13245;VERDADERO;VERDADERO;-30;;;
86765;86795;0;13246;VERDADERO;VERDADERO;-30;;;
86765;86795;0;13247;VERDADERO;VERDADERO;-30;;;
86801;86795;0;13248;VERDADERO;VERDADERO;6;;;
86801;86815;0;13249;VERDADERO;VERDADERO;-14;;;
86801;86815;0;13250;VERDADERO;VERDADERO;-14;;;
86801;86815;0;13251;VERDADERO;VERDADERO;-14;;;
86801;86835;0;13252;VERDADERO;VERDADERO;-34;;;
86801;86835;0;13253;VERDADERO;VERDADERO;-34;;;
86834;86855;1;13254;VERDADERO;VERDADERO;-21;;;
86834;86855;0;13255;VERDADERO;VERDADERO;-21;;;
86834;86855;0;13256;VERDADERO;VERDADERO;-21;;;
86834;86875;0;13257;VERDADERO;VERDADERO;-41;;;
86834;86875;0;13258;VERDADERO;VERDADERO;-41;;;
86869;86895;0;13259;VERDADERO;VERDADERO;-26;;;
86869;86895;0;13260;VERDADERO;VERDADERO;-26;;;
86869;86895;0;13261;VERDADERO;VERDADERO;-26;;;
86869;86895;0;13262;VERDADERO;VERDADERO;-26;;;
86869;86895;0;13263;VERDADERO;VERDADERO;-26;;;
86869;86915;0;13264;VERDADERO;VERDADERO;-46;;;
86901;86915;0;13265;VERDADERO;VERDADERO;-14;;;
86901;86935;0;13266;VERDADERO;VERDADERO;-34;;;
86901;86935;0;13267;VERDADERO;VERDADERO;-34;;;
86901;86935;0;13268;VERDADERO;VERDADERO;-34;;;
86901;86935;0;13269;VERDADERO;VERDADERO;-34;;;
86937;86935;0;13270;VERDADERO;VERDADERO;2;;;
86937;86935;0;13271;VERDADERO;VERDADERO;2;;;
86937;86955;0;13272;VERDADERO;VERDADERO;-18;;;
86937;86955;0;13273;VERDADERO;VERDADERO;-18;;;
86937;86975;0;13274;VERDADERO;VERDADERO;-38;;;
86970;86975;0;13275;VERDADERO;VERDADERO;-5;;;
86970;86995;0;13276;VERDADERO;VERDADERO;-25;;;
86970;86995;0;13277;VERDADERO;VERDADERO;-25;;;
86970;86995;0;13278;VERDADERO;VERDADERO;-25;;;
86970;86995;0;13279;VERDADERO;VERDADERO;-25;;;
86970;86995;0;13280;VERDADERO;VERDADERO;-25;;;
87005;86995;0;13281;VERDADERO;VERDADERO;10;;;
87005;86995;0;13282;VERDADERO;VERDADERO;10;;;
87005;86995;0;13283;VERDADERO;VERDADERO;10;;;
87005;86995;0;13284;VERDADERO;VERDADERO;10;;;
87005;86995;0;13285;VERDADERO;VERDADERO;10;;;
87036;87015;0;13286;VERDADERO;VERDADERO;21;;;
87036;87015;0;13287;VERDADERO;VERDADERO;21;;;
87036;87015;0;13288;VERDADERO;VERDADERO;21;;;
87036;87035;0;13289;VERDADERO;VERDADERO;1;;;
87036;87035;0;13290;VERDADERO;VERDADERO;1;;;
87069;87035;0;13291;VERDADERO;VERDADERO;34;;;
87069;87035;0;13292;VERDADERO;VERDADERO;34;;;
87069;87055;1;13293;VERDADERO;VERDADERO;14;;;
87069;87055;0;13294;VERDADERO;VERDADERO;14;;;
87069;87075;0;13295;VERDADERO;VERDADERO;-6;;;
87102;87075;0;13296;VERDADERO;VERDADERO;27;;;
87102;87075;0;13297;VERDADERO;VERDADERO;27;;;
87102;87095;0;13298;VERDADERO;VERDADERO;7;;;
87102;87095;0;13299;VERDADERO;VERDADERO;7;;;
87102;87115;0;13300;VERDADERO;VERDADERO;-13;;;
87133;87115;0;13301;VERDADERO;VERDADERO;18;;;
87133;87115;0;13302;VERDADERO;VERDADERO;18;;;
87133;87135;0;13303;VERDADERO;VERDADERO;-2;;;
87133;87135;0;13304;VERDADERO;VERDADERO;-2;;;
87133;87155;0;13305;VERDADERO;VERDADERO;-22;;;
87169;87155;0;13306;VERDADERO;VERDADERO;14;;;
87169;87155;0;13307;VERDADERO;VERDADERO;14;;;
87169;87175;0;13308;VERDADERO;VERDADERO;-6;;;
87169;87175;0;13309;VERDADERO;VERDADERO;-6;;;
87169;87195;0;13310;VERDADERO;VERDADERO;-26;;;
87200;87195;0;13311;VERDADERO;VERDADERO;5;;;
87200;87195;0;13312;VERDADERO;VERDADERO;5;;;
87200;87215;0;13313;VERDADERO;VERDADERO;-15;;;
87200;87215;0;13314;VERDADERO;VERDADERO;-15;;;
87200;87235;0;13315;VERDADERO;VERDADERO;-35;;;
87200;87235;0;13316;VERDADERO;VERDADERO;-35;;;
87235;87235;0;13317;VERDADERO;VERDADERO;0;;;
87235;87256;0;13318;VERDADERO;VERDADERO;-21;;;
87235;87256;0;13319;VERDADERO;VERDADERO;-21;;;
87235;87276;0;13320;VERDADERO;VERDADERO;-41;;;
87265;87276;0;13321;VERDADERO;VERDADERO;-11;;;
87265;87276;0;13322;VERDADERO;VERDADERO;-11;;;
87265;87276;0;13323;VERDADERO;VERDADERO;-11;;;
87265;87296;0;13324;VERDADERO;VERDADERO;-31;;;
87265;87296;0;13325;VERDADERO;VERDADERO;-31;;;
87297;87316;0;13326;VERDADERO;VERDADERO;-19;;;
87297;87316;0;13327;VERDADERO;VERDADERO;-19;;;
87297;87316;0;13328;VERDADERO;VERDADERO;-19;;;
87297;87316;0;13329;VERDADERO;VERDADERO;-19;;;
87297;87316;0;13330;VERDADERO;VERDADERO;-19;;;
87297;87316;0;13331;VERDADERO;VERDADERO;-19;;;
87329;87316;0;13332;VERDADERO;VERDADERO;13;;;
87329;87316;0;13333;VERDADERO;VERDADERO;13;;;
87329;87316;0;13334;VERDADERO;VERDADERO;13;;;
87329;87316;0;13335;VERDADERO;VERDADERO;13;;;
87329;87316;0;13336;VERDADERO;VERDADERO;13;;;
87361;87316;0;13337;VERDADERO;VERDADERO;45;;;
87361;87316;0;13338;VERDADERO;VERDADERO;45;;;
87361;87316;0;13339;VERDADERO;VERDADERO;45;;;
87361;87316;0;13340;VERDADERO;VERDADERO;45;;;
87361;87316;0;13341;VERDADERO;VERDADERO;45;;;
87361;87316;0;13342;VERDADERO;VERDADERO;45;;;
87397;87316;0;13343;FALSO;VERDADERO;81;;;
87397;87316;0;13344;FALSO;VERDADERO;81;;;
87397;87316;0;13345;FALSO;VERDADERO;81;;;
87397;87316;0;13346;FALSO;VERDADERO;81;;;
87397;87316;0;13347;FALSO;VERDADERO;81;;;
87429;87316;0;13348;FALSO;VERDADERO;113;;;
87429;87316;0;13349;FALSO;VERDADERO;113;;;
87429;87316;0;13350;FALSO;VERDADERO;113;;;
87429;87316;0;13351;FALSO;VERDADERO;113;;;
87429;87316;0;13352;FALSO;VERDADERO;113;;;
87429;87316;0;13353;FALSO;VERDADERO;113;;;
87462;87316;0;13354;FALSO;VERDADERO;146;;;
87462;87316;0;13355;FALSO;VERDADERO;146;;;
87462;87316;0;13356;FALSO;VERDADERO;146;;;
87462;87316;0;13357;FALSO;VERDADERO;146;;;
87462;87316;0;13358;FALSO;VERDADERO;146;;;
87497;87316;0;13359;FALSO;VERDADERO;181;;;
87497;87316;0;13360;FALSO;VERDADERO;181;;;
87497;87316;0;13361;FALSO;VERDADERO;181;;;
87497;87316;0;13362;FALSO;VERDADERO;181;;;
87497;87316;0;13363;FALSO;VERDADERO;181;;;
87529;87316;0;13364;FALSO;VERDADERO;213;;;
87529;87316;0;13365;FALSO;VERDADERO;213;;;
87529;87316;0;13366;FALSO;VERDADERO;213;;;
87529;87316;0;13367;FALSO;VERDADERO;213;;;
87529;87316;0;13368;FALSO;VERDADERO;213;;;
87529;87316;0;13369;FALSO;VERDADERO;213;;;
87565;87316;0;13370;FALSO;VERDADERO;249;;;
87565;87316;0;13371;FALSO;VERDADERO;249;;;
87565;87316;0;13372;FALSO;VERDADERO;249;;;
87565;87316;0;13373;FALSO;VERDADERO;249;;;
87565;87316;0;13374;FALSO;VERDADERO;249;;;
87565;87316;0;13375;FALSO;VERDADERO;249;;;
87597;87316;0;13376;FALSO;VERDADERO;281;;;
87597;87316;0;13377;FALSO;VERDADERO;281;;;
87597;87316;0;13378;FALSO;VERDADERO;281;;;
87597;87316;0;13379;FALSO;VERDADERO;281;;;
87597;87316;0;13380;FALSO;VERDADERO;281;;;
87597;87316;0;13381;FALSO;VERDADERO;281;;;
87633;87316;0;13382;FALSO;VERDADERO;317;;;
87633;87316;0;13383;FALSO;VERDADERO;317;;;
87633;87316;0;13384;FALSO;VERDADERO;317;;;
87633;87316;0;13385;FALSO;VERDADERO;317;;;
87633;87316;0;13386;FALSO;VERDADERO;317;;;
87664;87316;0;13387;FALSO;VERDADERO;348;;;
87664;87316;0;13388;FALSO;VERDADERO;348;;;
87664;87316;0;13389;FALSO;VERDADERO;348;;;
87664;87316;0;13390;FALSO;VERDADERO;348;;;
87664;87316;0;13391;FALSO;VERDADERO;348;;;
87697;87316;0;13392;FALSO;VERDADERO;381;;;
87697;87316;0;13393;FALSO;VERDADERO;381;;;
87697;87316;0;13394;FALSO;VERDADERO;381;;;
87697;87316;0;13395;FALSO;VERDADERO;381;;;
87697;87316;0;13396;FALSO;VERDADERO;381;;;
87697;87316;0;13397;FALSO;VERDADERO;381;;;
87733;87316;0;13398;FALSO;VERDADERO;417;;;
87733;87316;0;13399;FALSO;VERDADERO;417;;;
87733;87316;0;13400;FALSO;VERDADERO;417;;;
87733;87316;0;13401;FALSO;VERDADERO;417;;;
87733;87316;0;13402;FALSO;VERDADERO;417;;;
87764;87316;0;13403;FALSO;VERDADERO;448;;;
87764;87316;0;13404;FALSO;VERDADERO;448;;;
87764;87316;0;13405;FALSO;VERDADERO;448;;;
87764;87316;0;13406;FALSO;VERDADERO;448;;;
87764;87316;0;13407;FALSO;VERDADERO;448;;;
87764;87316;0;13408;FALSO;VERDADERO;448;;;
87800;87316;0;13409;FALSO;VERDADERO;484;;;
87800;87316;0;13410;FALSO;VERDADERO;484;;;
87800;87316;0;13411;FALSO;VERDADERO;484;;;
87800;87316;0;13412;FALSO;VERDADERO;484;;;
87800;87316;0;13413;FALSO;VERDADERO;484;;;
87800;87316;0;13414;FALSO;VERDADERO;484;;;
87833;87316;0;13415;FALSO;VERDADERO;517;;;
87833;87316;0;13416;FALSO;VERDADERO;517;;;
87833;87316;0;13417;FALSO;VERDADERO;517;;;
87833;87316;0;13418;FALSO;VERDADERO;517;;;
87833;87316;0;13419;FALSO;VERDADERO;517;;;
87865;87316;0;13420;FALSO;VERDADERO;549;;;
87865;87316;0;13421;FALSO;VERDADERO;549;;;
87865;87316;0;13422;FALSO;VERDADERO;549;;;
87865;87316;0;13423;FALSO;VERDADERO;549;;;
87865;87316;0;13424;FALSO;VERDADERO;549;;;
87896;87316;0;13425;FALSO;VERDADERO;580;;;
87896;87316;0;13426;FALSO;VERDADERO;580;;;
87896;87316;0;13427;FALSO;VERDADERO;580;;;
87896;87316;0;13428;FALSO;VERDADERO;580;;;
87896;87316;0;13429;FALSO;VERDADERO;580;;;
87929;87316;0;13430;FALSO;VERDADERO;613;;;
87929;87316;0;13431;FALSO;VERDADERO;613;;;
87929;87316;0;13432;FALSO;VERDADERO;613;;;
87929;87316;0;13433;FALSO;VERDADERO;613;;;
87929;87316;0;13434;FALSO;VERDADERO;613;;;
87929;87316;0;13435;FALSO;VERDADERO;613;;;
87965;87316;0;13436;FALSO;VERDADERO;649;;;
87965;87316;0;13437;FALSO;VERDADERO;649;;;
87965;87316;0;13438;FALSO;VERDADERO;649;;;
87965;87316;0;13439;FALSO;VERDADERO;649;;;
87965;87316;0;13440;FALSO;VERDADERO;649;;;
87965;87316;0;13441;FALSO;VERDADERO;649;;;
87997;87316;0;13442;FALSO;VERDADERO;681;;;
87997;87316;0;13443;FALSO;VERDADERO;681;;;
87997;87316;0;13444;FALSO;VERDADERO;681;;;
87997;87316;0;13445;FALSO;VERDADERO;681;;;
87997;87316;0;13446;FALSO;VERDADERO;681;;;
88029;87316;0;13447;FALSO;VERDADERO;713;;;
88029;87316;0;13448;FALSO;VERDADERO;713;;;
88029;87316;0;13449;FALSO;VERDADERO;713;;;
88029;87316;0;13450;FALSO;VERDADERO;713;;;
88029;87316;0;13451;FALSO;VERDADERO;713;;;
88029;87316;0;13452;FALSO;VERDADERO;713;;;
88065;87316;0;13453;FALSO;VERDADERO;749;;;
88065;87316;0;13454;FALSO;VERDADERO;749;;;
88065;87316;0;13455;FALSO;VERDADERO;749;;;
88065;87316;0;13456;FALSO;VERDADERO;749;;;
88065;87316;0;13457;FALSO;VERDADERO;749;;;
88097;87316;0;13458;FALSO;VERDADERO;781;;;
88097;87316;0;13459;FALSO;VERDADERO;781;;;
88097;87316;0;13460;FALSO;VERDADERO;781;;;
88097;87316;0;13461;FALSO;VERDADERO;781;;;
88097;87316;0;13462;FALSO;VERDADERO;781;;;
88097;87316;0;13463;FALSO;VERDADERO;781;;;
88132;87316;0;13464;FALSO;VERDADERO;816;;;
88132;87316;0;13465;FALSO;VERDADERO;816;;;
88132;87316;0;13466;FALSO;VERDADERO;816;;;
88132;87316;0;13467;FALSO;VERDADERO;816;;;
88132;87316;0;13468;FALSO;VERDADERO;816;;;
88165;87316;0;13469;FALSO;VERDADERO;849;;;
88165;87316;0;13470;FALSO;VERDADERO;849;;;
88165;87316;0;13471;FALSO;VERDADERO;849;;;
88165;87316;0;13472;FALSO;VERDADERO;849;;;
88165;87316;0;13473;FALSO;VERDADERO;849;;;
88165;87316;0;13474;FALSO;VERDADERO;849;;;
88201;87316;0;13475;FALSO;VERDADERO;885;;;
88201;87316;0;13476;FALSO;VERDADERO;885;;;
88201;87316;0;13477;FALSO;VERDADERO;885;;;
88201;87316;0;13478;FALSO;VERDADERO;885;;;
88201;87316;0;13479;FALSO;VERDADERO;885;;;
88201;87316;0;13480;FALSO;VERDADERO;885;;;
88233;87316;0;13481;FALSO;VERDADERO;917;;;
88233;87316;0;13482;FALSO;VERDADERO;917;;;
88233;87316;0;13483;FALSO;VERDADERO;917;;;
88233;87316;0;13484;FALSO;VERDADERO;917;;;
88233;87316;0;13485;FALSO;VERDADERO;917;;;
88265;87316;0;13486;FALSO;VERDADERO;949;;;
88265;87316;0;13487;FALSO;VERDADERO;949;;;
88265;87316;0;13488;FALSO;VERDADERO;949;;;
88265;87316;0;13489;FALSO;VERDADERO;949;;;
88265;87316;0;13490;FALSO;VERDADERO;949;;;
88297;87316;0;13491;FALSO;VERDADERO;981;;;
88297;87316;0;13492;FALSO;VERDADERO;981;;;
88297;87316;0;13493;FALSO;VERDADERO;981;;;
88297;87316;0;13494;FALSO;VERDADERO;981;;;
88297;87316;0;13495;FALSO;VERDADERO;981;;;
88329;87316;0;13496;FALSO;VERDADERO;1013;;;
88329;87316;0;13497;FALSO;VERDADERO;1013;;;
88329;87316;0;13498;FALSO;VERDADERO;1013;;;
88329;87316;0;13499;FALSO;VERDADERO;1013;;;
88329;87316;0;13500;FALSO;VERDADERO;1013;;;
88329;87316;0;13501;FALSO;VERDADERO;1013;;;
88364;87316;0;13502;FALSO;VERDADERO;1048;;;
88364;87316;0;13503;FALSO;VERDADERO;1048;;;
88364;87336;0;13504;FALSO;VERDADERO;1028;;;
88364;87336;0;13505;FALSO;VERDADERO;1028;;;
88364;87356;0;13506;FALSO;VERDADERO;1008;;;
88397;87356;0;13507;FALSO;VERDADERO;1041;;;
88397;87356;0;13508;FALSO;VERDADERO;1041;;;
88397;87376;0;13509;FALSO;VERDADERO;1021;;;
88397;87376;0;13510;FALSO;VERDADERO;1021;;;
88397;87396;0;13511;FALSO;VERDADERO;1001;;;
88429;87396;0;13512;FALSO;VERDADERO;1033;;;
88429;87396;0;13513;FALSO;VERDADERO;1033;;;
88429;87416;0;13514;FALSO;VERDADERO;1013;;;
88429;87416;0;13515;FALSO;VERDADERO;1013;;;
88429;87436;0;13516;FALSO;VERDADERO;993;;;
88429;87436;0;13517;FALSO;VERDADERO;993;;;
88464;87436;0;13518;FALSO;VERDADERO;1028;;;
88464;87456;0;13519;FALSO;VERDADERO;1008;;;
88464;87456;0;13520;FALSO;VERDADERO;1008;;;
88464;87476;0;13521;FALSO;VERDADERO;988;;;
88464;87476;0;13522;FALSO;VERDADERO;988;;;
88496;87476;0;13523;FALSO;VERDADERO;1020;;;
88496;87496;0;13524;FALSO;VERDADERO;1000;;;
88496;87496;0;13525;FALSO;VERDADERO;1000;;;
88496;87516;0;13526;FALSO;VERDADERO;980;;;
88496;87516;0;13527;FALSO;VERDADERO;980;;;
88529;87516;0;13528;FALSO;VERDADERO;1013;;;
88529;87536;0,00E+00;13529;FALSO;VERDADERO;993;;;
88529;87536;0;13530;FALSO;VERDADERO;993;;;
88529;87556;0;13531;FALSO;VERDADERO;973;;;
88529;87556;0;13532;FALSO;VERDADERO;973;;;
88529;87556;0;13533;FALSO;VERDADERO;973;;;
88565;87576;0;13534;FALSO;VERDADERO;989;;;
88565;87576;0;13535;FALSO;VERDADERO;989;;;
88565;87596;1;13536;FALSO;VERDADERO;969;;;
88565;87596;0;13537;FALSO;VERDADERO;969;;;
88565;87596;0;13538;FALSO;VERDADERO;969;;;
88597;87616;0;13539;FALSO;VERDADERO;981;;;
88597;87616;0;13540;FALSO;VERDADERO;981;;;
88597;87636;0;13541;FALSO;VERDADERO;961;;;
88597;87636;0;13542;FALSO;VERDADERO;961;;;
88597;87636;0;13543;FALSO;VERDADERO;961;;;
88628;87656;0;13544;FALSO;VERDADERO;972;;;
88628;87656;0;13545;FALSO;VERDADERO;972;;;
88628;87676;0;13546;FALSO;VERDADERO;952;;;
88628;87676;0;13547;FALSO;VERDADERO;952;;;
88628;87676;0;13548;FALSO;VERDADERO;952;;;
88628;87696;0;13549;FALSO;VERDADERO;932;;;
88669;87696;0;13550;FALSO;VERDADERO;973;;;
88669;87716;0;13551;FALSO;VERDADERO;953;;;
88669;87716;0;13552;FALSO;VERDADERO;953;;;
88669;87716;0;13553;FALSO;VERDADERO;953;;;
88696;87736;0;13554;FALSO;VERDADERO;960;;;
88696;87736;0;13555;FALSO;VERDADERO;960;;;
88696;87756;0;13556;FALSO;VERDADERO;940;;;
88696;87756;0;13557;FALSO;VERDADERO;940;;;
88696;87756;0;13558;FALSO;VERDADERO;940;;;
88729;87776;0;13559;FALSO;VERDADERO;953;;;
88729;87776;0;13560;FALSO;VERDADERO;953;;;
88729;87796;0;13561;FALSO;VERDADERO;933;;;
88729;87796;0;13562;FALSO;VERDADERO;933;;;
88729;87816;1;13563;FALSO;VERDADERO;913;;;
88729;87816;0;13564;FALSO;VERDADERO;913;;;
88765;87816;0;13565;FALSO;VERDADERO;949;;;
88765;87836;0;13566;FALSO;VERDADERO;929;;;
88765;87836;0;13567;FALSO;VERDADERO;929;;;
88765;87856;1;13568;FALSO;VERDADERO;909;;;
88765;87856;0;13569;FALSO;VERDADERO;909;;;
88801;87856;0;13570;FALSO;VERDADERO;945;;;
88801;87876;0;13571;FALSO;VERDADERO;925;;;
88801;87876;0;13572;FALSO;VERDADERO;925;;;
88801;87896;0;13573;FALSO;VERDADERO;905;;;
88801;87896;0;13574;FALSO;VERDADERO;905;;;
88832;87916;0;13575;FALSO;VERDADERO;916;;;
88832;87916;0;13576;FALSO;VERDADERO;916;;;
88832;87916;0;13577;FALSO;VERDADERO;916;;;
88832;87936;0;13578;FALSO;VERDADERO;896;;;
88832;87936;0;13579;FALSO;VERDADERO;896;;;
88864;87956;0;13580;FALSO;VERDADERO;908;;;
88864;87956;0;13581;FALSO;VERDADERO;908;;;
88864;87956;0;13582;FALSO;VERDADERO;908;;;
88864;87976;0;13583;FALSO;VERDADERO;888;;;
88864;87976;0;13584;FALSO;VERDADERO;888;;;
88864;87996;0;13585;FALSO;VERDADERO;868;;;
88901;87996;0;13586;FALSO;VERDADERO;905;;;
88901;87996;0;13587;FALSO;VERDADERO;905;;;
88901;88016;0;13588;FALSO;VERDADERO;885;;;
88901;88016;0;13589;FALSO;VERDADERO;885;;;
88901;88036;0;13590;FALSO;VERDADERO;865;;;
88901;88036;0;13591;FALSO;VERDADERO;865;;;
88937;88036;0;13592;FALSO;VERDADERO;901;;;
88937;88056;0;13593;FALSO;VERDADERO;881;;;
88937;88056;0;13594;FALSO;VERDADERO;881;;;
88937;88076;0;13595;FALSO;VERDADERO;861;;;
88969;88076;0;13596;FALSO;VERDADERO;893;;;
88969;88076;0;13597;FALSO;VERDADERO;893;;;
88969;88096;0;13598;FALSO;VERDADERO;873;;;
88969;88096;0;13599;FALSO;VERDADERO;873;;;
88969;88116;0;13600;FALSO;VERDADERO;853;;;
89001;88116;0;13601;FALSO;VERDADERO;885;;;
89001;88116;0;13602;FALSO;VERDADERO;885;;;
89001;88136;0;13603;FALSO;VERDADERO;865;;;
89001;88136;0;13604;FALSO;VERDADERO;865;;;
89001;88156;0;13605;FALSO;VERDADERO;845;;;
89001;88156;0;13606;FALSO;VERDADERO;845;;;
89036;88156;0;13607;FALSO;VERDADERO;880;;;
89036;88176;0;13608;FALSO;VERDADERO;860;;;
89036;88176;0;13609;FALSO;VERDADERO;860;;;
89036;88196;0;13610;FALSO;VERDADERO;840;;;
89036;88196;0;13611;FALSO;VERDADERO;840;;;
89068;88196;0;13612;FALSO;VERDADERO;872;;;
89068;88216;0;13613;FALSO;VERDADERO;852;;;
89068;88216;0;13614;FALSO;VERDADERO;852;;;
89068;88458;0;13615;FALSO;VERDADERO;610;;;
89068;88458;0;13616;FALSO;VERDADERO;610;;;
89100;88458;0;13617;FALSO;VERDADERO;642;;;
89100;88478;0;13618;FALSO;VERDADERO;622;;;
89100;88478;0;13619;FALSO;VERDADERO;622;;;
89100;88498;0;13620;FALSO;VERDADERO;602;;;
89100;88498;0;13621;FALSO;VERDADERO;602;;;
89100;88518;0;13622;FALSO;VERDADERO;582;;;
89137;88518;0;13623;FALSO;VERDADERO;619;;;
89137;88518;0;13624;FALSO;VERDADERO;619;;;
89137;88538;0;13625;FALSO;VERDADERO;599;;;
89137;88538;0;13626;FALSO;VERDADERO;599;;;
89168;88559;0;13627;FALSO;VERDADERO;609;;;
89168;88559;0;13628;FALSO;VERDADERO;609;;;
89168;88559;0;13629;FALSO;VERDADERO;609;;;
89168;88579;0;13630;FALSO;VERDADERO;589;;;
89168;88579;0;13631;FALSO;VERDADERO;589;;;
89201;88599;0;13632;FALSO;VERDADERO;602;;;
89201;88599;0;13633;FALSO;VERDADERO;602;;;
89201;88619;0;13634;FALSO;VERDADERO;582;;;
89201;88619;0;13635;FALSO;VERDADERO;582;;;
89201;88619;0;13636;FALSO;VERDADERO;582;;;
89201;88639;0;13637;FALSO;VERDADERO;562;;;
89237;88639;0;13638;FALSO;VERDADERO;598;;;
89237;88639;0;13639;FALSO;VERDADERO;598;;;
89237;88660;1;13640;FALSO;VERDADERO;577;;;
89237;88660;0;13641;FALSO;VERDADERO;577;;;
89237;88680;0;13642;FALSO;VERDADERO;557;;;
89269;88680;0;13643;FALSO;VERDADERO;589;;;
89269;88680;0;13644;FALSO;VERDADERO;589;;;
89269;88700;0;13645;FALSO;VERDADERO;569;;;
89269;88700;0;13646;FALSO;VERDADERO;569;;;
89269;88720;0;13647;FALSO;VERDADERO;549;;;
89301;88720;0;13648;FALSO;VERDADERO;581;;;
89301;88740;0;13649;FALSO;VERDADERO;561;;;
89301;88740;0;13650;FALSO;VERDADERO;561;;;
89301;88740;0;13651;FALSO;VERDADERO;561;;;
89301;88760;1;13652;FALSO;VERDADERO;541;;;
89333;88760;0;13653;FALSO;VERDADERO;573;;;
89333;88780;0;13654;FALSO;VERDADERO;553;;;
89333;88780;0;13655;FALSO;VERDADERO;553;;;
89333;88780;0;13656;FALSO;VERDADERO;553;;;
89333;88800;1;13657;FALSO;VERDADERO;533;;;
89333;88800;0;13658;FALSO;VERDADERO;533;;;
89368;88820;0;13659;FALSO;VERDADERO;548;;;
89368;88820;0;13660;FALSO;VERDADERO;548;;;
89368;88820;0;13661;FALSO;VERDADERO;548;;;
89368;88840;0;13662;FALSO;VERDADERO;528;;;
89368;88840;0;13663;FALSO;VERDADERO;528;;;
89401;88860;0;13664;FALSO;VERDADERO;541;;;
89401;88860;0;13665;FALSO;VERDADERO;541;;;
89401;88860;0;13666;FALSO;VERDADERO;541;;;
89401;88880;1;13667;FALSO;VERDADERO;521;;;
89401;88880;0;13668;FALSO;VERDADERO;521;;;
89433;88900;0;13669;FALSO;VERDADERO;533;;;
89433;88900;0;13670;FALSO;VERDADERO;533;;;
89433;88900;0;13671;FALSO;VERDADERO;533;;;
89433;88920;0;13672;FALSO;VERDADERO;513;;;
89433;88920;0;13673;FALSO;VERDADERO;513;;;
89465;88940;0;13674;FALSO;VERDADERO;525;;;
89465;88940;0;13675;FALSO;VERDADERO;525;;;
89465;88940;0;13676;FALSO;VERDADERO;525;;;
89465;88960;0;13677;FALSO;VERDADERO;505;;;
89497;88960;0;13678;FALSO;VERDADERO;537;;;
89497;88980;0;13679;FALSO;VERDADERO;517;;;
89497;88980;0;13680;FALSO;VERDADERO;517;;;
89497;88980;0;13681;FALSO;VERDADERO;517;;;
89497;89000;0;13682;FALSO;VERDADERO;497;;;
89497;89000;0;13683;FALSO;VERDADERO;497;;;
89533;89020;0;13684;FALSO;VERDADERO;513;;;
89533;89020;0;13685;FALSO;VERDADERO;513;;;
89533;89020;0;13686;FALSO;VERDADERO;513;;;
89533;89040;1;13687;FALSO;VERDADERO;493;;;
89533;89040;0;13688;FALSO;VERDADERO;493;;;
89564;89060;0;13689;FALSO;VERDADERO;504;;;
89564;89060;0;13690;FALSO;VERDADERO;504;;;
89564;89060;0;13691;FALSO;VERDADERO;504;;;
89797;89380;1;13692;FALSO;VERDADERO;417;;;
89829;89380;0;13693;FALSO;VERDADERO;449;;;
89829;89400;0;13694;FALSO;VERDADERO;429;;;
89829;89400;0;13695;FALSO;VERDADERO;429;;;
89829;89420;0;13696;FALSO;VERDADERO;409;;;
89829;89420;0;13697;FALSO;VERDADERO;409;;;
89861;89420;0;13698;FALSO;VERDADERO;441;;;
89861;89440;0;13699;FALSO;VERDADERO;421;;;
89861;89440;0;13700;FALSO;VERDADERO;421;;;
89861;89460;0;13701;FALSO;VERDADERO;401;;;
89861;89460;0;13702;FALSO;VERDADERO;401;;;
89894;89460;0;13703;FALSO;VERDADERO;434;;;
89894;89480;0;13704;FALSO;VERDADERO;414;;;
89894;89480;0;13705;FALSO;VERDADERO;414;;;
89894;89500;0;13706;FALSO;VERDADERO;394;;;
89894;89500;0;13707;FALSO;VERDADERO;394;;;
89925;89500;0;13708;FALSO;VERDADERO;425;;;
89925;89520;0;13709;FALSO;VERDADERO;405;;;
89925;89520;0;13710;FALSO;VERDADERO;405;;;
89925;89540;0;13711;FALSO;VERDADERO;385;;;
89925;89540;0;13712;FALSO;VERDADERO;385;;;
89961;89540;0;13713;FALSO;VERDADERO;421;;;
89961;89560;0;13714;FALSO;VERDADERO;401;;;
89961;89560;0;13715;FALSO;VERDADERO;401;;;
89961;89580;0;13716;FALSO;VERDADERO;381;;;
89961;89580;0;13717;FALSO;VERDADERO;381;;;
89993;89580;0;13718;FALSO;VERDADERO;413;;;
89993;89600;0;13719;FALSO;VERDADERO;393;;;
89993;89600;0;13720;FALSO;VERDADERO;393;;;
89993;89620;0;13721;FALSO;VERDADERO;373;;;
89993;89620;0;13722;FALSO;VERDADERO;373;;;
89993;89620;0;13723;FALSO;VERDADERO;373;;;
90029;89640;0;13724;FALSO;VERDADERO;389;;;
90029;89640;0;13725;FALSO;VERDADERO;389;;;
90029;89660;1;13726;FALSO;VERDADERO;369;;;
90029;89660;0;13727;FALSO;VERDADERO;369;;;
90029;89660;0;13728;FALSO;VERDADERO;369;;;
90061;89680;0;13729;FALSO;VERDADERO;381;;;
90061;89680;0;13730;FALSO;VERDADERO;381;;;
90061;89700;0;13731;FALSO;VERDADERO;361;;;
90061;89700;0;13732;FALSO;VERDADERO;361;;;
90061;89700;0;13733;FALSO;VERDADERO;361;;;
90061;89720;1;13734;FALSO;VERDADERO;341;;;
90061;89720;0;13735;FALSO;VERDADERO;341;;;
90105;89740;0;13736;FALSO;VERDADERO;365;;;
90105;89740;0;13737;FALSO;VERDADERO;365;;;
90105;89740;0;13738;FALSO;VERDADERO;365;;;
90105;89760;0;13739;FALSO;VERDADERO;345;;;
90132;89760;0;13740;FALSO;VERDADERO;372;;;
90132;89780;0;13741;FALSO;VERDADERO;352;;;
90132;89780;0;13742;FALSO;VERDADERO;352;;;
90132;89780;0;13743;FALSO;VERDADERO;352;;;
90132;89800;1;13744;FALSO;VERDADERO;332;;;
90161;89800;0;13745;FALSO;VERDADERO;361;;;
90161;89820;0;13746;FALSO;VERDADERO;341;;;
90161;89820;0;13747;FALSO;VERDADERO;341;;;
90161;89820;0;13748;FALSO;VERDADERO;341;;;
90161;89840;0;13749;FALSO;VERDADERO;321;;;
90161;89840;0;13750;FALSO;VERDADERO;321;;;
90197;89860;0;13751;FALSO;VERDADERO;337;;;
90197;89860;0;13752;FALSO;VERDADERO;337;;;
90197;89860;0;13753;FALSO;VERDADERO;337;;;
90197;89880;0;13754;FALSO;VERDADERO;317;;;
90197;89880;0;13755;FALSO;VERDADERO;317;;;
90233;89901;1;13756;FALSO;VERDADERO;332;;;
90233;89901;0;13757;FALSO;VERDADERO;332;;;
90233;89901;0;13758;FALSO;VERDADERO;332;;;
90233;89921;0;13759;FALSO;VERDADERO;312;;;
90233;89921;0;13760;FALSO;VERDADERO;312;;;
90265;89941;0;13761;FALSO;VERDADERO;324;;;
90265;89941;0;13762;FALSO;VERDADERO;324;;;
90265;89941;0;13763;FALSO;VERDADERO;324;;;
90265;89961;1;13764;FALSO;VERDADERO;304;;;
90265;89961;0;13765;FALSO;VERDADERO;304;;;
90296;89981;0;13766;FALSO;VERDADERO;315;;;
90296;89981;0;13767;FALSO;VERDADERO;315;;;
90296;89981;0;13768;FALSO;VERDADERO;315;;;
90296;90001;0;13769;FALSO;VERDADERO;295;;;
90296;90001;0;13770;FALSO;VERDADERO;295;;;
90296;90021;0;13771;FALSO;VERDADERO;275;;;
90333;90021;0;13772;FALSO;VERDADERO;312;;;
90333;90041;0;13773;FALSO;VERDADERO;292;;;
90333;90041;0;13774;FALSO;VERDADERO;292;;;
90333;90041;0;13775;FALSO;VERDADERO;292;;;
90333;90061;1;13776;FALSO;VERDADERO;272;;;
90369;90061;0;13777;FALSO;VERDADERO;308;;;
90369;90081;0;13778;FALSO;VERDADERO;288;;;
90369;90081;0;13779;FALSO;VERDADERO;288;;;
90369;90081;0;13780;FALSO;VERDADERO;288;;;
90369;90101;1;13781;FALSO;VERDADERO;268;;;
90401;90101;0;13782;FALSO;VERDADERO;300;;;
90401;90121;0;13783;FALSO;VERDADERO;280;;;
90401;90121;0;13784;FALSO;VERDADERO;280;;;
90401;90121;0;13785;FALSO;VERDADERO;280;;;
90401;90141;0;13786;FALSO;VERDADERO;260;;;
90433;90141;0;13787;FALSO;VERDADERO;292;;;
90433;90161;1;13788;FALSO;VERDADERO;272;;;
90433;90161;0;13789;FALSO;VERDADERO;272;;;
90433;90161;0;13790;FALSO;VERDADERO;272;;;
90433;90182;0;13791;FALSO;VERDADERO;251;;;
90465;90182;0;13792;FALSO;VERDADERO;283;;;
90465;90202;0;13793;FALSO;VERDADERO;263;;;
90465;90202;0;13794;FALSO;VERDADERO;263;;;
90465;90202;0;13795;FALSO;VERDADERO;263;;;
90465;90222;1;13796;FALSO;VERDADERO;243;;;
90496;90222;0;13797;FALSO;VERDADERO;274;;;
90496;90242;0;13798;FALSO;VERDADERO;254;;;
90496;90242;0;13799;FALSO;VERDADERO;254;;;
90496;90242;0;13800;FALSO;VERDADERO;254;;;
90496;90262;0;13801;FALSO;VERDADERO;234;;;
90496;90262;0;13802;FALSO;VERDADERO;234;;;
90532;90282;0;13803;FALSO;VERDADERO;250;;;
90532;90282;0;13804;FALSO;VERDADERO;250;;;
90532;90302;0;13805;FALSO;VERDADERO;230;;;
90532;90302;0;13806;FALSO;VERDADERO;230;;;
90532;90302;0;13807;FALSO;VERDADERO;230;;;
90565;90322;0;13808;FALSO;VERDADERO;243;;;
90565;90322;0;13809;FALSO;VERDADERO;243;;;
90565;90342;0;13810;FALSO;VERDADERO;223;;;
90565;90342;0;13811;FALSO;VERDADERO;223;;;
90565;90342;0;13812;FALSO;VERDADERO;223;;;
90597;90362;0;13813;FALSO;VERDADERO;235;;;
90597;90362;0;13814;FALSO;VERDADERO;235;;;
90597;90382;0;13815;FALSO;VERDADERO;215;;;
90597;90382;0;13816;FALSO;VERDADERO;215;;;
90597;90382;0;13817;FALSO;VERDADERO;215;;;
90629;90402;0;13818;FALSO;VERDADERO;227;;;
90629;90402;0;13819;FALSO;VERDADERO;227;;;
90629;90422;0;13820;FALSO;VERDADERO;207;;;
90629;90422;0;13821;FALSO;VERDADERO;207;;;
90629;90422;0;13822;FALSO;VERDADERO;207;;;
90661;90442;0;13823;FALSO;VERDADERO;219;;;
90661;90442;0;13824;FALSO;VERDADERO;219;;;
90661;90462;0;13825;FALSO;VERDADERO;199;;;
90661;90462;0;13826;FALSO;VERDADERO;199;;;
90661;90462;0;13827;FALSO;VERDADERO;199;;;
90697;90482;0;13828;FALSO;VERDADERO;215;;;
90697;90482;0;13829;FALSO;VERDADERO;215;;;
90697;90502;0;13830;FALSO;VERDADERO;195;;;
90697;90502;0;13831;FALSO;VERDADERO;195;;;
90697;90502;0;13832;FALSO;VERDADERO;195;;;
90729;90522;0;13833;FALSO;VERDADERO;207;;;
90729;90522;0;13834;FALSO;VERDADERO;207;;;
90729;90542;1;13835;FALSO;VERDADERO;187;;;
90729;90542;0;13836;FALSO;VERDADERO;187;;;
90729;90562;0;13837;FALSO;VERDADERO;167;;;
90761;90562;0;13838;FALSO;VERDADERO;199;;;
90761;90562;0;13839;FALSO;VERDADERO;199;;;
90761;90582;0;13840;FALSO;VERDADERO;179;;;
90761;90582;0;13841;FALSO;VERDADERO;179;;;
90761;90602;1;13842;FALSO;VERDADERO;159;;;
90761;90602;0;13843;FALSO;VERDADERO;159;;;
90796;90602;0;13844;FALSO;VERDADERO;194;;;
90796;90622;0;13845;FALSO;VERDADERO;174;;;
90796;90622;0;13846;FALSO;VERDADERO;174;;;
90796;90642;0;13847;FALSO;VERDADERO;154;;;
90796;90642;0;13848;FALSO;VERDADERO;154;;;
90829;90642;0;13849;FALSO;VERDADERO;187;;;
90829;90663;0;13850;FALSO;VERDADERO;166;;;
90829;90663;0;13851;FALSO;VERDADERO;166;;;
90829;90683;0;13852;FALSO;VERDADERO;146;;;
90829;90683;0;13853;FALSO;VERDADERO;146;;;
90860;90683;0;13854;FALSO;VERDADERO;177;;;
90860;90703;0;13855;FALSO;VERDADERO;157;;;
90860;90703;0;13856;FALSO;VERDADERO;157;;;
90860;90723;0;13857;FALSO;VERDADERO;137;;;
90860;90723;0;13858;FALSO;VERDADERO;137;;;
90897;90723;0;13859;FALSO;VERDADERO;174;;;
90897;90743;0;13860;FALSO;VERDADERO;154;;;
90897;90743;0;13861;FALSO;VERDADERO;154;;;
90897;90763;0;13862;FALSO;VERDADERO;134;;;
90897;90763;0;13863;FALSO;VERDADERO;134;;;
90928;90763;0;13864;FALSO;VERDADERO;165;;;
90928;90783;0;13865;FALSO;VERDADERO;145;;;
90928;90783;0;13866;FALSO;VERDADERO;145;;;
90928;90803;0;13867;FALSO;VERDADERO;125;;;
90928;90803;0;13868;FALSO;VERDADERO;125;;;
90961;90803;0;13869;FALSO;VERDADERO;158;;;
90961;90823;0;13870;FALSO;VERDADERO;138;;;
90961;90823;0;13871;FALSO;VERDADERO;138;;;
90961;90843;0;13872;FALSO;VERDADERO;118;;;
90961;90843;0;13873;FALSO;VERDADERO;118;;;
90961;90843;0;13874;FALSO;VERDADERO;118;;;
90997;90863;0;13875;FALSO;VERDADERO;134;;;
90997;90863;0;13876;FALSO;VERDADERO;134;;;
90997;90883;0;13877;FALSO;VERDADERO;114;;;
90997;90883;0;13878;FALSO;VERDADERO;114;;;
90997;90903;0;13879;FALSO;VERDADERO;94;;;
91029;90903;0;13880;FALSO;VERDADERO;126;;;
91029;90903;0;13881;FALSO;VERDADERO;126;;;
91029;90923;0;13882;FALSO;VERDADERO;106;;;
91029;90923;0;13883;FALSO;VERDADERO;106;;;
91029;90943;0;13884;FALSO;VERDADERO;86;;;
91061;90943;0;13885;FALSO;VERDADERO;118;;;
91061;90943;0;13886;FALSO;VERDADERO;118;;;
91061;90963;0;13887;FALSO;VERDADERO;98;;;
91061;90963;0;13888;FALSO;VERDADERO;98;;;
91061;90983;0;13889;FALSO;VERDADERO;78;;;
91097;90983;0;13890;FALSO;VERDADERO;114;;;
91097;90983;0;13891;FALSO;VERDADERO;114;;;
91097;91003;0;13892;FALSO;VERDADERO;94;;;
91097;91003;0;13893;FALSO;VERDADERO;94;;;
91097;91023;0;13894;FALSO;VERDADERO;74;;;
91129;91023;0;13895;FALSO;VERDADERO;106;;;
91129;91023;0;13896;FALSO;VERDADERO;106;;;
91129;91043;0;13897;FALSO;VERDADERO;86;;;
91129;91043;0;13898;FALSO;VERDADERO;86;;;
91129;91063;0;13899;FALSO;VERDADERO;66;;;
91161;91063;0;13900;FALSO;VERDADERO;98;;;
91161;91063;0;13901;FALSO;VERDADERO;98;;;
91161;91083;0;13902;FALSO;VERDADERO;78;;;
91161;91083;0;13903;FALSO;VERDADERO;78;;;
91161;91103;0;13904;FALSO;VERDADERO;58;;;
91193;91103;0;13905;FALSO;VERDADERO;90;;;
91193;91103;0;13906;FALSO;VERDADERO;90;;;
91193;91123;0;13907;FALSO;VERDADERO;70;;;
91193;91123;0;13908;FALSO;VERDADERO;70;;;
91193;91143;0;13909;FALSO;VERDADERO;50;;;
91193;91143;0;13910;FALSO;VERDADERO;50;;;
91225;91163;0;13911;FALSO;VERDADERO;62;;;
91225;91163;0;13912;FALSO;VERDADERO;62;;;
91225;91163;0;13913;FALSO;VERDADERO;62;;;
91225;91183;0;13914;VERDADERO;VERDADERO;42;;;
91225;91183;0;13915;VERDADERO;VERDADERO;42;;;
91261;91203;0;13916;FALSO;VERDADERO;58;;;
91261;91203;0;13917;FALSO;VERDADERO;58;;;
91261;91203;0;13918;FALSO;VERDADERO;58;;;
91261;91223;0;13919;VERDADERO;VERDADERO;38;;;
91261;91223;0;13920;VERDADERO;VERDADERO;38;;;
91292;91243;0;13921;VERDADERO;VERDADERO;49;;;
91292;91243;0;13922;VERDADERO;VERDADERO;49;;;
91292;91243;0;13923;VERDADERO;VERDADERO;49;;;
91292;91263;1;13924;VERDADERO;VERDADERO;29;;;
91292;91263;0;13925;VERDADERO;VERDADERO;29;;;
91292;91283;0;13926;VERDADERO;VERDADERO;9;;;
91325;91283;0;13927;VERDADERO;VERDADERO;42;;;
91325;91283;0;13928;VERDADERO;VERDADERO;42;;;
91325;91303;1;13929;VERDADERO;VERDADERO;22;;;
91325;91303;0;13930;VERDADERO;VERDADERO;22;;;
91356;91323;0;13931;VERDADERO;VERDADERO;33;;;
91356;91323;0;13932;VERDADERO;VERDADERO;33;;;
91356;91323;0;13933;VERDADERO;VERDADERO;33;;;
91356;91343;0;13934;VERDADERO;VERDADERO;13;;;
91356;91343;0;13935;VERDADERO;VERDADERO;13;;;
91356;91363;0;13936;VERDADERO;VERDADERO;-7;;;
91393;91363;0;13937;VERDADERO;VERDADERO;30;;;
91393;91383;0;13938;VERDADERO;VERDADERO;10;;;
91393;91383;0;13939;VERDADERO;VERDADERO;10;;;
91393;91383;0;13940;VERDADERO;VERDADERO;10;;;
91393;91403;0;13941;VERDADERO;VERDADERO;-10;;;
91425;91403;0;13942;VERDADERO;VERDADERO;22;;;
91425;91423;0;13943;VERDADERO;VERDADERO;2;;;
91425;91423;0;13944;VERDADERO;VERDADERO;2;;;
91425;91423;0;13945;VERDADERO;VERDADERO;2;;;
91425;91443;0;13946;VERDADERO;VERDADERO;-18;;;
91457;91443;0;13947;VERDADERO;VERDADERO;14;;;
91457;91463;0;13948;VERDADERO;VERDADERO;-6;;;
91457;91463;0;13949;VERDADERO;VERDADERO;-6;;;
91457;91463;0;13950;VERDADERO;VERDADERO;-6;;;
91457;91483;0;13951;VERDADERO;VERDADERO;-26;;;
91493;91483;0;13952;VERDADERO;VERDADERO;10;;;
91493;91503;0;13953;VERDADERO;VERDADERO;-10;;;
91493;91503;0;13954;VERDADERO;VERDADERO;-10;;;
91493;91503;0;13955;VERDADERO;VERDADERO;-10;;;
91493;91523;0;13956;VERDADERO;VERDADERO;-30;;;
91493;91523;0;13957;VERDADERO;VERDADERO;-30;;;
91529;91543;0;13958;VERDADERO;VERDADERO;-14;;;
91529;91543;0;13959;VERDADERO;VERDADERO;-14;;;
91529;91543;0;13960;VERDADERO;VERDADERO;-14;;;
91529;91563;1;13961;VERDADERO;VERDADERO;-34;;;
91529;91563;0;13962;VERDADERO;VERDADERO;-34;;;
91561;91583;0;13963;VERDADERO;VERDADERO;-22;;;
91561;91583;0;13964;VERDADERO;VERDADERO;-22;;;
91561;91583;0;13965;VERDADERO;VERDADERO;-22;;;
91561;91603;0;13966;VERDADERO;VERDADERO;-42;;;
91561;91603;0;13967;VERDADERO;VERDADERO;-42;;;
91592;91603;0;13968;VERDADERO;VERDADERO;-11;;;
91592;91603;0;13969;VERDADERO;VERDADERO;-11;;;
91592;91623;0;13970;VERDADERO;VERDADERO;-31;;;
91592;91623;0;13971;VERDADERO;VERDADERO;-31;;;
91592;91643;0;13972;VERDADERO;FALSO;-51;;;
91628;91643;0;13973;VERDADERO;VERDADERO;-15;;;
91628;91643;0;13974;VERDADERO;VERDADERO;-15;;;
91628;91643;0;13975;VERDADERO;VERDADERO;-15;;;
91628;91643;0;13976;VERDADERO;VERDADERO;-15;;;
91628;91643;0;13977;VERDADERO;VERDADERO;-15;;;
91628;91643;0;13978;VERDADERO;VERDADERO;-15;;;
91661;91663;1;13979;VERDADERO;VERDADERO;-2;;;
91661;91663;0;13980;VERDADERO;VERDADERO;-2;;;
91661;91684;0;13981;VERDADERO;VERDADERO;-23;;;
91661;91684;0;13982;VERDADERO;VERDADERO;-23;;;
91661;91684;0;13983;VERDADERO;VERDADERO;-23;;;
91693;91704;0;13984;VERDADERO;VERDADERO;-11;;;
91693;91704;0;13985;VERDADERO;VERDADERO;-11;;;
91693;91724;0;13986;VERDADERO;VERDADERO;-31;;;
91693;91724;0;13987;VERDADERO;VERDADERO;-31;;;
91693;91724;0;13988;VERDADERO;VERDADERO;-31;;;
91729;91744;0;13989;VERDADERO;VERDADERO;-15;;;
91729;91744;0;13990;VERDADERO;VERDADERO;-15;;;
91729;91744;0;13991;VERDADERO;VERDADERO;-15;;;
91729;91744;0;13992;VERDADERO;VERDADERO;-15;;;
91729;91744;0;13993;VERDADERO;VERDADERO;-15;;;
91729;91764;0;13994;VERDADERO;VERDADERO;-35;;;
91760;91764;0;13995;VERDADERO;VERDADERO;-4;;;
91760;91784;0;13996;VERDADERO;VERDADERO;-24;;;
91760;91784;0;13997;VERDADERO;VERDADERO;-24;;;
91760;91784;0;13998;VERDADERO;VERDADERO;-24;;;
91793;91804;1;13999;VERDADERO;VERDADERO;-11;;;
91793;91804;0;14000;VERDADERO;VERDADERO;-11;;;
91793;91824;0;14001;VERDADERO;VERDADERO;-31;;;
91793;91824;0;14002;VERDADERO;VERDADERO;-31;;;
91793;91824;0;14003;VERDADERO;VERDADERO;-31;;;
91793;91844;0;14004;VERDADERO;FALSO;-51;;;
91828;91844;0;14005;VERDADERO;VERDADERO;-16;;;
91828;91844;0;14006;VERDADERO;VERDADERO;-16;;;
91828;91844;0;14007;VERDADERO;VERDADERO;-16;;;
91828;91844;0;14008;VERDADERO;VERDADERO;-16;;;
91828;91844;0;14009;VERDADERO;VERDADERO;-16;;;
91860;91864;1;14010;VERDADERO;VERDADERO;-4;;;
91860;91864;0;14011;VERDADERO;VERDADERO;-4;;;
91860;91884;0;14012;VERDADERO;VERDADERO;-24;;;
91860;91884;0;14013;VERDADERO;VERDADERO;-24;;;
91860;91884;0;14014;VERDADERO;VERDADERO;-24;;;
91892;91904;0;14015;VERDADERO;VERDADERO;-12;;;
91892;91904;0;14016;VERDADERO;VERDADERO;-12;;;
91892;91924;0;14017;VERDADERO;VERDADERO;-32;;;
91892;91924;0;14018;VERDADERO;VERDADERO;-32;;;
91892;91944;0;14019;VERDADERO;FALSO;-52;;;
91892;91944;0;14020;VERDADERO;FALSO;-52;;;
91929;91944;0;14021;VERDADERO;VERDADERO;-15;;;
91929;91944;0;14022;VERDADERO;VERDADERO;-15;;;
91929;91944;0;14023;VERDADERO;VERDADERO;-15;;;
91929;91964;0;14024;VERDADERO;VERDADERO;-35;;;
91929;91964;0;14025;VERDADERO;VERDADERO;-35;;;
91961;91984;1;14026;VERDADERO;VERDADERO;-23;;;
91961;91984;0;14027;VERDADERO;VERDADERO;-23;;;
91961;91984;0;14028;VERDADERO;VERDADERO;-23;;;
91961;91984;0;14029;VERDADERO;VERDADERO;-23;;;
91961;91984;0;14030;VERDADERO;VERDADERO;-23;;;
91993;92004;0;14031;VERDADERO;VERDADERO;-11;;;
91993;92004;0;14032;VERDADERO;VERDADERO;-11;;;
91993;92004;0;14033;VERDADERO;VERDADERO;-11;;;
91993;92024;0;14034;VERDADERO;VERDADERO;-31;;;
91993;92024;0;14035;VERDADERO;VERDADERO;-31;;;
91993;92044;1;14036;VERDADERO;FALSO;-51;;;
92029;92044;0;14037;VERDADERO;VERDADERO;-15;;;
92029;92044;0;14038;VERDADERO;VERDADERO;-15;;;
92029;92064;0;14039;VERDADERO;VERDADERO;-35;;;
92029;92064;0;14040;VERDADERO;VERDADERO;-35;;;
92029;92084;0;14041;VERDADERO;FALSO;-55;;;
92060;92084;0;14042;VERDADERO;VERDADERO;-24;;;
92060;92084;0;14043;VERDADERO;VERDADERO;-24;;;
92060;92084;0;14044;VERDADERO;VERDADERO;-24;;;
92060;92104;0;14045;VERDADERO;VERDADERO;-44;;;
92060;92104;0;14046;VERDADERO;VERDADERO;-44;;;
92092;92124;1;14047;VERDADERO;VERDADERO;-32;;;
92092;92124;0;14048;VERDADERO;VERDADERO;-32;;;
92092;92124;0;14049;VERDADERO;VERDADERO;-32;;;
92092;92124;0;14050;VERDADERO;VERDADERO;-32;;;
92092;92124;0;14051;VERDADERO;VERDADERO;-32;;;
92092;92124;0;14052;VERDADERO;VERDADERO;-32;;;
92128;92144;0;14053;VERDADERO;VERDADERO;-16;;;
92128;92144;0;14054;VERDADERO;VERDADERO;-16;;;
92128;92164;0;14055;VERDADERO;VERDADERO;-36;;;
92128;92164;0;14056;VERDADERO;VERDADERO;-36;;;
92128;92164;0;14057;VERDADERO;VERDADERO;-36;;;
92160;92184;0;14058;VERDADERO;VERDADERO;-24;;;
92160;92184;0;14059;VERDADERO;VERDADERO;-24;;;
92160;92204;0;14060;VERDADERO;VERDADERO;-44;;;
92160;92204;0;14061;VERDADERO;VERDADERO;-44;;;
92160;92204;0;14062;VERDADERO;VERDADERO;-44;;;
92192;92224;1;14063;VERDADERO;VERDADERO;-32;;;
92192;92224;0;14064;VERDADERO;VERDADERO;-32;;;
92192;92224;0;14065;VERDADERO;VERDADERO;-32;;;
92192;92224;0;14066;VERDADERO;VERDADERO;-32;;;
92192;92224;0;14067;VERDADERO;VERDADERO;-32;;;
92225;92224;0;14068;VERDADERO;VERDADERO;1;;;
92225;92224;0;14069;VERDADERO;VERDADERO;1;;;
92225;92224;0;14070;VERDADERO;VERDADERO;1;;;
92225;92224;0;14071;VERDADERO;VERDADERO;1;;;
92225;92244;0;14072;VERDADERO;VERDADERO;-19;;;
92258;92244;0;14073;VERDADERO;VERDADERO;14;;;
92258;92264;0;14074;VERDADERO;VERDADERO;-6;;;
92258;92264;0;14075;VERDADERO;VERDADERO;-6;;;
92258;92264;0;14076;VERDADERO;VERDADERO;-6;;;
92258;92264;0;14077;VERDADERO;VERDADERO;-6;;;
92258;92264;0;14078;VERDADERO;VERDADERO;-6;;;
92292;92284;0;14079;VERDADERO;VERDADERO;8;;;
92292;92284;0;14080;VERDADERO;VERDADERO;8;;;
92292;92284;0;14081;VERDADERO;VERDADERO;8;;;
92292;92304;0;14082;VERDADERO;VERDADERO;-12;;;
92292;92304;0;14083;VERDADERO;VERDADERO;-12;;;
92324;92324;0;14084;VERDADERO;VERDADERO;0;;;
92324;92324;0;14085;VERDADERO;VERDADERO;0;;;
92324;92324;0;14086;VERDADERO;VERDADERO;0;;;
92324;92344;1;14087;VERDADERO;VERDADERO;-20;;;
92324;92344;0;14088;VERDADERO;VERDADERO;-20;;;
92324;92364;0;14089;VERDADERO;VERDADERO;-40;;;
92361;92364;0;14090;VERDADERO;VERDADERO;-3;;;
92361;92364;0;14091;VERDADERO;VERDADERO;-3;;;
92361;92384;0;14092;VERDADERO;VERDADERO;-23;;;
92361;92384;0;14093;VERDADERO;VERDADERO;-23;;;
92361;92404;0;14094;VERDADERO;VERDADERO;-43;;;
92393;92404;0;14095;VERDADERO;VERDADERO;-11;;;
92393;92404;0;14096;VERDADERO;VERDADERO;-11;;;
92393;92424;0;14097;VERDADERO;VERDADERO;-31;;;
92393;92424;0;14098;VERDADERO;VERDADERO;-31;;;
92393;92424;0;14099;VERDADERO;VERDADERO;-31;;;
92429;92424;0;14100;VERDADERO;VERDADERO;5;;;
92429;92424;0;14101;VERDADERO;VERDADERO;5;;;
92429;92444;1;14102;VERDADERO;VERDADERO;-15;;;
92429;92444;0;14103;VERDADERO;VERDADERO;-15;;;
92429;92464;1;14104;VERDADERO;VERDADERO;-35;;;
92461;92464;0;14105;VERDADERO;VERDADERO;-3;;;
92461;92464;0;14106;VERDADERO;VERDADERO;-3;;;
92461;92484;0;14107;VERDADERO;VERDADERO;-23;;;
92461;92484;0;14108;VERDADERO;VERDADERO;-23;;;
92461;92504;0;14109;VERDADERO;VERDADERO;-43;;;
92492;92504;0;14110;VERDADERO;VERDADERO;-12;;;
92492;92504;0;14111;VERDADERO;VERDADERO;-12;;;
92492;92524;0;14112;VERDADERO;VERDADERO;-32;;;
92492;92524;0;14113;VERDADERO;VERDADERO;-32;;;
92492;92544;0;14114;VERDADERO;FALSO;-52;;;
92492;92544;0;14115;VERDADERO;FALSO;-52;;;
92529;92544;0;14116;VERDADERO;VERDADERO;-15;;;
92529;92564;0;14117;VERDADERO;VERDADERO;-35;;;
92529;92564;0;14118;VERDADERO;VERDADERO;-35;;;
92529;92564;0;14119;VERDADERO;VERDADERO;-35;;;
92529;92584;1;14120;VERDADERO;FALSO;-55;;;
92561;92584;0;14121;VERDADERO;VERDADERO;-23;;;
92561;92584;0;14122;VERDADERO;VERDADERO;-23;;;
92561;92584;0;14123;VERDADERO;VERDADERO;-23;;;
92561;92584;0;14124;VERDADERO;VERDADERO;-23;;;
92561;92584;0;14125;VERDADERO;VERDADERO;-23;;;
92593;92604;0;14126;VERDADERO;VERDADERO;-11;;;
92593;92604;0;14127;VERDADERO;VERDADERO;-11;;;
92593;92604;0;14128;VERDADERO;VERDADERO;-11;;;
92593;92624;0;14129;VERDADERO;VERDADERO;-31;;;
92593;92624;0;14130;VERDADERO;VERDADERO;-31;;;
92625;92624;0;14131;VERDADERO;VERDADERO;1;;;
92625;92624;0;14132;VERDADERO;VERDADERO;1;;;
92625;92624;0;14133;VERDADERO;VERDADERO;1;;;
92625;92644;0;14134;VERDADERO;VERDADERO;-19;;;
92625;92644;0;14135;VERDADERO;VERDADERO;-19;;;
92657;92665;0;14136;VERDADERO;VERDADERO;-8;;;
92657;92665;0;14137;VERDADERO;VERDADERO;-8;;;
92657;92685;0;14138;VERDADERO;VERDADERO;-28;;;
92657;92685;0;14139;VERDADERO;VERDADERO;-28;;;
92657;92685;0;14140;VERDADERO;VERDADERO;-28;;;
92657;92685;0;14141;VERDADERO;VERDADERO;-28;;;
92657;92705;0;14142;VERDADERO;VERDADERO;-48;;;
92699;92705;0;14143;VERDADERO;VERDADERO;-6;;;
92699;92725;0;14144;VERDADERO;VERDADERO;-26;;;
92699;92725;0;14145;VERDADERO;VERDADERO;-26;;;
92699;92725;0;14146;VERDADERO;VERDADERO;-26;;;
92725;92725;0;14147;VERDADERO;VERDADERO;0;;;
92725;92725;0;14148;VERDADERO;VERDADERO;0;;;
92725;92725;0;14149;VERDADERO;VERDADERO;0;;;
92725;92745;1;14150;VERDADERO;VERDADERO;-20;;;
92725;92745;0;14151;VERDADERO;VERDADERO;-20;;;
92757;92745;0;14152;VERDADERO;VERDADERO;12;;;
92757;92765;0;14153;VERDADERO;VERDADERO;-8;;;
92757;92765;0;14154;VERDADERO;VERDADERO;-8;;;
92757;92785;1;14155;VERDADERO;VERDADERO;-28;;;
92757;92785;0;14156;VERDADERO;VERDADERO;-28;;;
92793;92785;0;14157;VERDADERO;VERDADERO;8;;;
92793;92805;0;14158;VERDADERO;VERDADERO;-12;;;
92793;92805;0;14159;VERDADERO;VERDADERO;-12;;;
92793;92825;0;14160;VERDADERO;VERDADERO;-32;;;
92793;92825;0;14161;VERDADERO;VERDADERO;-32;;;
92793;92825;0;14162;VERDADERO;VERDADERO;-32;;;
92829;92845;1;14163;VERDADERO;VERDADERO;-16;;;
92829;92845;0;14164;VERDADERO;VERDADERO;-16;;;
92829;92845;0;14165;VERDADERO;VERDADERO;-16;;;
92829;92865;0;14166;VERDADERO;VERDADERO;-36;;;
92829;92865;0;14167;VERDADERO;VERDADERO;-36;;;
92862;92885;1;14168;VERDADERO;VERDADERO;-23;;;
92862;92885;0;14169;VERDADERO;VERDADERO;-23;;;
92862;92885;0;14170;VERDADERO;VERDADERO;-23;;;
92862;92885;0;14171;VERDADERO;VERDADERO;-23;;;
92862;92885;0;14172;VERDADERO;VERDADERO;-23;;;
92862;92905;0;14173;VERDADERO;VERDADERO;-43;;;
92897;92905;0;14174;VERDADERO;VERDADERO;-8;;;
92897;92925;0;14175;VERDADERO;VERDADERO;-28;;;
92897;92925;0;14176;VERDADERO;VERDADERO;-28;;;
92897;92925;0;14177;VERDADERO;VERDADERO;-28;;;
92897;92945;0;14178;VERDADERO;VERDADERO;-48;;;
92928;92945;0;14179;VERDADERO;VERDADERO;-17;;;
92928;92965;0;14180;VERDADERO;VERDADERO;-37;;;
92928;92965;0;14181;VERDADERO;VERDADERO;-37;;;
92928;92965;0;14182;VERDADERO;VERDADERO;-37;;;
92928;92985;0;14183;VERDADERO;FALSO;-57;;;
92965;92985;0;14184;VERDADERO;VERDADERO;-20;;;
92965;92985;0;14185;VERDADERO;VERDADERO;-20;;;
92965;92985;0;14186;VERDADERO;VERDADERO;-20;;;
92965;92985;0;14187;VERDADERO;VERDADERO;-20;;;
92965;93005;0;14188;VERDADERO;VERDADERO;-40;;;
92965;93005;0;14189;VERDADERO;VERDADERO;-40;;;
93000;93005;0;14190;VERDADERO;VERDADERO;-5;;;
93000;93025;0;14191;VERDADERO;VERDADERO;-25;;;
93000;93025;0;14192;VERDADERO;VERDADERO;-25;;;
93000;93025;0;14193;VERDADERO;VERDADERO;-25;;;
93000;93025;0;14194;VERDADERO;VERDADERO;-25;;;
93033;93025;0;14195;VERDADERO;VERDADERO;8;;;
93033;93045;0;14196;VERDADERO;VERDADERO;-12;;;
93033;93045;0;14197;VERDADERO;VERDADERO;-12;;;
93033;93065;1;14198;VERDADERO;VERDADERO;-32;;;
93033;93065;0;14199;VERDADERO;VERDADERO;-32;;;
93064;93065;0;14200;VERDADERO;VERDADERO;-1;;;
93064;93085;0;14201;VERDADERO;VERDADERO;-21;;;
93064;93085;0;14202;VERDADERO;VERDADERO;-21;;;
93064;93085;0;14203;VERDADERO;VERDADERO;-21;;;
93064;93105;0;14204;VERDADERO;VERDADERO;-41;;;
93096;93105;0;14205;VERDADERO;VERDADERO;-9;;;
93096;93125;0;14206;VERDADERO;VERDADERO;-29;;;
93096;93125;0;14207;VERDADERO;VERDADERO;-29;;;
93096;93125;0;14208;VERDADERO;VERDADERO;-29;;;
93096;93125;0;14209;VERDADERO;VERDADERO;-29;;;
93096;93125;0;14210;VERDADERO;VERDADERO;-29;;;
93133;93145;0;14211;VERDADERO;VERDADERO;-12;;;
93133;93145;0;14212;VERDADERO;VERDADERO;-12;;;
93133;93145;0;14213;VERDADERO;VERDADERO;-12;;;
93133;93166;0;14214;VERDADERO;VERDADERO;-33;;;
93161;93166;0;14215;VERDADERO;VERDADERO;-5;;;
93161;93186;0;14216;VERDADERO;VERDADERO;-25;;;
93161;93186;0;14217;VERDADERO;VERDADERO;-25;;;
93161;93186;0;14218;VERDADERO;VERDADERO;-25;;;
93161;93206;1;14219;VERDADERO;VERDADERO;-45;;;
93161;93206;0;14220;VERDADERO;VERDADERO;-45;;;
93196;93206;0;14221;VERDADERO;VERDADERO;-10;;;
93196;93226;0;14222;VERDADERO;VERDADERO;-30;;;
93196;93226;0;14223;VERDADERO;VERDADERO;-30;;;
93196;93226;0;14224;VERDADERO;VERDADERO;-30;;;
93196;93226;0;14225;VERDADERO;VERDADERO;-30;;;
93229;93226;0;14226;VERDADERO;VERDADERO;3;;;
93229;93226;0;14227;VERDADERO;VERDADERO;3;;;
93229;93246;0;14228;VERDADERO;VERDADERO;-17;;;
93229;93246;0;14229;VERDADERO;VERDADERO;-17;;;
93229;93246;0;14230;VERDADERO;VERDADERO;-17;;;
93229;93266;0;14231;VERDADERO;VERDADERO;-37;;;
93265;93266;0;14232;VERDADERO;VERDADERO;-1;;;
93265;93286;1;14233;VERDADERO;VERDADERO;-21;;;
93265;93286;0;14234;VERDADERO;VERDADERO;-21;;;
93265;93286;0,00E+00;14235;VERDADERO;VERDADERO;-21;;;
93293;93306;0;14236;VERDADERO;VERDADERO;-13;;;
93293;93306;0;14237;VERDADERO;VERDADERO;-13;;;
93293;93326;0;14238;VERDADERO;VERDADERO;-33;;;
93293;93326;0;14239;VERDADERO;VERDADERO;-33;;;
93293;93326;0;14240;VERDADERO;VERDADERO;-33;;;
93325;93326;0;14241;VERDADERO;VERDADERO;-1;;;
93325;93326;0;14242;VERDADERO;VERDADERO;-1;;;
93325;93326;0;14243;VERDADERO;VERDADERO;-1;;;
93325;93346;0;14244;VERDADERO;VERDADERO;-21;;;
93325;93346;0;14245;VERDADERO;VERDADERO;-21;;;
93357;93366;1;14246;VERDADERO;VERDADERO;-9;;;
93357;93366;0;14247;VERDADERO;VERDADERO;-9;;;
93357;93366;0;14248;VERDADERO;VERDADERO;-9;;;
93357;93386;0;14249;VERDADERO;VERDADERO;-29;;;
93357;93386;0;14250;VERDADERO;VERDADERO;-29;;;
93389;93386;0;14251;VERDADERO;VERDADERO;3;;;
93389;93386;0;14252;VERDADERO;VERDADERO;3;;;
93389;93406;0;14253;VERDADERO;VERDADERO;-17;;;
93389;93406;0;14254;VERDADERO;VERDADERO;-17;;;
93389;93426;0;14255;VERDADERO;VERDADERO;-37;;;
93389;93426;0;14256;VERDADERO;VERDADERO;-37;;;
93389;93426;0;14257;VERDADERO;VERDADERO;-37;;;
93431;93426;0;14258;VERDADERO;VERDADERO;5;;;
93431;93426;0;14259;VERDADERO;VERDADERO;5;;;
93431;93446;0;14260;VERDADERO;VERDADERO;-15;;;
93431;93446;0;14261;VERDADERO;VERDADERO;-15;;;
93457;93446;0;14262;VERDADERO;VERDADERO;11;;;
93457;93467;0;14263;VERDADERO;VERDADERO;-10;;;
93457;93467;0;14264;VERDADERO;VERDADERO;-10;;;
93457;93487;0;14265;VERDADERO;VERDADERO;-30;;;
93457;93487;0;14266;VERDADERO;VERDADERO;-30;;;
93488;93487;0;14267;VERDADERO;VERDADERO;1;;;
93488;93507;0;14268;VERDADERO;VERDADERO;-19;;;
93488;93507;0;14269;VERDADERO;VERDADERO;-19;;;
93488;93507;0;14270;VERDADERO;VERDADERO;-19;;;
93488;93527;0;14271;VERDADERO;VERDADERO;-39;;;
93488;93527;0;14272;VERDADERO;VERDADERO;-39;;;
93525;93527;0;14273;VERDADERO;VERDADERO;-2;;;
93525;93527;0;14274;VERDADERO;VERDADERO;-2;;;
93525;93547;0;14275;VERDADERO;VERDADERO;-22;;;
93525;93547;0;14276;VERDADERO;VERDADERO;-22;;;
93525;93547;0;14277;VERDADERO;VERDADERO;-22;;;
93525;93568;0;14278;VERDADERO;VERDADERO;-43;;;
93561;93568;0;14279;VERDADERO;VERDADERO;-7;;;
93561;93588;0;14280;VERDADERO;VERDADERO;-27;;;
93561;93588;0;14281;VERDADERO;VERDADERO;-27;;;
93561;93588;0;14282;VERDADERO;VERDADERO;-27;;;
93561;93608;0;14283;VERDADERO;VERDADERO;-47;;;
93597;93608;0;14284;VERDADERO;VERDADERO;-11;;;
93597;93628;0;14285;VERDADERO;VERDADERO;-31;;;
93597;93628;0;14286;VERDADERO;VERDADERO;-31;;;
93597;93628;0;14287;VERDADERO;VERDADERO;-31;;;
93597;93628;0;14288;VERDADERO;VERDADERO;-31;;;
93625;93648;1;14289;VERDADERO;VERDADERO;-23;;;
93625;93648;0;14290;VERDADERO;VERDADERO;-23;;;
93625;93648;0;14291;VERDADERO;VERDADERO;-23;;;
93625;93668;1;14292;VERDADERO;VERDADERO;-43;;;
93625;93668;0;14293;VERDADERO;VERDADERO;-43;;;
93661;93668;0;14294;VERDADERO;VERDADERO;-7;;;
93661;93668;0;14295;VERDADERO;VERDADERO;-7;;;
93661;93668;0;14296;VERDADERO;VERDADERO;-7;;;
93661;93688;0;14297;VERDADERO;VERDADERO;-27;;;
93661;93688;0;14298;VERDADERO;VERDADERO;-27;;;
93692;93708;0;14299;VERDADERO;VERDADERO;-16;;;
93692;93708;0;14300;VERDADERO;VERDADERO;-16;;;
93692;93708;0;14301;VERDADERO;VERDADERO;-16;;;
93692;93728;0;14302;VERDADERO;VERDADERO;-36;;;
93692;93728;0;14303;VERDADERO;VERDADERO;-36;;;
93692;93748;0;14304;VERDADERO;FALSO;-56;;;
93732;93748;0;14305;VERDADERO;VERDADERO;-16;;;
93732;93748;0;14306;VERDADERO;VERDADERO;-16;;;
93732;93768;0;14307;VERDADERO;VERDADERO;-36;;;
93732;93768;0;14308;VERDADERO;VERDADERO;-36;;;
93732;93768;0;14309;VERDADERO;VERDADERO;-36;;;
93761;93768;0;14310;VERDADERO;VERDADERO;-7;;;
93761;93768;0;14311;VERDADERO;VERDADERO;-7;;;
93761;93788;0;14312;VERDADERO;VERDADERO;-27;;;
93761;93788;0;14313;VERDADERO;VERDADERO;-27;;;
93761;93808;0;14314;VERDADERO;VERDADERO;-47;;;
93761;93808;0;14315;VERDADERO;VERDADERO;-47;;;
93796;93808;0;14316;VERDADERO;VERDADERO;-12;;;
93796;93808;0;14317;VERDADERO;VERDADERO;-12;;;
93796;93808;0;14318;VERDADERO;VERDADERO;-12;;;
93796;93808;0;14319;VERDADERO;VERDADERO;-12;;;
93796;93828;0;14320;VERDADERO;VERDADERO;-32;;;
93828;93828;0;14321;VERDADERO;VERDADERO;0;;;
93828;93849;0;14322;VERDADERO;VERDADERO;-21;;;
93828;93849;0;14323;VERDADERO;VERDADERO;-21;;;
93828;93869;0;14324;VERDADERO;VERDADERO;-41;;;
93828;93869;0;14325;VERDADERO;VERDADERO;-41;;;
93828;93869;0;14326;VERDADERO;VERDADERO;-41;;;
93868;93869;0;14327;VERDADERO;VERDADERO;-1;;;
93868;93889;1;14328;VERDADERO;VERDADERO;-21;;;
93868;93889;0;14329;VERDADERO;VERDADERO;-21;;;
93868;93909;0;14330;VERDADERO;VERDADERO;-41;;;
93894;93909;0;14331;VERDADERO;VERDADERO;-15;;;
93894;93909;0;14332;VERDADERO;VERDADERO;-15;;;
93894;93929;0;14333;VERDADERO;VERDADERO;-35;;;
93894;93929;0;14334;VERDADERO;VERDADERO;-35;;;
93894;93949;0;14335;VERDADERO;FALSO;-55;;;
93925;93949;0;14336;VERDADERO;VERDADERO;-24;;;
93925;93949;0;14337;VERDADERO;VERDADERO;-24;;;
93925;93969;0;14338;VERDADERO;VERDADERO;-44;;;
93925;93969;0;14339;VERDADERO;VERDADERO;-44;;;
93925;93969;0;14340;VERDADERO;VERDADERO;-44;;;
93956;93969;0;14341;VERDADERO;VERDADERO;-13;;;
93956;93969;0;14342;VERDADERO;VERDADERO;-13;;;
93956;93969;0;14343;VERDADERO;VERDADERO;-13;;;
93956;93989;0;14344;VERDADERO;VERDADERO;-33;;;
93956;93989;0;14345;VERDADERO;VERDADERO;-33;;;
93990;94009;1;14346;VERDADERO;VERDADERO;-19;;;
93990;94009;0;14347;VERDADERO;VERDADERO;-19;;;
93990;94009;0;14348;VERDADERO;VERDADERO;-19;;;
93990;94009;0;14349;VERDADERO;VERDADERO;-19;;;
93990;94009;0;14350;VERDADERO;VERDADERO;-19;;;
93990;94029;0;14351;VERDADERO;VERDADERO;-39;;;
94025;94029;0;14352;VERDADERO;VERDADERO;-4;;;
94025;94049;0;14353;VERDADERO;VERDADERO;-24;;;
94025;94049;0;14354;VERDADERO;VERDADERO;-24;;;
94025;94049;0;14355;VERDADERO;VERDADERO;-24;;;
94025;94069;0;14356;VERDADERO;VERDADERO;-44;;;
94057;94069;0;14357;VERDADERO;VERDADERO;-12;;;
94057;94089;0;14358;VERDADERO;VERDADERO;-32;;;
94057;94089;0;14359;VERDADERO;VERDADERO;-32;;;
94057;94089;0;14360;VERDADERO;VERDADERO;-32;;;
94057;94109;0;14361;VERDADERO;FALSO;-52;;;
94093;94109;0;14362;VERDADERO;VERDADERO;-16;;;
94093;94109;0;14363;VERDADERO;VERDADERO;-16;;;
94093;94109;0;14364;VERDADERO;VERDADERO;-16;;;
94093;94129;0;14365;VERDADERO;VERDADERO;-36;;;
94093;94129;0;14366;VERDADERO;VERDADERO;-36;;;
94126;94129;0;14367;VERDADERO;VERDADERO;-3;;;
94126;94149;0;14368;VERDADERO;VERDADERO;-23;;;
94126;94149;0;14369;VERDADERO;VERDADERO;-23;;;
94126;94149;0;14370;VERDADERO;VERDADERO;-23;;;
94126;94149;0;14371;VERDADERO;VERDADERO;-23;;;
94126;94149;0;14372;VERDADERO;VERDADERO;-23;;;
94161;94169;0;14373;VERDADERO;VERDADERO;-8;;;
94161;94169;0;14374;VERDADERO;VERDADERO;-8;;;
94161;94169;0;14375;VERDADERO;VERDADERO;-8;;;
94161;94189;1;14376;VERDADERO;VERDADERO;-28;;;
94161;94189;0;14377;VERDADERO;VERDADERO;-28;;;
94193;94209;0;14378;VERDADERO;VERDADERO;-16;;;
94193;94209;0;14379;VERDADERO;VERDADERO;-16;;;
94193;94209;0;14380;VERDADERO;VERDADERO;-16;;;
94193;94209;0;14381;VERDADERO;VERDADERO;-16;;;
94193;94209;0;14382;VERDADERO;VERDADERO;-16;;;
94225;94209;0;14383;VERDADERO;VERDADERO;16;;;
94225;94229;0;14384;VERDADERO;VERDADERO;-4;;;
94225;94229;0;14385;VERDADERO;VERDADERO;-4;;;
94225;94229;0;14386;VERDADERO;VERDADERO;-4;;;
94225;94249;0;14387;VERDADERO;VERDADERO;-24;;;
94225;94249;0;14388;VERDADERO;VERDADERO;-24;;;
94260;94249;0;14389;VERDADERO;VERDADERO;11;;;
94260;94249;0;14390;VERDADERO;VERDADERO;11;;;
94260;94249;0;14391;VERDADERO;VERDADERO;11;;;
94260;94249;0;14392;VERDADERO;VERDADERO;11;;;
94260;94269;0;14393;VERDADERO;VERDADERO;-9;;;
94289;94269;0;14394;VERDADERO;VERDADERO;20;;;
94289;94289;0;14395;VERDADERO;VERDADERO;0;;;
94289;94289;0;14396;VERDADERO;VERDADERO;0;;;
94289;94289;0;14397;VERDADERO;VERDADERO;0;;;
94289;94309;0;14398;VERDADERO;VERDADERO;-20;;;
94325;94309;0;14399;VERDADERO;VERDADERO;16;;;
94325;94329;0;14400;VERDADERO;VERDADERO;-4;;;
94325;94329;0;14401;VERDADERO;VERDADERO;-4;;;
94325;94329;0;14402;VERDADERO;VERDADERO;-4;;;
94325;94349;1;14403;VERDADERO;VERDADERO;-24;;;
94357;94349;0;14404;VERDADERO;VERDADERO;8;;;
94357;94369;0;14405;VERDADERO;VERDADERO;-12;;;
94357;94369;0;14406;VERDADERO;VERDADERO;-12;;;
94357;94369;0;14407;VERDADERO;VERDADERO;-12;;;
94357;94389;0;14408;VERDADERO;VERDADERO;-32;;;
94388;94389;0;14409;VERDADERO;VERDADERO;-1;;;
94388;94409;0;14410;VERDADERO;VERDADERO;-21;;;
94388;94409;0;14411;VERDADERO;VERDADERO;-21;;;
94388;94409;0;14412;VERDADERO;VERDADERO;-21;;;
94388;94429;0;14413;VERDADERO;VERDADERO;-41;;;
94388;94429;0;14414;VERDADERO;VERDADERO;-41;;;
94428;94429;0;14415;VERDADERO;VERDADERO;-1;;;
94428;94429;0;14416;VERDADERO;VERDADERO;-1;;;
94428;94429;0;14417;VERDADERO;VERDADERO;-1;;;
94428;94449;0;14418;VERDADERO;VERDADERO;-21;;;
94454;94449;0;14419;VERDADERO;VERDADERO;5;;;
94454;94469;0;14420;VERDADERO;VERDADERO;-15;;;
94454;94469;0;14421;VERDADERO;VERDADERO;-15;;;
94454;94469;0;14422;VERDADERO;VERDADERO;-15;;;
94454;94489;0;14423;VERDADERO;VERDADERO;-35;;;
94454;94489;0;14424;VERDADERO;VERDADERO;-35;;;
94488;94489;0;14425;VERDADERO;VERDADERO;-1;;;
94488;94509;0;14426;VERDADERO;VERDADERO;-21;;;
94488;94509;0;14427;VERDADERO;VERDADERO;-21;;;
94488;94509;0;14428;VERDADERO;VERDADERO;-21;;;
94488;94529;0;14429;VERDADERO;VERDADERO;-41;;;
94521;94529;0;14430;VERDADERO;VERDADERO;-8;;;
94521;94529;0;14431;VERDADERO;VERDADERO;-8;;;
94521;94529;0;14432;VERDADERO;VERDADERO;-8;;;
94521;94549;0;14433;VERDADERO;VERDADERO;-28;;;
94521;94549;0;14434;VERDADERO;VERDADERO;-28;;;
94556;94549;0;14435;VERDADERO;VERDADERO;7;;;
94556;94570;0;14436;VERDADERO;VERDADERO;-14;;;
94556;94570;0;14437;VERDADERO;VERDADERO;-14;;;
94556;94590;0;14438;VERDADERO;VERDADERO;-34;;;
94556;94590;0;14439;VERDADERO;VERDADERO;-34;;;
94589;94590;0;14440;VERDADERO;VERDADERO;-1;;;
94589;94610;0;14441;VERDADERO;VERDADERO;-21;;;
94589;94610;0;14442;VERDADERO;VERDADERO;-21;;;
94589;94630;0;14443;VERDADERO;VERDADERO;-41;;;
94589;94630;0;14444;VERDADERO;VERDADERO;-41;;;
94589;94630;0;14445;VERDADERO;VERDADERO;-41;;;
94589;94630;0;14446;VERDADERO;VERDADERO;-41;;;
94630;94630;0;14447;VERDADERO;VERDADERO;0;;;
94630;94630;0;14448;VERDADERO;VERDADERO;0;;;
94630;94650;0;14449;VERDADERO;VERDADERO;-20;;;
94630;94650;0;14450;VERDADERO;VERDADERO;-20;;;
94657;94670;0;14451;VERDADERO;VERDADERO;-13;;;
94657;94670;0;14452;VERDADERO;VERDADERO;-13;;;
94657;94670;0;14453;VERDADERO;VERDADERO;-13;;;
94657;94690;1;14454;VERDADERO;VERDADERO;-33;;;
94657;94690;0;14455;VERDADERO;VERDADERO;-33;;;
94689;94690;0;14456;VERDADERO;VERDADERO;-1;;;
94689;94710;0;14457;VERDADERO;VERDADERO;-21;;;
94689;94710;0;14458;VERDADERO;VERDADERO;-21;;;
94689;94730;0;14459;VERDADERO;VERDADERO;-41;;;
94689;94730;0;14460;VERDADERO;VERDADERO;-41;;;
94689;94730;0;14461;VERDADERO;VERDADERO;-41;;;
94725;94730;0;14462;VERDADERO;VERDADERO;-5;;;
94725;94730;0;14463;VERDADERO;VERDADERO;-5;;;
94725;94750;0;14464;VERDADERO;VERDADERO;-25;;;
94725;94750;0;14465;VERDADERO;VERDADERO;-25;;;
94725;94750;0;14466;VERDADERO;VERDADERO;-25;;;
94725;94771;0;14467;VERDADERO;VERDADERO;-46;;;
94765;94771;0;14468;VERDADERO;VERDADERO;-6;;;
94765;94791;0;14469;VERDADERO;VERDADERO;-26;;;
94765;94791;0;14470;VERDADERO;VERDADERO;-26;;;
94765;94791;0;14471;VERDADERO;VERDADERO;-26;;;
94793;94791;0;14472;VERDADERO;VERDADERO;2;;;
94793;94811;0;14473;VERDADERO;VERDADERO;-18;;;
94793;94811;0;14474;VERDADERO;VERDADERO;-18;;;
94793;94831;1;14475;VERDADERO;VERDADERO;-38;;;
94793;94831;0;14476;VERDADERO;VERDADERO;-38;;;
94825;94851;1;14477;VERDADERO;VERDADERO;-26;;;
94825;94851;0;14478;VERDADERO;VERDADERO;-26;;;
94825;94851;0;14479;VERDADERO;VERDADERO;-26;;;
94825;94871;0;14480;VERDADERO;VERDADERO;-46;;;
94825;94871;0;14481;VERDADERO;VERDADERO;-46;;;
94856;94871;0;14482;VERDADERO;VERDADERO;-15;;;
94856;94891;0;14483;VERDADERO;VERDADERO;-35;;;
94856;94891;0;14484;VERDADERO;VERDADERO;-35;;;
94856;94891;0;14485;VERDADERO;VERDADERO;-35;;;
94856;94891;0;14486;VERDADERO;VERDADERO;-35;;;
94889;94891;0;14487;VERDADERO;VERDADERO;-2;;;
94889;94891;0;14488;VERDADERO;VERDADERO;-2;;;
94889;94891;0;14489;VERDADERO;VERDADERO;-2;;;
94889;94891;0;14490;VERDADERO;VERDADERO;-2;;;
94889;94891;0;14491;VERDADERO;VERDADERO;-2;;;
94889;94911;0;14492;VERDADERO;VERDADERO;-22;;;
94924;94911;0;14493;VERDADERO;VERDADERO;13;;;
94924;94931;0;14494;VERDADERO;VERDADERO;-7;;;
94924;94931;0;14495;VERDADERO;VERDADERO;-7;;;
94924;94931;0;14496;VERDADERO;VERDADERO;-7;;;
94924;94931;0;14497;VERDADERO;VERDADERO;-7;;;
94957;94931;0;14498;VERDADERO;VERDADERO;26;;;
94957;94931;0;14499;VERDADERO;VERDADERO;26;;;
94957;94931;0;14500;VERDADERO;VERDADERO;26;;;
94957;94931;0;14501;VERDADERO;VERDADERO;26;;;
94957;94951;0;14502;VERDADERO;VERDADERO;6;;;
94989;94951;0;14503;VERDADERO;VERDADERO;38;;;
94989;94951;0;14504;VERDADERO;VERDADERO;38;;;
94989;94971;0;14505;VERDADERO;VERDADERO;18;;;
94989;94971;0;14506;VERDADERO;VERDADERO;18;;;
94989;94991;0;14507;VERDADERO;VERDADERO;-2;;;
95022;94991;0;14508;VERDADERO;VERDADERO;31;;;
95022;94991;0;14509;VERDADERO;VERDADERO;31;;;
95022;95011;0;14510;VERDADERO;VERDADERO;11;;;
95022;95011;0;14511;VERDADERO;VERDADERO;11;;;
95022;95011;0;14512;VERDADERO;VERDADERO;11;;;
95022;95011;0;14513;VERDADERO;VERDADERO;11;;;
95053;95011;0;14514;VERDADERO;VERDADERO;42;;;
95053;95011;0;14515;VERDADERO;VERDADERO;42;;;
95053;95031;0;14516;VERDADERO;VERDADERO;22;;;
95053;95031;0;14517;VERDADERO;VERDADERO;22;;;
95053;95031;0;14518;VERDADERO;VERDADERO;22;;;
95053;95051;0;14519;VERDADERO;VERDADERO;2;;;
95088;95051;0;14520;VERDADERO;VERDADERO;37;;;
95088;95071;0;14521;VERDADERO;VERDADERO;17;;;
95088;95071;0;14522;VERDADERO;VERDADERO;17;;;
95088;95071;0;14523;VERDADERO;VERDADERO;17;;;
95121;95091;1;14524;VERDADERO;VERDADERO;30;;;
95121;95091;0;14525;VERDADERO;VERDADERO;30;;;
95121;95111;0;14526;VERDADERO;VERDADERO;10;;;
95121;95111;0;14527;VERDADERO;VERDADERO;10;;;
95121;95111;0;14528;VERDADERO;VERDADERO;10;;;
95121;95131;0;14529;VERDADERO;VERDADERO;-10;;;
95156;95131;0;14530;VERDADERO;VERDADERO;25;;;
95156;95151;0;14531;VERDADERO;VERDADERO;5;;;
95156;95151;0;14532;VERDADERO;VERDADERO;5;;;
95156;95151;0;14533;VERDADERO;VERDADERO;5;;;
95156;95171;0;14534;VERDADERO;VERDADERO;-15;;;
95156;95171;0;14535;VERDADERO;VERDADERO;-15;;;
95196;95192;1;14536;VERDADERO;VERDADERO;4;;;
95196;95192;0;14537;VERDADERO;VERDADERO;4;;;
95196;95192;0;14538;VERDADERO;VERDADERO;4;;;
95196;95212;0;14539;VERDADERO;VERDADERO;-16;;;
95196;95212;0;14540;VERDADERO;VERDADERO;-16;;;
95224;95232;0;14541;VERDADERO;VERDADERO;-8;;;
95224;95232;0;14542;VERDADERO;VERDADERO;-8;;;
95224;95232;0;14543;VERDADERO;VERDADERO;-8;;;
95224;95252;0;14544;VERDADERO;VERDADERO;-28;;;
95224;95252;0;14545;VERDADERO;VERDADERO;-28;;;
95256;95272;1;14546;VERDADERO;VERDADERO;-16;;;
95256;95272;0;14547;VERDADERO;VERDADERO;-16;;;
95256;95272;0;14548;VERDADERO;VERDADERO;-16;;;
95256;95292;0;14549;VERDADERO;VERDADERO;-36;;;
95256;95292;0;14550;VERDADERO;VERDADERO;-36;;;
95292;95292;0;14551;VERDADERO;VERDADERO;0;;;
95292;95292;0;14552;VERDADERO;VERDADERO;0;;;
95292;95292;0;14553;VERDADERO;VERDADERO;0;;;
95292;95292;0;14554;VERDADERO;VERDADERO;0;;;
95292;95312;0;14555;VERDADERO;VERDADERO;-20;;;
95292;95312;0;14556;VERDADERO;VERDADERO;-20;;;
95292;95333;0;14557;VERDADERO;VERDADERO;-41;;;
95330;95333;0;14558;VERDADERO;VERDADERO;-3;;;
95330;95333;0;14559;VERDADERO;VERDADERO;-3;;;
95330;95353;1;14560;VERDADERO;VERDADERO;-23;;;
95330;95353;0;14561;VERDADERO;VERDADERO;-23;;;
95330;95373;0;14562;VERDADERO;VERDADERO;-43;;;
95360;95373;0;14563;VERDADERO;VERDADERO;-13;;;
95360;95373;0;14564;VERDADERO;VERDADERO;-13;;;
95360;95393;0;14565;VERDADERO;VERDADERO;-33;;;
95360;95393;0;14566;VERDADERO;VERDADERO;-33;;;
95393;95413;0;14567;VERDADERO;VERDADERO;-20;;;
95393;95413;0;14568;VERDADERO;VERDADERO;-20;;;
95393;95413;0;14569;VERDADERO;VERDADERO;-20;;;
95393;95413;0;14570;VERDADERO;VERDADERO;-20;;;
95393;95413;0;14571;VERDADERO;VERDADERO;-20;;;
95425;95433;1;14572;VERDADERO;VERDADERO;-8;;;
95425;95433;0;14573;VERDADERO;VERDADERO;-8;;;
95425;95453;0;14574;VERDADERO;VERDADERO;-28;;;
95425;95453;0;14575;VERDADERO;VERDADERO;-28;;;
95425;95453;0;14576;VERDADERO;VERDADERO;-28;;;
95425;95453;0;14577;VERDADERO;VERDADERO;-28;;;
95458;95453;0;14578;VERDADERO;VERDADERO;5;;;
95458;95473;0;14579;VERDADERO;VERDADERO;-15;;;
95458;95473;0;14580;VERDADERO;VERDADERO;-15;;;
95458;95493;0;14581;VERDADERO;VERDADERO;-35;;;
95458;95493;0;14582;VERDADERO;VERDADERO;-35;;;
95493;95493;0;14583;VERDADERO;VERDADERO;0;;;
95493;95513;0;14584;VERDADERO;VERDADERO;-20;;;
95493;95513;0;14585;VERDADERO;VERDADERO;-20;;;
95493;95533;0;14586;VERDADERO;VERDADERO;-40;;;
95493;95533;0;14587;VERDADERO;VERDADERO;-40;;;
95525;95533;0;14588;VERDADERO;VERDADERO;-8;;;
95525;95553;0;14589;VERDADERO;VERDADERO;-28;;;
95525;95553;0;14590;VERDADERO;VERDADERO;-28;;;
95525;95553;0;14591;VERDADERO;VERDADERO;-28;;;
95525;95553;0;14592;VERDADERO;VERDADERO;-28;;;
95557;95553;0;14593;VERDADERO;VERDADERO;4;;;
95557;95573;0;14594;VERDADERO;VERDADERO;-16;;;
95557;95573;0;14595;VERDADERO;VERDADERO;-16;;;
95557;95593;1;14596;VERDADERO;VERDADERO;-36;;;
95557;95593;0;14597;VERDADERO;VERDADERO;-36;;;
95557;95593;0;14598;VERDADERO;VERDADERO;-36;;;
95590;95613;0;14599;VERDADERO;VERDADERO;-23;;;
95590;95613;0;14600;VERDADERO;VERDADERO;-23;;;
95590;95633;1;14601;VERDADERO;VERDADERO;-43;;;
95590;95633;0;14602;VERDADERO;VERDADERO;-43;;;
95620;95633;0;14603;VERDADERO;VERDADERO;-13;;;
95620;95653;0;14604;VERDADERO;VERDADERO;-33;;;
95620;95653;0;14605;VERDADERO;VERDADERO;-33;;;
95620;95653;0;14606;VERDADERO;VERDADERO;-33;;;
95620;95653;0;14607;VERDADERO;VERDADERO;-33;;;
95620;95653;0;14608;VERDADERO;VERDADERO;-33;;;
95657;95653;0;14609;VERDADERO;VERDADERO;4;;;
95657;95653;0;14610;VERDADERO;VERDADERO;4;;;
95657;95673;0;14611;VERDADERO;VERDADERO;-16;;;
95657;95673;0;14612;VERDADERO;VERDADERO;-16;;;
95657;95693;0;14613;VERDADERO;VERDADERO;-36;;;
95688;95693;0;14614;VERDADERO;VERDADERO;-5;;;
95688;95693;0;14615;VERDADERO;VERDADERO;-5;;;
95688;95693;0;14616;VERDADERO;VERDADERO;-5;;;
95688;95693;0;14617;VERDADERO;VERDADERO;-5;;;
95688;95693;0;14618;VERDADERO;VERDADERO;-5;;;
95721;95713;0;14619;VERDADERO;VERDADERO;8;;;
95721;95713;0;14620;VERDADERO;VERDADERO;8;;;
95721;95733;0;14621;VERDADERO;VERDADERO;-12;;;
95721;95733;0;14622;VERDADERO;VERDADERO;-12;;;
95721;95733;0;14623;VERDADERO;VERDADERO;-12;;;
95721;95753;0;14624;VERDADERO;VERDADERO;-32;;;
95754;95753;0;14625;VERDADERO;VERDADERO;1;;;
95754;95773;0;14626;VERDADERO;VERDADERO;-19;;;
95754;95773;0;14627;VERDADERO;VERDADERO;-19;;;
95754;95773;0;14628;VERDADERO;VERDADERO;-19;;;
95754;95793;0;14629;VERDADERO;VERDADERO;-39;;;
95784;95793;0;14630;VERDADERO;VERDADERO;-9;;;
95784;95813;0;14631;VERDADERO;VERDADERO;-29;;;
95784;95813;0;14632;VERDADERO;VERDADERO;-29;;;
95784;95813;0;14633;VERDADERO;VERDADERO;-29;;;
95784;95833;0;14634;VERDADERO;VERDADERO;-49;;;
95820;95833;0;14635;VERDADERO;VERDADERO;-13;;;
95820;95853;0;14636;VERDADERO;VERDADERO;-33;;;
95820;95853;0;14637;VERDADERO;VERDADERO;-33;;;
95820;95853;0;14638;VERDADERO;VERDADERO;-33;;;
95820;95853;0;14639;VERDADERO;VERDADERO;-33;;;
95853;95873;0;14640;VERDADERO;VERDADERO;-20;;;
95853;95873;0;14641;VERDADERO;VERDADERO;-20;;;
95853;95893;0;14642;VERDADERO;VERDADERO;-40;;;
95853;95893;0;14643;VERDADERO;VERDADERO;-40;;;
95853;95893;0;14644;VERDADERO;VERDADERO;-40;;;
95853;95893;0;14645;VERDADERO;VERDADERO;-40;;;
95889;95893;0;14646;VERDADERO;VERDADERO;-4;;;
95889;95893;0;14647;VERDADERO;VERDADERO;-4;;;
95889;95893;0;14648;VERDADERO;VERDADERO;-4;;;
95889;95893;0;14649;VERDADERO;VERDADERO;-4;;;
95889;95913;0;14650;VERDADERO;VERDADERO;-24;;;
95921;95913;0;14651;VERDADERO;VERDADERO;8;;;
95921;95913;0;14652;VERDADERO;VERDADERO;8;;;
95921;95933;0;14653;VERDADERO;VERDADERO;-12;;;
95921;95933;0;14654;VERDADERO;VERDADERO;-12;;;
95921;95933;0;14655;VERDADERO;VERDADERO;-12;;;
95921;95933;0;14656;VERDADERO;VERDADERO;-12;;;
95957;95933;0;14657;VERDADERO;VERDADERO;24;;;
95957;95933;0;14658;VERDADERO;VERDADERO;24;;;
95957;95933;0;14659;VERDADERO;VERDADERO;24;;;
95957;95933;0;14660;VERDADERO;VERDADERO;24;;;
95957;95953;0;14661;VERDADERO;VERDADERO;4;;;
95989;95953;0;14662;VERDADERO;VERDADERO;36;;;
95989;95953;0;14663;VERDADERO;VERDADERO;36;;;
95989;95973;0;14664;VERDADERO;VERDADERO;16;;;
95989;95973;0;14665;VERDADERO;VERDADERO;16;;;
95989;95993;0;14666;VERDADERO;VERDADERO;-4;;;
96020;95993;0;14667;VERDADERO;VERDADERO;27;;;
96020;95993;0;14668;VERDADERO;VERDADERO;27;;;
96020;96013;0;14669;VERDADERO;VERDADERO;7;;;
96020;96013;0;14670;VERDADERO;VERDADERO;7;;;
96020;96033;1;14671;VERDADERO;VERDADERO;-13;;;
96020;96033;0;14672;VERDADERO;VERDADERO;-13;;;
96057;96033;0;14673;VERDADERO;VERDADERO;24;;;
96057;96053;1;14674;VERDADERO;VERDADERO;4;;;
96057;96053;0;14675;VERDADERO;VERDADERO;4;;;
96057;96073;0;14676;VERDADERO;VERDADERO;-16;;;
96057;96073;0;14677;VERDADERO;VERDADERO;-16;;;
96089;96073;0;14678;VERDADERO;VERDADERO;16;;;
96089;96093;0;14679;VERDADERO;VERDADERO;-4;;;
96089;96093;0;14680;VERDADERO;VERDADERO;-4;;;
96089;96113;0;14681;VERDADERO;VERDADERO;-24;;;
96121;96113;0;14682;VERDADERO;VERDADERO;8;;;
96121;96113;0;14683;VERDADERO;VERDADERO;8;;;
96121;96133;0;14684;VERDADERO;VERDADERO;-12;;;
96121;96133;0;14685;VERDADERO;VERDADERO;-12;;;
96121;96154;1;14686;VERDADERO;VERDADERO;-33;;;
96121;96154;0;14687;VERDADERO;VERDADERO;-33;;;
96153;96174;0;14688;VERDADERO;VERDADERO;-21;;;
96153;96174;0;14689;VERDADERO;VERDADERO;-21;;;
96153;96174;0;14690;VERDADERO;VERDADERO;-21;;;
96153;96194;0;14691;VERDADERO;VERDADERO;-41;;;
96185;96194;0;14692;VERDADERO;VERDADERO;-9;;;
96185;96214;0;14693;VERDADERO;VERDADERO;-29;;;
96185;96214;0;14694;VERDADERO;VERDADERO;-29;;;
96185;96214;0;14695;VERDADERO;VERDADERO;-29;;;
96185;96214;0;14696;VERDADERO;VERDADERO;-29;;;
96185;96214;0;14697;VERDADERO;VERDADERO;-29;;;
96221;96234;0;14698;VERDADERO;VERDADERO;-13;;;
96221;96234;0;14699;VERDADERO;VERDADERO;-13;;;
96221;96254;1;14700;VERDADERO;VERDADERO;-33;;;
96221;96254;0;14701;VERDADERO;VERDADERO;-33;;;
96221;96254;0;14702;VERDADERO;VERDADERO;-33;;;
96253;96274;1;14703;VERDADERO;VERDADERO;-21;;;
96253;96274;0;14704;VERDADERO;VERDADERO;-21;;;
96253;96274;0;14705;VERDADERO;VERDADERO;-21;;;
96253;96274;0;14706;VERDADERO;VERDADERO;-21;;;
96253;96294;0;14707;VERDADERO;VERDADERO;-41;;;
96285;96294;0;14708;VERDADERO;VERDADERO;-9;;;
96285;96294;0;14709;VERDADERO;VERDADERO;-9;;;
96285;96314;0;14710;VERDADERO;VERDADERO;-29;;;
96285;96314;0;14711;VERDADERO;VERDADERO;-29;;;
96285;96314;0;14712;VERDADERO;VERDADERO;-29;;;
96285;96314;0;14713;VERDADERO;VERDADERO;-29;;;
96321;96314;0;14714;VERDADERO;VERDADERO;7;;;
96321;96334;0;14715;VERDADERO;VERDADERO;-13;;;
96321;96334;0;14716;VERDADERO;VERDADERO;-13;;;
96321;96334;0;14717;VERDADERO;VERDADERO;-13;;;
96321;96354;0;14718;VERDADERO;VERDADERO;-33;;;
96352;96354;0;14719;VERDADERO;VERDADERO;-2;;;
96352;96374;0;14720;VERDADERO;VERDADERO;-22;;;
96352;96374;0;14721;VERDADERO;VERDADERO;-22;;;
96352;96374;0;14722;VERDADERO;VERDADERO;-22;;;
96352;96394;0;14723;VERDADERO;VERDADERO;-42;;;
96352;96394;0;14724;VERDADERO;VERDADERO;-42;;;
96389;96394;0;14725;VERDADERO;VERDADERO;-5;;;
96389;96414;0;14726;VERDADERO;VERDADERO;-25;;;
96389;96414;0;14727;VERDADERO;VERDADERO;-25;;;
96389;96414;0;14728;VERDADERO;VERDADERO;-25;;;
96389;96414;0;14729;VERDADERO;VERDADERO;-25;;;
96389;96414;0;14730;VERDADERO;VERDADERO;-25;;;
96429;96434;0;14731;VERDADERO;VERDADERO;-5;;;
96429;96434;0;14732;VERDADERO;VERDADERO;-5;;;
96429;96434;0;14733;VERDADERO;VERDADERO;-5;;;
96429;96454;0;14734;VERDADERO;VERDADERO;-25;;;
96429;96454;0;14735;VERDADERO;VERDADERO;-25;;;
96457;96474;0;14736;VERDADERO;VERDADERO;-17;;;
96457;96474;0;14737;VERDADERO;VERDADERO;-17;;;
96457;96474;0;14738;VERDADERO;VERDADERO;-17;;;
96457;96474;0;14739;VERDADERO;VERDADERO;-17;;;
96457;96494;0;14740;VERDADERO;VERDADERO;-37;;;
96488;96494;0;14741;VERDADERO;VERDADERO;-6;;;
96488;96514;0;14742;VERDADERO;VERDADERO;-26;;;
96488;96514;0;14743;VERDADERO;VERDADERO;-26;;;
96488;96514;0;14744;VERDADERO;VERDADERO;-26;;;
96488;96534;0;14745;VERDADERO;VERDADERO;-46;;;
96525;96534;0;14746;VERDADERO;VERDADERO;-9;;;
96525;96534;0;14747;VERDADERO;VERDADERO;-9;;;
96525;96554;0;14748;VERDADERO;VERDADERO;-29;;;
96525;96554;0;14749;VERDADERO;VERDADERO;-29;;;
96525;96574;0;14750;VERDADERO;VERDADERO;-49;;;
96558;96574;0;14751;VERDADERO;VERDADERO;-16;;;
96558;96574;0;14752;VERDADERO;VERDADERO;-16;;;
96558;96574;0;14753;VERDADERO;VERDADERO;-16;;;
96558;96574;0;14754;VERDADERO;VERDADERO;-16;;;
96558;96574;0;14755;VERDADERO;VERDADERO;-16;;;
96558;96594;0;14756;VERDADERO;VERDADERO;-36;;;
96593;96594;0;14757;VERDADERO;VERDADERO;-1;;;
96593;96615;0;14758;VERDADERO;VERDADERO;-22;;;
96593;96615;0;14759;VERDADERO;VERDADERO;-22;;;
96593;96615;0;14760;VERDADERO;VERDADERO;-22;;;
96593;96635;0;14761;VERDADERO;VERDADERO;-42;;;
96625;96635;0;14762;VERDADERO;VERDADERO;-10;;;
96625;96635;0;14763;VERDADERO;VERDADERO;-10;;;
96625;96655;0;14764;VERDADERO;VERDADERO;-30;;;
96625;96655;0;14765;VERDADERO;VERDADERO;-30;;;
96625;96675;0;14766;VERDADERO;FALSO;-50;;;
96656;96675;0;14767;VERDADERO;VERDADERO;-19;;;
96656;96675;0;14768;VERDADERO;VERDADERO;-19;;;
96656;96675;0;14769;VERDADERO;VERDADERO;-19;;;
96656;96675;0;14770;VERDADERO;VERDADERO;-19;;;
96656;96675;0;14771;VERDADERO;VERDADERO;-19;;;
96656;96675;0;14772;VERDADERO;VERDADERO;-19;;;
96693;96675;0;14773;VERDADERO;VERDADERO;18;;;
96693;96675;0;14774;VERDADERO;VERDADERO;18;;;
96693;96675;0;14775;VERDADERO;VERDADERO;18;;;
96693;96675;0;14776;VERDADERO;VERDADERO;18;;;
96721;96675;0;14777;VERDADERO;VERDADERO;46;;;
96721;96695;0;14778;VERDADERO;VERDADERO;26;;;
96721;96695;0;14779;VERDADERO;VERDADERO;26;;;
96721;96695;0;14780;VERDADERO;VERDADERO;26;;;
96721;96715;0;14781;VERDADERO;VERDADERO;6;;;
96721;96715;0;14782;VERDADERO;VERDADERO;6;;;
96757;96715;0;14783;VERDADERO;VERDADERO;42;;;
96757;96735;0;14784;VERDADERO;VERDADERO;22;;;
96757;96735;0;14785;VERDADERO;VERDADERO;22;;;
96757;96735;0;14786;VERDADERO;VERDADERO;22;;;
96757;96735;0;14787;VERDADERO;VERDADERO;22;;;
96789;96735;0;14788;FALSO;VERDADERO;54;;;
96789;96735;0;14789;FALSO;VERDADERO;54;;;
96789;96755;0;14790;VERDADERO;VERDADERO;34;;;
96789;96755;0;14791;VERDADERO;VERDADERO;34;;;
96789;96775;0;14792;VERDADERO;VERDADERO;14;;;
96789;96775;0;14793;VERDADERO;VERDADERO;14;;;
96825;96775;0;14794;FALSO;VERDADERO;50;;;
96825;96795;0;14795;VERDADERO;VERDADERO;30;;;
96825;96795;0;14796;VERDADERO;VERDADERO;30;;;
96825;96815;0;14797;VERDADERO;VERDADERO;10;;;
96852;96815;0;14798;VERDADERO;VERDADERO;37;;;
96852;96835;0;14799;VERDADERO;VERDADERO;17;;;
96852;96835;0;14800;VERDADERO;VERDADERO;17;;;
96852;96835;0;14801;VERDADERO;VERDADERO;17;;;
96852;96855;0;14802;VERDADERO;VERDADERO;-3;;;
96885;96855;0;14803;VERDADERO;VERDADERO;30;;;
96885;96875;1;14804;VERDADERO;VERDADERO;10;;;
96885;96875;0;14805;VERDADERO;VERDADERO;10;;;
96885;96875;0;14806;VERDADERO;VERDADERO;10;;;
96885;96895;0;14807;VERDADERO;VERDADERO;-10;;;
96916;96895;0;14808;VERDADERO;VERDADERO;21;;;
96916;96895;0;14809;VERDADERO;VERDADERO;21;;;
96916;96895;0;14810;VERDADERO;VERDADERO;21;;;
96916;96895;0;14811;VERDADERO;VERDADERO;21;;;
96916;96895;0;14812;VERDADERO;VERDADERO;21;;;
96916;96895;0;14813;VERDADERO;VERDADERO;21;;;
96949;96915;0;14814;VERDADERO;VERDADERO;34;;;
96949;96915;0;14815;VERDADERO;VERDADERO;34;;;
96949;96935;0;14816;VERDADERO;VERDADERO;14;;;
96949;96935;0;14817;VERDADERO;VERDADERO;14;;;
96949;96935;0;14818;VERDADERO;VERDADERO;14;;;
96985;96935;0;14819;FALSO;VERDADERO;50;;;
96985;96935;0;14820;FALSO;VERDADERO;50;;;
96985;96955;0;14821;VERDADERO;VERDADERO;30;;;
96985;96955;0;14822;VERDADERO;VERDADERO;30;;;
96985;96955;0;14823;VERDADERO;VERDADERO;30;;;
97016;96975;0;14824;VERDADERO;VERDADERO;41;;;
97016;96975;0;14825;VERDADERO;VERDADERO;41;;;
97016;96995;0;14826;VERDADERO;VERDADERO;21;;;
97016;96995;0;14827;VERDADERO;VERDADERO;21;;;
97016;96995;0;14828;VERDADERO;VERDADERO;21;;;
97049;97015;1;14829;VERDADERO;VERDADERO;34;;;
97049;97015;0;14830;VERDADERO;VERDADERO;34;;;
97049;97035;0;14831;VERDADERO;VERDADERO;14;;;
97049;97035;0;14832;VERDADERO;VERDADERO;14;;;
97049;97055;0;14833;VERDADERO;VERDADERO;-6;;;
97049;97055;0;14834;VERDADERO;VERDADERO;-6;;;
97085;97055;0;14835;VERDADERO;VERDADERO;30;;;
97085;97075;0;14836;VERDADERO;VERDADERO;10;;;
97085;97075;0;14837;VERDADERO;VERDADERO;10;;;
97085;97095;0;14838;VERDADERO;VERDADERO;-10;;;
97085;97095;0;14839;VERDADERO;VERDADERO;-10;;;
97116;97095;0;14840;VERDADERO;VERDADERO;21;;;
97116;97115;0;14841;VERDADERO;VERDADERO;1;;;
97116;97115;0;14842;VERDADERO;VERDADERO;1;;;
97116;97135;1;14843;VERDADERO;VERDADERO;-19;;;
97116;97135;0;14844;VERDADERO;VERDADERO;-19;;;
97153;97135;0;14845;VERDADERO;VERDADERO;18;;;
97153;97155;0;14846;VERDADERO;VERDADERO;-2;;;
97153;97155;0;14847;VERDADERO;VERDADERO;-2;;;
97153;97175;0;14848;VERDADERO;VERDADERO;-22;;;
97153;97175;0;14849;VERDADERO;VERDADERO;-22;;;
97185;97195;0;14850;VERDADERO;VERDADERO;-10;;;
97185;97195;0;14851;VERDADERO;VERDADERO;-10;;;
97185;97195;0;14852;VERDADERO;VERDADERO;-10;;;
97185;97215;0;14853;VERDADERO;VERDADERO;-30;;;
97185;97215;0;14854;VERDADERO;VERDADERO;-30;;;
97185;97235;0;14855;VERDADERO;FALSO;-50;;;
97220;97235;0;14856;VERDADERO;VERDADERO;-15;;;
97220;97235;0;14857;VERDADERO;VERDADERO;-15;;;
97220;97255;0;14858;VERDADERO;VERDADERO;-35;;;
97220;97255;0;14859;VERDADERO;VERDADERO;-35;;;
97220;97255;0;14860;VERDADERO;VERDADERO;-35;;;
97252;97275;1;14861;VERDADERO;VERDADERO;-23;;;
97252;97275;0;14862;VERDADERO;VERDADERO;-23;;;
97252;97275;0;14863;VERDADERO;VERDADERO;-23;;;
97252;97295;1;14864;VERDADERO;VERDADERO;-43;;;
97252;97295;0;14865;VERDADERO;VERDADERO;-43;;;
97289;97295;0;14866;VERDADERO;VERDADERO;-6;;;
97289;97295;0;14867;VERDADERO;VERDADERO;-6;;;
97289;97295;0;14868;VERDADERO;VERDADERO;-6;;;
97289;97315;0;14869;VERDADERO;VERDADERO;-26;;;
97289;97315;0;14870;VERDADERO;VERDADERO;-26;;;
97320;97336;0;14871;VERDADERO;VERDADERO;-16;;;
97320;97336;0;14872;VERDADERO;VERDADERO;-16;;;
97320;97336;0;14873;VERDADERO;VERDADERO;-16;;;
97320;97356;0;14874;VERDADERO;VERDADERO;-36;;;
97320;97356;0;14875;VERDADERO;VERDADERO;-36;;;
97320;97356;0;14876;VERDADERO;VERDADERO;-36;;;
97357;97356;0;14877;VERDADERO;VERDADERO;1;;;
97357;97356;0;14878;VERDADERO;VERDADERO;1;;;
97357;97356;0;14879;VERDADERO;VERDADERO;1;;;
97357;97356;0;14880;VERDADERO;VERDADERO;1;;;
97357;97376;0;14881;VERDADERO;VERDADERO;-19;;;
97388;97376;0;14882;VERDADERO;VERDADERO;12;;;
97388;97396;0;14883;VERDADERO;VERDADERO;-8;;;
97388;97396;0;14884;VERDADERO;VERDADERO;-8;;;
97388;97396;0;14885;VERDADERO;VERDADERO;-8;;;
97388;97396;0;14886;VERDADERO;VERDADERO;-8;;;
97388;97396;0;14887;VERDADERO;VERDADERO;-8;;;
97424;97416;1;14888;VERDADERO;VERDADERO;8;;;
97424;97416;0;14889;VERDADERO;VERDADERO;8;;;
97424;97416;0;14890;VERDADERO;VERDADERO;8;;;
97424;97436;0;14891;VERDADERO;VERDADERO;-12;;;
97424;97436;0;14892;VERDADERO;VERDADERO;-12;;;
97456;97456;0;14893;VERDADERO;VERDADERO;0;;;
97456;97456;0;14894;VERDADERO;VERDADERO;0;;;
97456;97456;0;14895;VERDADERO;VERDADERO;0;;;
97456;97476;1;14896;VERDADERO;VERDADERO;-20;;;
97456;97476;0;14897;VERDADERO;VERDADERO;-20;;;
97489;97496;0;14898;VERDADERO;VERDADERO;-7;;;
97489;97496;0;14899;VERDADERO;VERDADERO;-7;;;
97489;97496;0;14900;VERDADERO;VERDADERO;-7;;;
97489;97516;0;14901;VERDADERO;VERDADERO;-27;;;
97489;97516;0;14902;VERDADERO;VERDADERO;-27;;;
97521;97536;0;14903;VERDADERO;VERDADERO;-15;;;
97521;97536;0;14904;VERDADERO;VERDADERO;-15;;;
97521;97536;0;14905;VERDADERO;VERDADERO;-15;;;
97521;97556;0;14906;VERDADERO;VERDADERO;-35;;;
97521;97556;0;14907;VERDADERO;VERDADERO;-35;;;
97553;97556;0;14908;VERDADERO;VERDADERO;-3;;;
97553;97556;0;14909;VERDADERO;VERDADERO;-3;;;
97553;97576;0;14910;VERDADERO;VERDADERO;-23;;;
97553;97576;0;14911;VERDADERO;VERDADERO;-23;;;
97553;97596;0;14912;VERDADERO;VERDADERO;-43;;;
97553;97596;0;14913;VERDADERO;VERDADERO;-43;;;
97589;97596;0;14914;VERDADERO;VERDADERO;-7;;;
97589;97616;0;14915;VERDADERO;VERDADERO;-27;;;
97589;97616;0;14916;VERDADERO;VERDADERO;-27;;;
97589;97616;0;14917;VERDADERO;VERDADERO;-27;;;
97589;97616;0;14918;VERDADERO;VERDADERO;-27;;;
97621;97616;0;14919;VERDADERO;VERDADERO;5;;;
97621;97616;0;14920;VERDADERO;VERDADERO;5;;;
97621;97636;0;14921;VERDADERO;VERDADERO;-15;;;
97621;97636;0;14922;VERDADERO;VERDADERO;-15;;;
97621;97656;0;14923;VERDADERO;VERDADERO;-35;;;
97652;97656;0;14924;VERDADERO;VERDADERO;-4;;;
97652;97656;0;14925;VERDADERO;VERDADERO;-4;;;
97652;97656;0;14926;VERDADERO;VERDADERO;-4;;;
97652;97656;0;14927;VERDADERO;VERDADERO;-4;;;
97652;97676;0;14928;VERDADERO;VERDADERO;-24;;;
97652;97676;0;14929;VERDADERO;VERDADERO;-24;;;
97689;97696;0;14930;VERDADERO;VERDADERO;-7;;;
97689;97696;0;14931;VERDADERO;VERDADERO;-7;;;
97689;97696;0;14932;VERDADERO;VERDADERO;-7;;;
97689;97716;0;14933;VERDADERO;VERDADERO;-27;;;
97689;97716;0;14934;VERDADERO;VERDADERO;-27;;;
97721;97736;0;14935;VERDADERO;VERDADERO;-15;;;
97721;97736;0;14936;VERDADERO;VERDADERO;-15;;;
97721;97736;0;14937;VERDADERO;VERDADERO;-15;;;
97721;97756;0;14938;VERDADERO;VERDADERO;-35;;;
97721;97756;0;14939;VERDADERO;VERDADERO;-35;;;
97753;97776;1;14940;VERDADERO;VERDADERO;-23;;;
97753;97776;0;14941;VERDADERO;VERDADERO;-23;;;
97753;97776;0;14942;VERDADERO;VERDADERO;-23;;;
97753;97796;0;14943;VERDADERO;VERDADERO;-43;;;
97753;97796;0;14944;VERDADERO;VERDADERO;-43;;;
97785;97816;0;14945;VERDADERO;VERDADERO;-31;;;
97785;97816;0;14946;VERDADERO;VERDADERO;-31;;;
97785;97816;0;14947;VERDADERO;VERDADERO;-31;;;
97785;97816;0;14948;VERDADERO;VERDADERO;-31;;;
97785;97816;0;14949;VERDADERO;VERDADERO;-31;;;
97817;97836;0;14950;VERDADERO;VERDADERO;-19;;;
97817;97836;0;14951;VERDADERO;VERDADERO;-19;;;
97817;97856;0;14952;VERDADERO;VERDADERO;-39;;;
97817;97856;0;14953;VERDADERO;VERDADERO;-39;;;
97817;97856;0;14954;VERDADERO;VERDADERO;-39;;;
97852;97856;0;14955;VERDADERO;VERDADERO;-4;;;
97852;97856;0;14956;VERDADERO;VERDADERO;-4;;;
97852;97856;0;14957;VERDADERO;VERDADERO;-4;;;
97852;97876;0;14958;VERDADERO;VERDADERO;-24;;;
97852;97876;0;14959;VERDADERO;VERDADERO;-24;;;
97884;97876;0;14960;VERDADERO;VERDADERO;8;;;
97884;97896;0;14961;VERDADERO;VERDADERO;-12;;;
97884;97896;0;14962;VERDADERO;VERDADERO;-12;;;
97884;97916;0;14963;VERDADERO;VERDADERO;-32;;;
97884;97916;0;14964;VERDADERO;VERDADERO;-32;;;
97917;97916;0;14965;VERDADERO;VERDADERO;1;;;
97917;97936;0;14966;VERDADERO;VERDADERO;-19;;;
97917;97936;0;14967;VERDADERO;VERDADERO;-19;;;
97917;97936;0;14968;VERDADERO;VERDADERO;-19;;;
97917;97956;0;14969;VERDADERO;VERDADERO;-39;;;
97917;97956;0;14970;VERDADERO;VERDADERO;-39;;;
97948;97956;0;14971;VERDADERO;VERDADERO;-8;;;
97948;97956;0;14972;VERDADERO;VERDADERO;-8;;;
97948;97956;0;14973;VERDADERO;VERDADERO;-8;;;
97948;97976;0;14974;VERDADERO;VERDADERO;-28;;;
97948;97976;0;14975;VERDADERO;VERDADERO;-28;;;
97982;97996;0;14976;VERDADERO;VERDADERO;-14;;;
97982;97996;0;14977;VERDADERO;VERDADERO;-14;;;
97982;97996;0;14978;VERDADERO;VERDADERO;-14;;;
97982;98016;0;14979;VERDADERO;VERDADERO;-34;;;
97982;98016;0;14980;VERDADERO;VERDADERO;-34;;;
98017;98016;0;14981;VERDADERO;VERDADERO;1;;;
98017;98036;1;14982;VERDADERO;VERDADERO;-19;;;
98017;98036;0;14983;VERDADERO;VERDADERO;-19;;;
98017;98056;0;14984;VERDADERO;VERDADERO;-39;;;
98017;98056;0;14985;VERDADERO;VERDADERO;-39;;;
98049;98056;0;14986;VERDADERO;VERDADERO;-7;;;
98049;98056;0;14987;VERDADERO;VERDADERO;-7;;;
98049;98056;0;14988;VERDADERO;VERDADERO;-7;;;
98049;98056;0;14989;VERDADERO;VERDADERO;-7;;;
98049;98076;0;14990;VERDADERO;VERDADERO;-27;;;
98049;98076;0;14991;VERDADERO;VERDADERO;-27;;;
98085;98076;0;14992;VERDADERO;VERDADERO;9;;;
98085;98096;1;14993;VERDADERO;VERDADERO;-11;;;
98085;98096;0;14994;VERDADERO;VERDADERO;-11;;;
98085;98116;0;14995;VERDADERO;VERDADERO;-31;;;
98085;98116;0;14996;VERDADERO;VERDADERO;-31;;;
98117;98116;0;14997;VERDADERO;VERDADERO;1;;;
98117;98116;0;14998;VERDADERO;VERDADERO;1;;;
98117;98136;0;14999;VERDADERO;VERDADERO;-19;;;
98117;98136;0;15000;VERDADERO;VERDADERO;-19;;;
98117;98136;0;15001;VERDADERO;VERDADERO;-19;;;
98117;98156;0;15002;VERDADERO;VERDADERO;-39;;;
98152;98156;0;15003;VERDADERO;VERDADERO;-4;;;
98152;98176;0;15004;VERDADERO;VERDADERO;-24;;;
98152;98176;0;15005;VERDADERO;VERDADERO;-24;;;
98152;98176;0;15006;VERDADERO;VERDADERO;-24;;;
98152;98196;0;15007;VERDADERO;VERDADERO;-44;;;
98152;98196;0;15008;VERDADERO;VERDADERO;-44;;;
98189;98216;0;15009;VERDADERO;VERDADERO;-27;;;
98189;98216;0;15010;VERDADERO;VERDADERO;-27;;;
98189;98216;0;15011;VERDADERO;VERDADERO;-27;;;
98189;98216;0;15012;VERDADERO;VERDADERO;-27;;;
98217;98216;0;15013;VERDADERO;VERDADERO;1;;;
98217;98216;0;15014;VERDADERO;VERDADERO;1;;;
98217;98216;0;15015;VERDADERO;VERDADERO;1;;;
98217;98236;0;15016;VERDADERO;VERDADERO;-19;;;
98217;98236;0;15017;VERDADERO;VERDADERO;-19;;;
98217;98256;0;15018;VERDADERO;VERDADERO;-39;;;
98253;98256;0;15019;VERDADERO;VERDADERO;-3;;;
98253;98256;0;15020;VERDADERO;VERDADERO;-3;;;
98253;98276;0;15021;VERDADERO;VERDADERO;-23;;;
98253;98276;0;15022;VERDADERO;VERDADERO;-23;;;
98253;98296;0;15023;VERDADERO;VERDADERO;-43;;;
98285;98296;0;15024;VERDADERO;VERDADERO;-11;;;
98285;98296;0;15025;VERDADERO;VERDADERO;-11;;;
98285;98316;0;15026;VERDADERO;VERDADERO;-31;;;
98285;98316;0;15027;VERDADERO;VERDADERO;-31;;;
98285;98336;0;15028;VERDADERO;FALSO;-51;;;
98320;98336;0;15029;VERDADERO;VERDADERO;-16;;;
98320;98336;0;15030;VERDADERO;VERDADERO;-16;;;
98320;98356;0;15031;VERDADERO;VERDADERO;-36;;;
98320;98356;0;15032;VERDADERO;VERDADERO;-36;;;
98320;98376;1;15033;VERDADERO;FALSO;-56;;;
98353;98376;0;15034;VERDADERO;VERDADERO;-23;;;
98353;98376;0;15035;VERDADERO;VERDADERO;-23;;;
98353;98376;0;15036;VERDADERO;VERDADERO;-23;;;
98353;98376;0;15037;VERDADERO;VERDADERO;-23;;;
98353;98376;0;15038;VERDADERO;VERDADERO;-23;;;
98353;98396;0;15039;VERDADERO;VERDADERO;-43;;;
98389;98396;0;15040;VERDADERO;VERDADERO;-7;;;
98389;98416;0;15041;VERDADERO;VERDADERO;-27;;;
98389;98416;0;15042;VERDADERO;VERDADERO;-27;;;
98389;98416;0;15043;VERDADERO;VERDADERO;-27;;;
98389;98416;0;15044;VERDADERO;VERDADERO;-27;;;
98420;98416;0;15045;VERDADERO;VERDADERO;4;;;
98420;98416;0;15046;VERDADERO;VERDADERO;4;;;
98420;98436;0;15047;VERDADERO;VERDADERO;-16;;;
98420;98436;0;15048;VERDADERO;VERDADERO;-16;;;
98420;98457;0;15049;VERDADERO;VERDADERO;-37;;;
98453;98457;0;15050;VERDADERO;VERDADERO;-4;;;
98453;98457;0;15051;VERDADERO;VERDADERO;-4;;;
98453;98477;0;15052;VERDADERO;VERDADERO;-24;;;
98453;98477;0;15053;VERDADERO;VERDADERO;-24;;;
98453;98497;1;15054;VERDADERO;VERDADERO;-44;;;
98485;98497;0;15055;VERDADERO;VERDADERO;-12;;;
98485;98497;0;15056;VERDADERO;VERDADERO;-12;;;
98485;98517;0;15057;VERDADERO;VERDADERO;-32;;;
98485;98517;0;15058;VERDADERO;VERDADERO;-32;;;
98485;98517;0;15059;VERDADERO;VERDADERO;-32;;;
98516;98517;0;15060;VERDADERO;VERDADERO;-1;;;
98516;98517;0;15061;VERDADERO;VERDADERO;-1;;;
98516;98537;0;15062;VERDADERO;VERDADERO;-21;;;
98516;98537;0;15063;VERDADERO;VERDADERO;-21;;;
98516;98557;0;15064;VERDADERO;VERDADERO;-41;;;
98516;98557;0;15065;VERDADERO;VERDADERO;-41;;;
98553;98557;0;15066;VERDADERO;VERDADERO;-4;;;
98553;98577;0;15067;VERDADERO;VERDADERO;-24;;;
98553;98577;0;15068;VERDADERO;VERDADERO;-24;;;
98553;98597;1;15069;VERDADERO;VERDADERO;-44;;;
98553;98597;0;15070;VERDADERO;VERDADERO;-44;;;
98585;98617;0;15071;VERDADERO;VERDADERO;-32;;;
98585;98617;0;15072;VERDADERO;VERDADERO;-32;;;
98585;98617;0;15073;VERDADERO;VERDADERO;-32;;;
98585;98617;0;15074;VERDADERO;VERDADERO;-32;;;
98585;98617;0;15075;VERDADERO;VERDADERO;-32;;;
98617;98637;0;15076;VERDADERO;VERDADERO;-20;;;
98617;98637;0;15077;VERDADERO;VERDADERO;-20;;;
98617;98637;0;15078;VERDADERO;VERDADERO;-20;;;
98617;98657;0;15079;VERDADERO;VERDADERO;-40;;;
98617;98657;0;15080;VERDADERO;VERDADERO;-40;;;
98617;98657;0;15081;VERDADERO;VERDADERO;-40;;;
98658;98657;0;15082;VERDADERO;VERDADERO;1;;;
98658;98657;0;15083;VERDADERO;VERDADERO;1;;;
98658;98677;0;15084;VERDADERO;VERDADERO;-19;;;
98658;98677;0;15085;VERDADERO;VERDADERO;-19;;;
98684;98697;0;15086;VERDADERO;VERDADERO;-13;;;
98684;98697;0;15087;VERDADERO;VERDADERO;-13;;;
98684;98697;0;15088;VERDADERO;VERDADERO;-13;;;
98684;98717;1;15089;VERDADERO;VERDADERO;-33;;;
98684;98717;0;15090;VERDADERO;VERDADERO;-33;;;
98684;98717;0;15091;VERDADERO;VERDADERO;-33;;;
98717;98737;0;15092;VERDADERO;VERDADERO;-20;;;
98717;98737;0;15093;VERDADERO;VERDADERO;-20;;;
98717;98737;0;15094;VERDADERO;VERDADERO;-20;;;
98717;98757;0;15095;VERDADERO;VERDADERO;-40;;;
98717;98757;0;15096;VERDADERO;VERDADERO;-40;;;
98752;98757;0;15097;VERDADERO;VERDADERO;-5;;;
98752;98757;0;15098;VERDADERO;VERDADERO;-5;;;
98752;98757;0;15099;VERDADERO;VERDADERO;-5;;;
98752;98777;0;15100;VERDADERO;VERDADERO;-25;;;
98752;98777;0;15101;VERDADERO;VERDADERO;-25;;;
98752;98797;0;15102;VERDADERO;VERDADERO;-45;;;
98789;98797;0;15103;VERDADERO;VERDADERO;-8;;;
98789;98797;0;15104;VERDADERO;VERDADERO;-8;;;
98789;98817;0;15105;VERDADERO;VERDADERO;-28;;;
98789;98817;0;15106;VERDADERO;VERDADERO;-28;;;
98789;98837;0;15107;VERDADERO;VERDADERO;-48;;;
98821;98837;0;15108;VERDADERO;VERDADERO;-16;;;
98821;98837;0;15109;VERDADERO;VERDADERO;-16;;;
98821;98857;0;15110;VERDADERO;VERDADERO;-36;;;
98821;98857;0;15111;VERDADERO;VERDADERO;-36;;;
98821;98857;0;15112;VERDADERO;VERDADERO;-36;;;
98853;98857;0;15113;VERDADERO;VERDADERO;-4;;;
98853;98857;0;15114;VERDADERO;VERDADERO;-4;;;
98853;98877;0;15115;VERDADERO;VERDADERO;-24;;;
98853;98877;0;15116;VERDADERO;VERDADERO;-24;;;
98853;98897;0;15117;VERDADERO;VERDADERO;-44;;;
98888;98897;0;15118;VERDADERO;VERDADERO;-9;;;
98888;98897;0;15119;VERDADERO;VERDADERO;-9;;;
98888;98917;0;15120;VERDADERO;VERDADERO;-29;;;
98888;98917;0;15121;VERDADERO;VERDADERO;-29;;;
98888;98937;0;15122;VERDADERO;VERDADERO;-49;;;
98888;98937;0;15123;VERDADERO;VERDADERO;-49;;;
98924;98957;0;15124;VERDADERO;VERDADERO;-33;;;
98924;98957;0;15125;VERDADERO;VERDADERO;-33;;;
98924;98957;0;15126;VERDADERO;VERDADERO;-33;;;
98924;98957;0;15127;VERDADERO;VERDADERO;-33;;;
98924;98977;0;15128;VERDADERO;FALSO;-53;;;
98957;98977;0;15129;VERDADERO;VERDADERO;-20;;;
98957;98977;0;15130;VERDADERO;VERDADERO;-20;;;
98957;98997;0;15131;VERDADERO;VERDADERO;-40;;;
98957;98997;0;15132;VERDADERO;VERDADERO;-40;;;
98957;98997;0;15133;VERDADERO;VERDADERO;-40;;;
98988;98997;0;15134;VERDADERO;VERDADERO;-9;;;
98988;98997;0;15135;VERDADERO;VERDADERO;-9;;;
98988;99017;0;15136;VERDADERO;VERDADERO;-29;;;
98988;99017;0;15137;VERDADERO;VERDADERO;-29;;;
98988;99037;0;15138;VERDADERO;VERDADERO;-49;;;
98988;99037;0;15139;VERDADERO;VERDADERO;-49;;;
99025;99037;0;15140;VERDADERO;VERDADERO;-12;;;
99025;99037;0;15141;VERDADERO;VERDADERO;-12;;;
99025;99037;0;15142;VERDADERO;VERDADERO;-12;;;
99025;99057;0;15143;VERDADERO;VERDADERO;-32;;;
99025;99057;0;15144;VERDADERO;VERDADERO;-32;;;
99057;99057;0;15145;VERDADERO;VERDADERO;0;;;
99057;99077;0;15146;VERDADERO;VERDADERO;-20;;;
99057;99077;0;15147;VERDADERO;VERDADERO;-20;;;
99057;99097;0;15148;VERDADERO;VERDADERO;-40;;;
99057;99097;0;15149;VERDADERO;VERDADERO;-40;;;
99057;99097;0;15150;VERDADERO;VERDADERO;-40;;;
99093;99097;0;15151;VERDADERO;VERDADERO;-4;;;
99093;99117;0;15152;VERDADERO;VERDADERO;-24;;;
99093;99117;0;15153;VERDADERO;VERDADERO;-24;;;
99093;99137;1;15154;VERDADERO;VERDADERO;-44;;;
99093;99137;0;15155;VERDADERO;VERDADERO;-44;;;
99125;99157;1;15156;VERDADERO;VERDADERO;-32;;;
99156;99177;1;15157;VERDADERO;VERDADERO;-21;;;
99188;99197;0;15158;VERDADERO;VERDADERO;-9;;;
99220;99237;1;15159;VERDADERO;VERDADERO;-17;;;
99257;99257;1;15160;VERDADERO;VERDADERO;0;;;
99289;99297;0;15161;VERDADERO;VERDADERO;-8;;;
99320;99337;0;15162;VERDADERO;VERDADERO;-17;;;
99353;99357;0;15163;VERDADERO;VERDADERO;-4;;;
99385;99397;0;15164;VERDADERO;VERDADERO;-12;;;
99421;99437;1;15165;VERDADERO;VERDADERO;-16;;;
99453;99457;0;15166;VERDADERO;VERDADERO;-4;;;
99485;99497;0;15167;VERDADERO;VERDADERO;-12;;;
99521;99537;0;15168;VERDADERO;VERDADERO;-16;;;
99553;99557;1;15169;VERDADERO;VERDADERO;-4;;;
99585;99597;1;15170;VERDADERO;VERDADERO;-12;;;
99617;99617;1;15171;VERDADERO;VERDADERO;0;;;
99648;99657;0;15172;VERDADERO;VERDADERO;-9;;;
99681;99697;0;15173;VERDADERO;VERDADERO;-16;;;
99713;99717;1;15174;VERDADERO;VERDADERO;-4;;;
99749;99757;0;15175;VERDADERO;VERDADERO;-8;;;
99781;99797;0;15176;VERDADERO;VERDADERO;-16;;;
99813;99817;0;15177;VERDADERO;VERDADERO;-4;;;
99849;99857;1;15178;VERDADERO;VERDADERO;-8;;;
99880;99897;1;15179;VERDADERO;VERDADERO;-17;;;
99912;99917;1;15180;VERDADERO;VERDADERO;-5;;;
99948;99957;0;15181;VERDADERO;VERDADERO;-9;;;
99985;99997;1;15182;VERDADERO;VERDADERO;-12;;;
100016;100017;1;15183;VERDADERO;VERDADERO;-1;;;
100049;100057;1;15184;VERDADERO;VERDADERO;-8;;;
100085;100097;0;15185;VERDADERO;VERDADERO;-12;;;
100116;100117;0;15186;VERDADERO;VERDADERO;-1;;;
100152;100157;0;15187;VERDADERO;VERDADERO;-5;;;
100185;100197;1;15188;VERDADERO;VERDADERO;-12;;;
100221;100237;1;15189;VERDADERO;VERDADERO;-16;;;
100253;100257;1;15190;VERDADERO;VERDADERO;-4;;;
100285;100297;0;15191;VERDADERO;VERDADERO;-12;;;
100321;100337;0;15192;VERDADERO;VERDADERO;-16;;;
100353;100357;1;15193;VERDADERO;VERDADERO;-4;;;
100384;100397;1;15194;VERDADERO;VERDADERO;-13;;;
100417;100437;0;15195;VERDADERO;VERDADERO;-20;;;
100449;100457;1;15196;VERDADERO;VERDADERO;-8;;;
100485;100497;1;15197;VERDADERO;VERDADERO;-12;;;
100517;100517;1;15198;VERDADERO;VERDADERO;0;;;
100517;100537;0;15199;VERDADERO;VERDADERO;-20;;;
100549;100557;1;15200;VERDADERO;VERDADERO;-8;;;
100549;100557;0;15201;VERDADERO;VERDADERO;-8;;;
100549;100557;0;15202;VERDADERO;VERDADERO;-8;;;
100549;100557;0;15203;VERDADERO;VERDADERO;-8;;;
100549;100557;0;15204;VERDADERO;VERDADERO;-8;;;
100549;100557;0;15205;VERDADERO;VERDADERO;-8;;;
100585;100577;1;15206;VERDADERO;VERDADERO;8;;;
100585;100577;0;15207;VERDADERO;VERDADERO;8;;;
100585;100597;0;15208;VERDADERO;VERDADERO;-12;;;
100585;100597;0;15209;VERDADERO;VERDADERO;-12;;;
100585;100597;0;15210;VERDADERO;VERDADERO;-12;;;
100617;100617;0;15211;VERDADERO;VERDADERO;0;;;
100617;100617;0;15212;VERDADERO;VERDADERO;0;;;
100617;100637;0;15213;VERDADERO;VERDADERO;-20;;;
100617;100637;0;15214;VERDADERO;VERDADERO;-20;;;
100617;100637;0;15215;VERDADERO;VERDADERO;-20;;;
100649;100657;1;15216;VERDADERO;VERDADERO;-8;;;
100649;100657;0;15217;VERDADERO;VERDADERO;-8;;;
100649;100677;0;15218;VERDADERO;VERDADERO;-28;;;
100649;100677;0;15219;VERDADERO;VERDADERO;-28;;;
100649;100677;0;15220;VERDADERO;VERDADERO;-28;;;
100681;100677;0;15221;VERDADERO;VERDADERO;4;;;
100681;100697;0;15222;VERDADERO;VERDADERO;-16;;;
100681;100697;0;15223;VERDADERO;VERDADERO;-16;;;
100681;100717;1;15224;VERDADERO;VERDADERO;-36;;;
100681;100717;0;15225;VERDADERO;VERDADERO;-36;;;
100714;100717;0;15226;VERDADERO;VERDADERO;-3;;;
100714;100737;0;15227;VERDADERO;VERDADERO;-23;;;
100714;100737;0;15228;VERDADERO;VERDADERO;-23;;;
100714;100757;1;15229;VERDADERO;VERDADERO;-43;;;
100714;100757;0;15230;VERDADERO;VERDADERO;-43;;;
100749;100757;0;15231;VERDADERO;VERDADERO;-8;;;
100749;100777;1;15232;VERDADERO;VERDADERO;-28;;;
100749;100777;0;15233;VERDADERO;VERDADERO;-28;;;
100749;100777;0;15234;VERDADERO;VERDADERO;-28;;;
100749;100777;0;15235;VERDADERO;VERDADERO;-28;;;
100780;100777;0;15236;VERDADERO;VERDADERO;3;;;
100780;100797;0;15237;VERDADERO;VERDADERO;-17;;;
100780;100797;0;15238;VERDADERO;VERDADERO;-17;;;
100780;100797;0;15239;VERDADERO;VERDADERO;-17;;;
100780;100817;1;15240;VERDADERO;VERDADERO;-37;;;
100780;100817;0;15241;VERDADERO;VERDADERO;-37;;;
100817;100837;0;15242;VERDADERO;VERDADERO;-20;;;
100817;100837;0;15243;VERDADERO;VERDADERO;-20;;;
100817;100837;0;15244;VERDADERO;VERDADERO;-20;;;
100817;100857;0;15245;VERDADERO;VERDADERO;-40;;;
100817;100857;0;15246;VERDADERO;VERDADERO;-40;;;
100849;100877;0;15247;VERDADERO;VERDADERO;-28;;;
100849;100877;0;15248;VERDADERO;VERDADERO;-28;;;
100849;100877;0;15249;VERDADERO;VERDADERO;-28;;;
100849;100877;0;15250;VERDADERO;VERDADERO;-28;;;
100849;100877;0;15251;VERDADERO;VERDADERO;-28;;;
100849;100877;0;15252;VERDADERO;VERDADERO;-28;;;
100885;100897;1;15253;VERDADERO;VERDADERO;-12;;;
100885;100897;0;15254;VERDADERO;VERDADERO;-12;;;
100885;100917;0;15255;VERDADERO;VERDADERO;-32;;;
100885;100917;0;15256;VERDADERO;VERDADERO;-32;;;
100885;100917;0;15257;VERDADERO;VERDADERO;-32;;;
100917;100917;0;15258;VERDADERO;VERDADERO;0;;;
100917;100917;0;15259;VERDADERO;VERDADERO;0;;;
100917;100917;0;15260;VERDADERO;VERDADERO;0;;;
100917;100917;0;15261;VERDADERO;VERDADERO;0;;;
100917;100937;0;15262;VERDADERO;VERDADERO;-20;;;
100917;100937;0;15263;VERDADERO;VERDADERO;-20;;;
100953;100958;1;15264;VERDADERO;VERDADERO;-5;;;
100953;100958;0;15265;VERDADERO;VERDADERO;-5;;;
100953;100958;0;15266;VERDADERO;VERDADERO;-5;;;
100953;100978;0;15267;VERDADERO;VERDADERO;-25;;;
100953;100978;0;15268;VERDADERO;VERDADERO;-25;;;
100989;100978;0;15269;VERDADERO;VERDADERO;11;;;
100989;100998;0;15270;VERDADERO;VERDADERO;-9;;;
100989;100998;0;15271;VERDADERO;VERDADERO;-9;;;
100989;100998;0;15272;VERDADERO;VERDADERO;-9;;;
100989;101018;0;15273;VERDADERO;VERDADERO;-29;;;
101021;101018;0;15274;VERDADERO;VERDADERO;3;;;
101021;101038;0;15275;VERDADERO;VERDADERO;-17;;;
101021;101038;0;15276;VERDADERO;VERDADERO;-17;;;
101021;101038;0;15277;VERDADERO;VERDADERO;-17;;;
101021;101038;0;15278;VERDADERO;VERDADERO;-17;;;
101053;101038;0;15279;VERDADERO;VERDADERO;15;;;
101053;101038;0;15280;VERDADERO;VERDADERO;15;;;
101053;101058;0;15281;VERDADERO;VERDADERO;-5;;;
101053;101058;0;15282;VERDADERO;VERDADERO;-5;;;
101053;101078;0;15283;VERDADERO;VERDADERO;-25;;;
101053;101078;0;15284;VERDADERO;VERDADERO;-25;;;
101089;101078;0;15285;VERDADERO;VERDADERO;11;;;
101089;101098;0;15286;VERDADERO;VERDADERO;-9;;;
101089;101098;0;15287;VERDADERO;VERDADERO;-9;;;
101089;101118;1;15288;VERDADERO;VERDADERO;-29;;;
101089;101118;0;15289;VERDADERO;VERDADERO;-29;;;
101121;101118;0;15290;VERDADERO;VERDADERO;3;;;
101121;101138;0;15291;VERDADERO;VERDADERO;-17;;;
101121;101138;0;15292;VERDADERO;VERDADERO;-17;;;
101121;101158;0;15293;VERDADERO;VERDADERO;-37;;;
101121;101158;0;15294;VERDADERO;VERDADERO;-37;;;
101153;101158;0;15295;VERDADERO;VERDADERO;-5;;;
101153;101178;0;15296;VERDADERO;VERDADERO;-25;;;
101153;101178;0;15297;VERDADERO;VERDADERO;-25;;;
101153;101198;0;15298;VERDADERO;VERDADERO;-45;;;
101153;101198;0;15299;VERDADERO;VERDADERO;-45;;;
101153;101198;0;15300;VERDADERO;VERDADERO;-45;;;
101188;101198;0;15301;VERDADERO;VERDADERO;-10;;;
101188;101218;0;15302;VERDADERO;VERDADERO;-30;;;
101188;101218;0;15303;VERDADERO;VERDADERO;-30;;;
101188;101218;0;15304;VERDADERO;VERDADERO;-30;;;
101188;101238;0;15305;VERDADERO;FALSO;-50;;;
101221;101238;0;15306;VERDADERO;VERDADERO;-17;;;
101221;101238;0;15307;VERDADERO;VERDADERO;-17;;;
101221;101238;0,00E+00;15308;VERDADERO;VERDADERO;-17;;;
101221;101238;0;15309;VERDADERO;VERDADERO;-17;;;
101221;101238;0;15310;VERDADERO;VERDADERO;-17;;;
101253;101238;0;15311;VERDADERO;VERDADERO;15;;;
101253;101258;0;15312;VERDADERO;VERDADERO;-5;;;
101253;101258;0;15313;VERDADERO;VERDADERO;-5;;;
101253;101278;0;15314;VERDADERO;VERDADERO;-25;;;
101253;101278;0;15315;VERDADERO;VERDADERO;-25;;;
101253;101278;0;15316;VERDADERO;VERDADERO;-25;;;
101289;101298;0;15317;VERDADERO;VERDADERO;-9;;;
101289;101298;0;15318;VERDADERO;VERDADERO;-9;;;
101289;101318;0;15319;VERDADERO;VERDADERO;-29;;;
101289;101318;0;15320;VERDADERO;VERDADERO;-29;;;
101320;101338;0;15321;VERDADERO;VERDADERO;-18;;;
101320;101338;0;15322;VERDADERO;VERDADERO;-18;;;
101320;101338;0;15323;VERDADERO;VERDADERO;-18;;;
101320;101358;1;15324;VERDADERO;VERDADERO;-38;;;
101320;101358;0;15325;VERDADERO;VERDADERO;-38;;;
101353;101378;0;15326;VERDADERO;VERDADERO;-25;;;
101353;101378;0;15327;VERDADERO;VERDADERO;-25;;;
101353;101378;0;15328;VERDADERO;VERDADERO;-25;;;
101353;101398;0;15329;VERDADERO;VERDADERO;-45;;;
101353;101398;0;15330;VERDADERO;VERDADERO;-45;;;
101353;101398;0;15331;VERDADERO;VERDADERO;-45;;;
101389;101398;0;15332;VERDADERO;VERDADERO;-9;;;
101389;101398;0;15333;VERDADERO;VERDADERO;-9;;;
101389;101418;0;15334;VERDADERO;VERDADERO;-29;;;
101389;101418;0;15335;VERDADERO;VERDADERO;-29;;;
101389;101438;0;15336;VERDADERO;VERDADERO;-49;;;
101421;101438;0;15337;VERDADERO;VERDADERO;-17;;;
101421;101438;0;15338;VERDADERO;VERDADERO;-17;;;
101421;101438;0;15339;VERDADERO;VERDADERO;-17;;;
101421;101438;0;15340;VERDADERO;VERDADERO;-17;;;
101421;101438;0;15341;VERDADERO;VERDADERO;-17;;;
101453;101458;0;15342;VERDADERO;VERDADERO;-5;;;
101453;101458;0;15343;VERDADERO;VERDADERO;-5;;;
101453;101478;0;15344;VERDADERO;VERDADERO;-25;;;
101453;101478;0;15345;VERDADERO;VERDADERO;-25;;;
101453;101478;0;15346;VERDADERO;VERDADERO;-25;;;
101453;101498;0;15347;VERDADERO;VERDADERO;-45;;;
101488;101498;0;15348;VERDADERO;VERDADERO;-10;;;
101488;101498;0;15349;VERDADERO;VERDADERO;-10;;;
101488;101518;0;15350;VERDADERO;VERDADERO;-30;;;
101488;101518;0;15351;VERDADERO;VERDADERO;-30;;;
101488;101518;0;15352;VERDADERO;VERDADERO;-30;;;
101521;101538;1;15353;VERDADERO;VERDADERO;-17;;;
101521;101538;0;15354;VERDADERO;VERDADERO;-17;;;
101521;101538;0;15355;VERDADERO;VERDADERO;-17;;;
101521;101538;0;15356;VERDADERO;VERDADERO;-17;;;
101521;101538;0;15357;VERDADERO;VERDADERO;-17;;;
101553;101558;0;15358;VERDADERO;VERDADERO;-5;;;
101553;101558;0;15359;VERDADERO;VERDADERO;-5;;;
101553;101558;0;15360;VERDADERO;VERDADERO;-5;;;
101553;101578;0;15361;VERDADERO;VERDADERO;-25;;;
101553;101578;0;15362;VERDADERO;VERDADERO;-25;;;
101553;101598;0;15363;VERDADERO;VERDADERO;-45;;;
101588;101598;0;15364;VERDADERO;VERDADERO;-10;;;
101588;101598;0;15365;VERDADERO;VERDADERO;-10;;;
101588;101618;0;15366;VERDADERO;VERDADERO;-30;;;
101588;101618;0;15367;VERDADERO;VERDADERO;-30;;;
101588;101638;0;15368;VERDADERO;FALSO;-50;;;
101621;101638;0;15369;VERDADERO;VERDADERO;-17;;;
101621;101638;0;15370;VERDADERO;VERDADERO;-17;;;
101621;101638;0;15371;VERDADERO;VERDADERO;-17;;;
101621;101638;0;15372;VERDADERO;VERDADERO;-17;;;
101621;101658;0;15373;VERDADERO;VERDADERO;-37;;;
101653;101658;0;15374;VERDADERO;VERDADERO;-5;;;
101653;101658;0;15375;VERDADERO;VERDADERO;-5;;;
101653;101678;0;15376;VERDADERO;VERDADERO;-25;;;
101653;101678;0;15377;VERDADERO;VERDADERO;-25;;;
101653;101698;0;15378;VERDADERO;VERDADERO;-45;;;
101685;101698;0;15379;VERDADERO;VERDADERO;-13;;;
101685;101698;0;15380;VERDADERO;VERDADERO;-13;;;
101685;101698;0;15381;VERDADERO;VERDADERO;-13;;;
101685;101698;0;15382;VERDADERO;VERDADERO;-13;;;
101685;101718;0;15383;VERDADERO;VERDADERO;-33;;;
101716;101718;0;15384;VERDADERO;VERDADERO;-2;;;
101716;101718;0;15385;VERDADERO;VERDADERO;-2;;;
101716;101738;0;15386;VERDADERO;VERDADERO;-22;;;
101716;101738;0;15387;VERDADERO;VERDADERO;-22;;;
101716;101738;0;15388;VERDADERO;VERDADERO;-22;;;
101716;101738;0;15389;VERDADERO;VERDADERO;-22;;;
101753;101738;0;15390;VERDADERO;VERDADERO;15;;;
101753;101758;0;15391;VERDADERO;VERDADERO;-5;;;
101753;101758;0;15392;VERDADERO;VERDADERO;-5;;;
101753;101778;0;15393;VERDADERO;VERDADERO;-25;;;
101753;101778;0;15394;VERDADERO;VERDADERO;-25;;;
101784;101778;0;15395;VERDADERO;VERDADERO;6;;;
101784;101798;0;15396;VERDADERO;VERDADERO;-14;;;
101784;101798;0;15397;VERDADERO;VERDADERO;-14;;;
101784;101798;0;15398;VERDADERO;VERDADERO;-14;;;
101784;101818;0;15399;VERDADERO;VERDADERO;-34;;;
101817;101818;0;15400;VERDADERO;VERDADERO;-1;;;
101817;101838;0;15401;VERDADERO;VERDADERO;-21;;;
101817;101838;0;15402;VERDADERO;VERDADERO;-21;;;
101817;101838;0;15403;VERDADERO;VERDADERO;-21;;;
101817;101858;0;15404;VERDADERO;VERDADERO;-41;;;
101853;101858;0;15405;VERDADERO;VERDADERO;-5;;;
101853;101878;0;15406;VERDADERO;VERDADERO;-25;;;
101853;101878;0;15407;VERDADERO;VERDADERO;-25;;;
101853;101898;0;15408;VERDADERO;VERDADERO;-45;;;
101853;101898;0;15409;VERDADERO;VERDADERO;-45;;;
101884;101898;0;15410;VERDADERO;VERDADERO;-14;;;
101884;101898;0;15411;VERDADERO;VERDADERO;-14;;;
101884;101898;0;15412;VERDADERO;VERDADERO;-14;;;
101884;101898;0;15413;VERDADERO;VERDADERO;-14;;;
101884;101898;0;15414;VERDADERO;VERDADERO;-14;;;
101917;101898;0;15415;VERDADERO;VERDADERO;19;;;
101917;101898;0;15416;VERDADERO;VERDADERO;19;;;
101917;101918;0;15417;VERDADERO;VERDADERO;-1;;;
101917;101918;0;15418;VERDADERO;VERDADERO;-1;;;
101917;101918;0;15419;VERDADERO;VERDADERO;-1;;;
101917;101938;1;15420;VERDADERO;VERDADERO;-21;;;
101953;101938;0;15421;VERDADERO;VERDADERO;15;;;
101953;101958;0;15422;VERDADERO;VERDADERO;-5;;;
101953;101958;0;15423;VERDADERO;VERDADERO;-5;;;
101953;101958;0;15424;VERDADERO;VERDADERO;-5;;;
101953;101978;0;15425;VERDADERO;VERDADERO;-25;;;
101984;101978;0;15426;VERDADERO;VERDADERO;6;;;
101984;101998;0;15427;VERDADERO;VERDADERO;-14;;;
101984;101998;0;15428;VERDADERO;VERDADERO;-14;;;
101984;101998;0;15429;VERDADERO;VERDADERO;-14;;;
102017;102018;0;15430;VERDADERO;VERDADERO;-1;;;
102017;102018;0;15431;VERDADERO;VERDADERO;-1;;;
102017;102038;0;15432;VERDADERO;VERDADERO;-21;;;
102017;102038;0;15433;VERDADERO;VERDADERO;-21;;;
102017;102038;0;15434;VERDADERO;VERDADERO;-21;;;
102017;102058;0;15435;VERDADERO;VERDADERO;-41;;;
102049;102058;0;15436;VERDADERO;VERDADERO;-9;;;
102049;102058;0;15437;VERDADERO;VERDADERO;-9;;;
102049;102058;0;15438;VERDADERO;VERDADERO;-9;;;
102049;102078;1;15439;VERDADERO;VERDADERO;-29;;;
102049;102078;0;15440;VERDADERO;VERDADERO;-29;;;
102081;102099;0;15441;VERDADERO;VERDADERO;-18;;;
102081;102099;0;15442;VERDADERO;VERDADERO;-18;;;
102081;102099;0;15443;VERDADERO;VERDADERO;-18;;;
102081;102119;0;15444;VERDADERO;VERDADERO;-38;;;
102081;102119;0;15445;VERDADERO;VERDADERO;-38;;;
102117;102139;0;15446;VERDADERO;VERDADERO;-22;;;
102117;102139;0;15447;VERDADERO;VERDADERO;-22;;;
102117;102159;0;15448;VERDADERO;VERDADERO;-42;;;
102117;102159;0;15449;VERDADERO;VERDADERO;-42;;;
102117;102159;0;15450;VERDADERO;VERDADERO;-42;;;
102149;102159;0;15451;VERDADERO;VERDADERO;-10;;;
102149;102179;0;15452;VERDADERO;VERDADERO;-30;;;
102149;102179;0;15453;VERDADERO;VERDADERO;-30;;;
102149;102199;0;15454;VERDADERO;FALSO;-50;;;
102149;102199;0;15455;VERDADERO;FALSO;-50;;;
102181;102199;0;15456;VERDADERO;VERDADERO;-18;;;
102181;102199;0;15457;VERDADERO;VERDADERO;-18;;;
102181;102199;0;15458;VERDADERO;VERDADERO;-18;;;
102181;102219;0;15459;VERDADERO;VERDADERO;-38;;;
102181;102219;0;15460;VERDADERO;VERDADERO;-38;;;
102181;102219;0;15461;VERDADERO;VERDADERO;-38;;;
102216;102239;0;15462;VERDADERO;VERDADERO;-23;;;
102216;102239;0;15463;VERDADERO;VERDADERO;-23;;;
102216;102239;0;15464;VERDADERO;VERDADERO;-23;;;
102216;102239;0;15465;VERDADERO;VERDADERO;-23;;;
102216;102259;0;15466;VERDADERO;VERDADERO;-43;;;
102249;102259;0;15467;VERDADERO;VERDADERO;-10;;;
102249;102259;0;15468;VERDADERO;VERDADERO;-10;;;
102249;102279;0;15469;VERDADERO;VERDADERO;-30;;;
102249;102279;0;15470;VERDADERO;VERDADERO;-30;;;
102249;102299;1;15471;VERDADERO;FALSO;-50;;;
102281;102299;0;15472;VERDADERO;VERDADERO;-18;;;
102281;102299;0;15473;VERDADERO;VERDADERO;-18;;;
102281;102319;0;15474;VERDADERO;VERDADERO;-38;;;
102281;102319;0;15475;VERDADERO;VERDADERO;-38;;;
102281;102339;0;15476;VERDADERO;FALSO;-58;;;
102312;102339;0;15477;VERDADERO;VERDADERO;-27;;;
102312;102339;0;15478;VERDADERO;VERDADERO;-27;;;
102312;102339;0;15479;VERDADERO;VERDADERO;-27;;;
102312;102359;1;15480;VERDADERO;VERDADERO;-47;;;
102312;102359;0;15481;VERDADERO;VERDADERO;-47;;;
102345;102379;0;15482;VERDADERO;VERDADERO;-34;;;
102345;102379;0;15483;VERDADERO;VERDADERO;-34;;;
102345;102379;0;15484;VERDADERO;VERDADERO;-34;;;
102345;102379;0;15485;VERDADERO;VERDADERO;-34;;;
102345;102379;0;15486;VERDADERO;VERDADERO;-34;;;
102345;102379;0;15487;VERDADERO;VERDADERO;-34;;;
102381;102399;0;15488;VERDADERO;VERDADERO;-18;;;
102381;102399;0;15489;VERDADERO;VERDADERO;-18;;;
102381;102399;0;15490;VERDADERO;VERDADERO;-18;;;
102381;102419;0;15491;VERDADERO;VERDADERO;-38;;;
102381;102419;0;15492;VERDADERO;VERDADERO;-38;;;
102413;102419;0;15493;VERDADERO;VERDADERO;-6;;;
102413;102419;0;15494;VERDADERO;VERDADERO;-6;;;
102413;102439;0;15495;VERDADERO;VERDADERO;-26;;;
102413;102439;0;15496;VERDADERO;VERDADERO;-26;;;
102413;102439;0;15497;VERDADERO;VERDADERO;-26;;;
102413;102459;0;15498;VERDADERO;VERDADERO;-46;;;
102448;102459;0;15499;VERDADERO;VERDADERO;-11;;;
102448;102479;0;15500;VERDADERO;VERDADERO;-31;;;
102448;102479;0;15501;VERDADERO;VERDADERO;-31;;;
102448;102479;0;15502;VERDADERO;VERDADERO;-31;;;
102448;102499;0;15503;VERDADERO;FALSO;-51;;;
102481;102499;0;15504;VERDADERO;VERDADERO;-18;;;
102481;102519;0;15505;VERDADERO;VERDADERO;-38;;;
102481;102519;0;15506;VERDADERO;VERDADERO;-38;;;
102481;102519;0;15507;VERDADERO;VERDADERO;-38;;;
102481;102519;0;15508;VERDADERO;VERDADERO;-38;;;
102516;102519;0;15509;VERDADERO;VERDADERO;-3;;;
102516;102519;0;15510;VERDADERO;VERDADERO;-3;;;
102516;102539;1;15511;VERDADERO;VERDADERO;-23;;;
102516;102539;0;15512;VERDADERO;VERDADERO;-23;;;
102516;102539;0;15513;VERDADERO;VERDADERO;-23;;;
102516;102559;0;15514;VERDADERO;VERDADERO;-43;;;
102549;102559;0;15515;VERDADERO;VERDADERO;-10;;;
102549;102579;0;15516;VERDADERO;VERDADERO;-30;;;
102549;102579;0;15517;VERDADERO;VERDADERO;-30;;;
102549;102579;0;15518;VERDADERO;VERDADERO;-30;;;
102549;102579;0;15519;VERDADERO;VERDADERO;-30;;;
102549;102599;0;15520;VERDADERO;FALSO;-50;;;
102585;102599;0;15521;VERDADERO;VERDADERO;-14;;;
102585;102619;0;15522;VERDADERO;VERDADERO;-34;;;
102585;102619;0;15523;VERDADERO;VERDADERO;-34;;;
102585;102619;0;15524;VERDADERO;VERDADERO;-34;;;
102617;102619;0;15525;VERDADERO;VERDADERO;-2;;;
102617;102619;0;15526;VERDADERO;VERDADERO;-2;;;
102617;102639;0;15527;VERDADERO;VERDADERO;-22;;;
102617;102639;0;15528;VERDADERO;VERDADERO;-22;;;
102617;102639;0;15529;VERDADERO;VERDADERO;-22;;;
102617;102659;0;15530;VERDADERO;VERDADERO;-42;;;
102648;102659;0;15531;VERDADERO;VERDADERO;-11;;;
102648;102679;0;15532;VERDADERO;VERDADERO;-31;;;
102648;102679;0;15533;VERDADERO;VERDADERO;-31;;;
102648;102679;0;15534;VERDADERO;VERDADERO;-31;;;
102648;102679;0;15535;VERDADERO;VERDADERO;-31;;;
102685;102699;0;15536;VERDADERO;VERDADERO;-14;;;
102685;102699;0;15537;VERDADERO;VERDADERO;-14;;;
102685;102719;0;15538;VERDADERO;VERDADERO;-34;;;
102685;102719;0;15539;VERDADERO;VERDADERO;-34;;;
102685;102719;0;15540;VERDADERO;VERDADERO;-34;;;
102717;102719;0;15541;VERDADERO;VERDADERO;-2;;;
102717;102719;0;15542;VERDADERO;VERDADERO;-2;;;
102717;102719;0;15543;VERDADERO;VERDADERO;-2;;;
102717;102739;0;15544;VERDADERO;VERDADERO;-22;;;
102717;102739;0;15545;VERDADERO;VERDADERO;-22;;;
102717;102759;0;15546;VERDADERO;VERDADERO;-42;;;
102748;102759;0;15547;VERDADERO;VERDADERO;-11;;;
102748;102759;0;15548;VERDADERO;VERDADERO;-11;;;
102748;102779;0;15549;VERDADERO;VERDADERO;-31;;;
102748;102779;0;15550;VERDADERO;VERDADERO;-31;;;
102781;102779;0;15551;VERDADERO;VERDADERO;2;;;
102781;102799;0;15552;VERDADERO;VERDADERO;-18;;;
102781;102799;0;15553;VERDADERO;VERDADERO;-18;;;
102781;102819;1;15554;VERDADERO;VERDADERO;-38;;;
102781;102819;0;15555;VERDADERO;VERDADERO;-38;;;
102813;102819;0;15556;VERDADERO;VERDADERO;-6;;;
102813;102819;0;15557;VERDADERO;VERDADERO;-6;;;
102813;102819;0;15558;VERDADERO;VERDADERO;-6;;;
102813;102819;0;15559;VERDADERO;VERDADERO;-6;;;
102813;102839;1;15560;VERDADERO;VERDADERO;-26;;;
102813;102839;0;15561;VERDADERO;VERDADERO;-26;;;
102848;102860;1;15562;VERDADERO;VERDADERO;-12;;;
102848;102860;0;15563;VERDADERO;VERDADERO;-12;;;
102848;102860;0;15564;VERDADERO;VERDADERO;-12;;;
102848;102880;0;15565;VERDADERO;VERDADERO;-32;;;
102848;102880;0;15566;VERDADERO;VERDADERO;-32;;;
102881;102880;0;15567;VERDADERO;VERDADERO;1;;;
102881;102900;0;15568;VERDADERO;VERDADERO;-19;;;
102881;102900;0;15569;VERDADERO;VERDADERO;-19;;;
102881;102920;0;15570;VERDADERO;VERDADERO;-39;;;
102881;102920;0;15571;VERDADERO;VERDADERO;-39;;;
102913;102920;0;15572;VERDADERO;VERDADERO;-7;;;
102913;102940;0;15573;VERDADERO;VERDADERO;-27;;;
102913;102940;0;15574;VERDADERO;VERDADERO;-27;;;
102913;102960;0;15575;VERDADERO;VERDADERO;-47;;;
102913;102960;0;15576;VERDADERO;VERDADERO;-47;;;
102913;102960;0;15577;VERDADERO;VERDADERO;-47;;;
102948;102980;0;15578;VERDADERO;VERDADERO;-32;;;
102948;102980;0;15579;VERDADERO;VERDADERO;-32;;;
102948;102980;0;15580;VERDADERO;VERDADERO;-32;;;
102948;102980;0;15581;VERDADERO;VERDADERO;-32;;;
102948;103000;1;15582;VERDADERO;FALSO;-52;;;
102981;103000;0;15583;VERDADERO;VERDADERO;-19;;;
102981;103000;0;15584;VERDADERO;VERDADERO;-19;;;
102981;103020;0;15585;VERDADERO;VERDADERO;-39;;;
102981;103020;0;15586;VERDADERO;VERDADERO;-39;;;
102981;103020;0;15587;VERDADERO;VERDADERO;-39;;;
103013;103020;0;15588;VERDADERO;VERDADERO;-7;;;
103013;103020;0;15589;VERDADERO;VERDADERO;-7;;;
103013;103020;0;15590;VERDADERO;VERDADERO;-7;;;
103013;103020;0;15591;VERDADERO;VERDADERO;-7;;;
103013;103040;1;15592;VERDADERO;VERDADERO;-27;;;
103044;103040;0;15593;VERDADERO;VERDADERO;4;;;
103044;103060;0;15594;VERDADERO;VERDADERO;-16;;;
103044;103060;0;15595;VERDADERO;VERDADERO;-16;;;
103044;103060;0;15596;VERDADERO;VERDADERO;-16;;;
103044;103080;0;15597;VERDADERO;VERDADERO;-36;;;
103077;103080;0;15598;VERDADERO;VERDADERO;-3;;;
103077;103080;0;15599;VERDADERO;VERDADERO;-3;;;
103077;103100;0;15600;VERDADERO;VERDADERO;-23;;;
103077;103100;0;15601;VERDADERO;VERDADERO;-23;;;
103077;103120;0;15602;VERDADERO;VERDADERO;-43;;;
103077;103120;0;15603;VERDADERO;VERDADERO;-43;;;
103112;103120;0;15604;VERDADERO;VERDADERO;-8;;;
103112;103140;1;15605;VERDADERO;VERDADERO;-28;;;
103112;103140;0;15606;VERDADERO;VERDADERO;-28;;;
103112;103140;0;15607;VERDADERO;VERDADERO;-28;;;
103112;103160;1;15608;VERDADERO;VERDADERO;-48;;;
103145;103160;0;15609;VERDADERO;VERDADERO;-15;;;
103145;103160;0;15610;VERDADERO;VERDADERO;-15;;;
103145;103180;0;15611;VERDADERO;VERDADERO;-35;;;
103145;103180;0;15612;VERDADERO;VERDADERO;-35;;;
103176;103180;0;15613;VERDADERO;VERDADERO;-4;;;
103176;103180;0;15614;VERDADERO;VERDADERO;-4;;;
103176;103180;0;15615;VERDADERO;VERDADERO;-4;;;
103176;103180;0;15616;VERDADERO;VERDADERO;-4;;;
103176;103180;0;15617;VERDADERO;VERDADERO;-4;;;
103176;103200;0;15618;VERDADERO;VERDADERO;-24;;;
103209;103200;0;15619;VERDADERO;VERDADERO;9;;;
103209;103220;0;15620;VERDADERO;VERDADERO;-11;;;
103209;103220;0;15621;VERDADERO;VERDADERO;-11;;;
103209;103220;0;15622;VERDADERO;VERDADERO;-11;;;
103209;103240;0;15623;VERDADERO;VERDADERO;-31;;;
103241;103240;0;15624;VERDADERO;VERDADERO;1;;;
103241;103260;0;15625;VERDADERO;VERDADERO;-19;;;
103241;103260;0;15626;VERDADERO;VERDADERO;-19;;;
103241;103260;0;15627;VERDADERO;VERDADERO;-19;;;
103241;103280;0;15628;VERDADERO;VERDADERO;-39;;;
103277;103280;0;15629;VERDADERO;VERDADERO;-3;;;
103277;103300;0;15630;VERDADERO;VERDADERO;-23;;;
103277;103300;0;15631;VERDADERO;VERDADERO;-23;;;
103277;103300;0;15632;VERDADERO;VERDADERO;-23;;;
103277;103320;0;15633;VERDADERO;VERDADERO;-43;;;
103309;103320;0;15634;VERDADERO;VERDADERO;-11;;;
103309;103340;0;15635;VERDADERO;VERDADERO;-31;;;
103309;103340;0;15636;VERDADERO;VERDADERO;-31;;;
103309;103340;0;15637;VERDADERO;VERDADERO;-31;;;
103309;103340;0;15638;VERDADERO;VERDADERO;-31;;;
103309;103340;0;15639;VERDADERO;VERDADERO;-31;;;
103345;103340;0;15640;VERDADERO;VERDADERO;5;;;
103345;103360;0;15641;VERDADERO;VERDADERO;-15;;;
103345;103360;0;15642;VERDADERO;VERDADERO;-15;;;
103345;103380;0;15643;VERDADERO;VERDADERO;-35;;;
103345;103380;0;15644;VERDADERO;VERDADERO;-35;;;
103376;103380;0;15645;VERDADERO;VERDADERO;-4;;;
103376;103380;0;15646;VERDADERO;VERDADERO;-4;;;
103376;103380;0;15647;VERDADERO;VERDADERO;-4;;;
103376;103380;0;15648;VERDADERO;VERDADERO;-4;;;
103376;103400;1;15649;VERDADERO;VERDADERO;-24;;;
103376;103400;0;15650;VERDADERO;VERDADERO;-24;;;
103413;103400;0;15651;VERDADERO;VERDADERO;13;;;
103413;103420;0;15652;VERDADERO;VERDADERO;-7;;;
103413;103420;0;15653;VERDADERO;VERDADERO;-7;;;
103413;103440;0;15654;VERDADERO;VERDADERO;-27;;;
103413;103440;0;15655;VERDADERO;VERDADERO;-27;;;
103445;103440;0;15656;VERDADERO;VERDADERO;5;;;
103445;103440;0;15657;VERDADERO;VERDADERO;5;;;
103445;103460;0;15658;VERDADERO;VERDADERO;-15;;;
103445;103460;0;15659;VERDADERO;VERDADERO;-15;;;
103445;103480;0;15660;VERDADERO;VERDADERO;-35;;;
103477;103480;0;15661;VERDADERO;VERDADERO;-3;;;
103477;103480;0;15662;VERDADERO;VERDADERO;-3;;;
103477;103500;0;15663;VERDADERO;VERDADERO;-23;;;
103477;103500;0;15664;VERDADERO;VERDADERO;-23;;;
103477;103520;0;15665;VERDADERO;VERDADERO;-43;;;
103477;103520;0;15666;VERDADERO;VERDADERO;-43;;;
103513;103520;0;15667;VERDADERO;VERDADERO;-7;;;
103513;103540;0;15668;VERDADERO;VERDADERO;-27;;;
103513;103540;0;15669;VERDADERO;VERDADERO;-27;;;
103513;103560;0;15670;VERDADERO;VERDADERO;-47;;;
103513;103560;0;15671;VERDADERO;VERDADERO;-47;;;
103545;103560;0;15672;VERDADERO;VERDADERO;-15;;;
103545;103560;0;15673;VERDADERO;VERDADERO;-15;;;
103545;103560;0;15674;VERDADERO;VERDADERO;-15;;;
103545;103580;0;15675;VERDADERO;VERDADERO;-35;;;
103545;103580;0;15676;VERDADERO;VERDADERO;-35;;;
103581;103600;0;15677;VERDADERO;VERDADERO;-19;;;
103581;103600;0;15678;VERDADERO;VERDADERO;-19;;;
103581;103600;0;15679;VERDADERO;VERDADERO;-19;;;
103581;103600;0;15680;VERDADERO;VERDADERO;-19;;;
103581;103600;0;15681;VERDADERO;VERDADERO;-19;;;
103581;103600;0;15682;VERDADERO;VERDADERO;-19;;;
103612;103620;0;15683;VERDADERO;VERDADERO;-8;;;
103612;103620;0;15684;VERDADERO;VERDADERO;-8;;;
103612;103620;0;15685;VERDADERO;VERDADERO;-8;;;
103612;103640;0;15686;VERDADERO;VERDADERO;-28;;;
103612;103640;0;15687;VERDADERO;VERDADERO;-28;;;
103648;103660;1;15688;VERDADERO;VERDADERO;-12;;;
103648;103660;0,00E+00;15689;VERDADERO;VERDADERO;-12;;;
103648;103660;0;15690;VERDADERO;VERDADERO;-12;;;
103648;103660;0;15691;VERDADERO;VERDADERO;-12;;;
103648;103660;0;15692;VERDADERO;VERDADERO;-12;;;
103681;103660;0;15693;VERDADERO;VERDADERO;21;;;
103681;103680;0;15694;VERDADERO;VERDADERO;1;;;
103681;103680;0;15695;VERDADERO;VERDADERO;1;;;
103681;103680;0;15696;VERDADERO;VERDADERO;1;;;
103681;103700;0;15697;VERDADERO;VERDADERO;-19;;;
103681;103700;0;15698;VERDADERO;VERDADERO;-19;;;
103713;103720;1;15699;VERDADERO;VERDADERO;-7;;;
103713;103720;0;15700;VERDADERO;VERDADERO;-7;;;
103713;103720;0;15701;VERDADERO;VERDADERO;-7;;;
103713;103720;0;15702;VERDADERO;VERDADERO;-7;;;
103713;103740;0;15703;VERDADERO;VERDADERO;-27;;;
103713;103740;0;15704;VERDADERO;VERDADERO;-27;;;
103750;103740;0;15705;VERDADERO;VERDADERO;10;;;
103750;103760;0;15706;VERDADERO;VERDADERO;-10;;;
103750;103760;0;15707;VERDADERO;VERDADERO;-10;;;
103750;103780;0;15708;VERDADERO;VERDADERO;-30;;;
103781;103780;0;15709;VERDADERO;VERDADERO;1;;;
103781;103800;1;15710;VERDADERO;VERDADERO;-19;;;
103781;103800;0;15711;VERDADERO;VERDADERO;-19;;;
103781;103800;0;15712;VERDADERO;VERDADERO;-19;;;
103781;103820;1;15713;VERDADERO;VERDADERO;-39;;;
103813;103820;0;15714;VERDADERO;VERDADERO;-7;;;
103813;103840;1;15715;VERDADERO;VERDADERO;-27;;;
103813;103840;0;15716;VERDADERO;VERDADERO;-27;;;
103813;103840;0;15717;VERDADERO;VERDADERO;-27;;;
103813;103860;0;15718;VERDADERO;VERDADERO;-47;;;
103813;103860;0;15719;VERDADERO;VERDADERO;-47;;;
103848;103880;0;15720;VERDADERO;VERDADERO;-32;;;
103848;103880;0;15721;VERDADERO;VERDADERO;-32;;;
103848;103880;0;15722;VERDADERO;VERDADERO;-32;;;
103848;103880;0;15723;VERDADERO;VERDADERO;-32;;;
103848;103880;0;15724;VERDADERO;VERDADERO;-32;;;
103881;103900;0;15725;VERDADERO;VERDADERO;-19;;;
103881;103900;0;15726;VERDADERO;VERDADERO;-19;;;
103881;103900;0;15727;VERDADERO;VERDADERO;-19;;;
103881;103920;0;15728;VERDADERO;VERDADERO;-39;;;
103881;103920;0;15729;VERDADERO;VERDADERO;-39;;;
103913;103920;0;15730;VERDADERO;VERDADERO;-7;;;
103913;103920;0;15731;VERDADERO;VERDADERO;-7;;;
103913;103940;0;15732;VERDADERO;VERDADERO;-27;;;
103913;103940;0;15733;VERDADERO;VERDADERO;-27;;;
103913;103940;0;15734;VERDADERO;VERDADERO;-27;;;
103944;103960;0;15735;VERDADERO;VERDADERO;-16;;;
103944;103960;0;15736;VERDADERO;VERDADERO;-16;;;
103944;103980;0;15737;VERDADERO;VERDADERO;-36;;;
103944;103980;0;15738;VERDADERO;VERDADERO;-36;;;
103944;104000;1;15739;VERDADERO;FALSO;-56;;;
103977;104000;0;15740;VERDADERO;VERDADERO;-23;;;
103977;104000;0;15741;VERDADERO;VERDADERO;-23;;;
103977;104020;0;15742;VERDADERO;VERDADERO;-43;;;
103977;104020;0;15743;VERDADERO;VERDADERO;-43;;;
103977;104020;0;15744;VERDADERO;VERDADERO;-43;;;
103977;104020;0;15745;VERDADERO;VERDADERO;-43;;;
103977;104040;0;15746;VERDADERO;FALSO;-63;;;
104020;104040;0;15747;VERDADERO;VERDADERO;-20;;;
104020;104060;0;15748;VERDADERO;VERDADERO;-40;;;
104020;104060;0;15749;VERDADERO;VERDADERO;-40;;;
104020;104060;0;15750;VERDADERO;VERDADERO;-40;;;
104045;104060;0;15751;VERDADERO;VERDADERO;-15;;;
104045;104060;0;15752;VERDADERO;VERDADERO;-15;;;
104045;104080;0;15753;VERDADERO;VERDADERO;-35;;;
104045;104080;0;15754;VERDADERO;VERDADERO;-35;;;
104045;104100;0;15755;VERDADERO;FALSO;-55;;;
104077;104100;0;15756;VERDADERO;VERDADERO;-23;;;
104077;104100;0;15757;VERDADERO;VERDADERO;-23;;;
104077;104100;0;15758;VERDADERO;VERDADERO;-23;;;
104077;104100;0;15759;VERDADERO;VERDADERO;-23;;;
104077;104120;0;15760;VERDADERO;VERDADERO;-43;;;
104077;104120;0;15761;VERDADERO;VERDADERO;-43;;;
104112;104120;0;15762;VERDADERO;VERDADERO;-8;;;
104112;104140;0;15763;VERDADERO;VERDADERO;-28;;;
104112;104140;0;15764;VERDADERO;VERDADERO;-28;;;
104112;104160;0;15765;VERDADERO;VERDADERO;-48;;;
104112;104160;0;15766;VERDADERO;VERDADERO;-48;;;
104149;104160;0;15767;VERDADERO;VERDADERO;-11;;;
104149;104160;0;15768;VERDADERO;VERDADERO;-11;;;
104149;104160;0;15769;VERDADERO;VERDADERO;-11;;;
104149;104160;0;15770;VERDADERO;VERDADERO;-11;;;
104149;104180;0;15771;VERDADERO;VERDADERO;-31;;;
104149;104180;0;15772;VERDADERO;VERDADERO;-31;;;
104181;104200;1;15773;VERDADERO;VERDADERO;-19;;;
104181;104200;0;15774;VERDADERO;VERDADERO;-19;;;
104181;104200;0;15775;VERDADERO;VERDADERO;-19;;;
104181;104200;0;15776;VERDADERO;VERDADERO;-19;;;
104181;104200;0;15777;VERDADERO;VERDADERO;-19;;;
104212;104200;0;15778;VERDADERO;VERDADERO;12;;;
104212;104220;0;15779;VERDADERO;VERDADERO;-8;;;
104212;104220;0;15780;VERDADERO;VERDADERO;-8;;;
104212;104220;0;15781;VERDADERO;VERDADERO;-8;;;
104212;104240;0;15782;VERDADERO;VERDADERO;-28;;;
104249;104240;0;15783;VERDADERO;VERDADERO;9;;;
104249;104240;0;15784;VERDADERO;VERDADERO;9;;;
104249;104260;0;15785;VERDADERO;VERDADERO;-11;;;
104249;104260;0;15786;VERDADERO;VERDADERO;-11;;;
104249;104260;0;15787;VERDADERO;VERDADERO;-11;;;
104249;104260;0;15788;VERDADERO;VERDADERO;-11;;;
104285;104280;0;15789;VERDADERO;VERDADERO;5;;;
104285;104280;0;15790;VERDADERO;VERDADERO;5;;;
104285;104300;0;15791;VERDADERO;VERDADERO;-15;;;
104285;104300;0;15792;VERDADERO;VERDADERO;-15;;;
104285;104300;0;15793;VERDADERO;VERDADERO;-15;;;
104316;104320;1;15794;VERDADERO;VERDADERO;-4;;;
104316;104320;0;15795;VERDADERO;VERDADERO;-4;;;
104316;104340;0;15796;VERDADERO;VERDADERO;-24;;;
104316;104340;0;15797;VERDADERO;VERDADERO;-24;;;
104316;104340;0;15798;VERDADERO;VERDADERO;-24;;;
104316;104360;0;15799;VERDADERO;VERDADERO;-44;;;
104353;104360;0;15800;VERDADERO;VERDADERO;-7;;;
104353;104380;0;15801;VERDADERO;VERDADERO;-27;;;
104353;104380;0;15802;VERDADERO;VERDADERO;-27;;;
104353;104380;0;15803;VERDADERO;VERDADERO;-27;;;
104353;104380;0;15804;VERDADERO;VERDADERO;-27;;;
104384;104400;1;15805;VERDADERO;VERDADERO;-16;;;
104384;104400;0;15806;VERDADERO;VERDADERO;-16;;;
104384;104420;0;15807;VERDADERO;VERDADERO;-36;;;
104384;104420;0;15808;VERDADERO;VERDADERO;-36;;;
104384;104420;0;15809;VERDADERO;VERDADERO;-36;;;
104417;104420;0;15810;VERDADERO;VERDADERO;-3;;;
104417;104420;0;15811;VERDADERO;VERDADERO;-3;;;
104417;104440;1;15812;VERDADERO;VERDADERO;-23;;;
104417;104440;0;15813;VERDADERO;VERDADERO;-23;;;
104417;104460;0;15814;VERDADERO;VERDADERO;-43;;;
104450;104460;0;15815;VERDADERO;VERDADERO;-10;;;
104450;104460;0;15816;VERDADERO;VERDADERO;-10;;;
104450;104480;0;15817;VERDADERO;VERDADERO;-30;;;
104450;104480;0;15818;VERDADERO;VERDADERO;-30;;;
104450;104480;0;15819;VERDADERO;VERDADERO;-30;;;
104481;104500;0;15820;VERDADERO;VERDADERO;-19;;;
104481;104500;0;15821;VERDADERO;VERDADERO;-19;;;
104481;104520;1;15822;VERDADERO;VERDADERO;-39;;;
104481;104520;0;15823;VERDADERO;VERDADERO;-39;;;
104481;104520;0;15824;VERDADERO;VERDADERO;-39;;;
104517;104520;0;15825;VERDADERO;VERDADERO;-3;;;
104517;104520;0;15826;VERDADERO;VERDADERO;-3;;;
104517;104520;0;15827;VERDADERO;VERDADERO;-3;;;
104517;104520;0;15828;VERDADERO;VERDADERO;-3;;;
104517;104520;0;15829;VERDADERO;VERDADERO;-3;;;
104517;104520;0;15830;VERDADERO;VERDADERO;-3;;;
104549;104540;0;15831;VERDADERO;VERDADERO;9;;;
104549;104540;0;15832;VERDADERO;VERDADERO;9;;;
104549;104560;0;15833;VERDADERO;VERDADERO;-11;;;
104549;104560;0;15834;VERDADERO;VERDADERO;-11;;;
104549;104560;0;15835;VERDADERO;VERDADERO;-11;;;
104581;104580;1;15836;VERDADERO;VERDADERO;1;;;
104581;104580;0;15837;VERDADERO;VERDADERO;1;;;
104581;104600;0;15838;VERDADERO;VERDADERO;-19;;;
104581;104600;0;15839;VERDADERO;VERDADERO;-19;;;
104581;104600;0;15840;VERDADERO;VERDADERO;-19;;;
104617;104620;0;15841;VERDADERO;VERDADERO;-3;;;
104617;104620;0;15842;VERDADERO;VERDADERO;-3;;;
104617;104640;0;15843;VERDADERO;VERDADERO;-23;;;
104617;104640;0;15844;VERDADERO;VERDADERO;-23;;;
104617;104640;0;15845;VERDADERO;VERDADERO;-23;;;
104649;104660;0;15846;VERDADERO;VERDADERO;-11;;;
104649;104660;0;15847;VERDADERO;VERDADERO;-11;;;
104649;104680;0;15848;VERDADERO;VERDADERO;-31;;;
104649;104680;0;15849;VERDADERO;VERDADERO;-31;;;
104649;104680;0;15850;VERDADERO;VERDADERO;-31;;;
104680;104680;0;15851;VERDADERO;VERDADERO;0;;;
104680;104680;0;15852;VERDADERO;VERDADERO;0;;;
104680;104680;0;15853;VERDADERO;VERDADERO;0;;;
104680;104700;1;15854;VERDADERO;VERDADERO;-20;;;
104680;104700;0;15855;VERDADERO;VERDADERO;-20;;;
104680;104721;0;15856;VERDADERO;VERDADERO;-41;;;
104713;104721;0;15857;VERDADERO;VERDADERO;-8;;;
104713;104721;0;15858;VERDADERO;VERDADERO;-8;;;
104713;104741;0;15859;VERDADERO;VERDADERO;-28;;;
104713;104741;0;15860;VERDADERO;VERDADERO;-28;;;
104713;104741;0;15861;VERDADERO;VERDADERO;-28;;;
104745;104761;0;15862;VERDADERO;VERDADERO;-16;;;
104745;104761;0;15863;VERDADERO;VERDADERO;-16;;;
104745;104781;0;15864;VERDADERO;VERDADERO;-36;;;
104745;104781;0;15865;VERDADERO;VERDADERO;-36;;;
104745;104781;0;15866;VERDADERO;VERDADERO;-36;;;
104781;104801;1;15867;VERDADERO;VERDADERO;-20;;;
104781;104801;0,00E+00;15868;VERDADERO;VERDADERO;-20;;;
104781;104821;0;15869;VERDADERO;VERDADERO;-40;;;
104781;104821;0;15870;VERDADERO;VERDADERO;-40;;;
104781;104821;0;15871;VERDADERO;VERDADERO;-40;;;
104813;104841;1;15872;VERDADERO;VERDADERO;-28;;;
104813;104841;0;15873;VERDADERO;VERDADERO;-28;;;
104813;104841;0;15874;VERDADERO;VERDADERO;-28;;;
104813;104841;0;15875;VERDADERO;VERDADERO;-28;;;
104813;104841;0;15876;VERDADERO;VERDADERO;-28;;;
104845;104861;0;15877;VERDADERO;VERDADERO;-16;;;
104845;104861;0;15878;VERDADERO;VERDADERO;-16;;;
104845;104861;0;15879;VERDADERO;VERDADERO;-16;;;
104845;104881;1;15880;VERDADERO;VERDADERO;-36;;;
104845;104881;0;15881;VERDADERO;VERDADERO;-36;;;
104845;104881;0;15882;VERDADERO;VERDADERO;-36;;;
104881;104881;0;15883;VERDADERO;VERDADERO;0;;;
104881;104881;0;15884;VERDADERO;VERDADERO;0;;;
104881;104881;0;15885;VERDADERO;VERDADERO;0;;;
104881;104901;1;15886;VERDADERO;VERDADERO;-20;;;
104881;104901;0;15887;VERDADERO;VERDADERO;-20;;;
104913;104921;0;15888;VERDADERO;VERDADERO;-8;;;
104913;104921;0;15889;VERDADERO;VERDADERO;-8;;;
104913;104921;0;15890;VERDADERO;VERDADERO;-8;;;
104913;104941;0;15891;VERDADERO;VERDADERO;-28;;;
104913;104941;0;15892;VERDADERO;VERDADERO;-28;;;
104945;104961;0;15893;VERDADERO;VERDADERO;-16;;;
104945;104961;0;15894;VERDADERO;VERDADERO;-16;;;
104945;104981;0;15895;VERDADERO;VERDADERO;-36;;;
104945;104981;0;15896;VERDADERO;VERDADERO;-36;;;
104945;104981;0;15897;VERDADERO;VERDADERO;-36;;;
104945;104981;0;15898;VERDADERO;VERDADERO;-36;;;
104980;104981;0;15899;VERDADERO;VERDADERO;-1;;;
104980;105001;0;15900;VERDADERO;VERDADERO;-21;;;
104980;105001;0;15901;VERDADERO;VERDADERO;-21;;;
104980;105001;0;15902;VERDADERO;VERDADERO;-21;;;
104980;105021;0;15903;VERDADERO;VERDADERO;-41;;;
105012;105021;0;15904;VERDADERO;VERDADERO;-9;;;
105012;105041;0;15905;VERDADERO;VERDADERO;-29;;;
105012;105041;0;15906;VERDADERO;VERDADERO;-29;;;
105012;105061;0;15907;VERDADERO;VERDADERO;-49;;;
105012;105061;0;15908;VERDADERO;VERDADERO;-49;;;
105044;105061;0;15909;VERDADERO;VERDADERO;-17;;;
105044;105081;0;15910;VERDADERO;VERDADERO;-37;;;
105044;105081;0;15911;VERDADERO;VERDADERO;-37;;;
105044;105081;0;15912;VERDADERO;VERDADERO;-37;;;
105044;105081;0;15913;VERDADERO;VERDADERO;-37;;;
105076;105101;0;15914;VERDADERO;VERDADERO;-25;;;
105076;105101;0;15915;VERDADERO;VERDADERO;-25;;;
105076;105101;0;15916;VERDADERO;VERDADERO;-25;;;
105076;105121;0;15917;VERDADERO;VERDADERO;-45;;;
105076;105121;0;15918;VERDADERO;VERDADERO;-45;;;
105109;105121;0;15919;VERDADERO;VERDADERO;-12;;;
105109;105121;0;15920;VERDADERO;VERDADERO;-12;;;
105109;105141;0;15921;VERDADERO;VERDADERO;-32;;;
105109;105141;0;15922;VERDADERO;VERDADERO;-32;;;
105109;105141;0;15923;VERDADERO;VERDADERO;-32;;;
105109;105161;0;15924;VERDADERO;FALSO;-52;;;
105145;105161;0;15925;VERDADERO;VERDADERO;-16;;;
105145;105161;0;15926;VERDADERO;VERDADERO;-16;;;
105145;105161;0;15927;VERDADERO;VERDADERO;-16;;;
105145;105161;0;15928;VERDADERO;VERDADERO;-16;;;
105145;105181;0;15929;VERDADERO;VERDADERO;-36;;;
105176;105181;0;15930;VERDADERO;VERDADERO;-5;;;
105176;105181;0;15931;VERDADERO;VERDADERO;-5;;;
105176;105202;0;15932;VERDADERO;VERDADERO;-26;;;
105176;105202;0;15933;VERDADERO;VERDADERO;-26;;;
105176;105222;1;15934;VERDADERO;VERDADERO;-46;;;
105209;105222;0;15935;VERDADERO;VERDADERO;-13;;;
105209;105222;0;15936;VERDADERO;VERDADERO;-13;;;
105209;105242;1;15937;VERDADERO;VERDADERO;-33;;;
105209;105242;0;15938;VERDADERO;VERDADERO;-33;;;
105209;105242;0;15939;VERDADERO;VERDADERO;-33;;;
105242;105262;0;15940;VERDADERO;VERDADERO;-20;;;
105242;105262;0;15941;VERDADERO;VERDADERO;-20;;;
105242;105262;0;15942;VERDADERO;VERDADERO;-20;;;
105242;105262;0;15943;VERDADERO;VERDADERO;-20;;;
105242;105262;0;15944;VERDADERO;VERDADERO;-20;;;
105273;105262;0;15945;VERDADERO;VERDADERO;11;;;
105273;105262;0;15946;VERDADERO;VERDADERO;11;;;
105273;105282;0;15947;VERDADERO;VERDADERO;-9;;;
105273;105282;0;15948;VERDADERO;VERDADERO;-9;;;
105273;105282;0;15949;VERDADERO;VERDADERO;-9;;;
105273;105302;0;15950;VERDADERO;VERDADERO;-29;;;
105309;105302;0;15951;VERDADERO;VERDADERO;7;;;
105309;105322;0;15952;VERDADERO;VERDADERO;-13;;;
105309;105322;0;15953;VERDADERO;VERDADERO;-13;;;
105309;105342;0;15954;VERDADERO;VERDADERO;-33;;;
105309;105342;0;15955;VERDADERO;VERDADERO;-33;;;
105340;105342;0;15956;VERDADERO;VERDADERO;-2;;;
105340;105362;0;15957;VERDADERO;VERDADERO;-22;;;
105340;105362;0;15958;VERDADERO;VERDADERO;-22;;;
105340;105382;0;15959;VERDADERO;VERDADERO;-42;;;
105340;105382;0;15960;VERDADERO;VERDADERO;-42;;;
105376;105382;0;15961;VERDADERO;VERDADERO;-6;;;
105376;105402;0;15962;VERDADERO;VERDADERO;-26;;;
105376;105402;0;15963;VERDADERO;VERDADERO;-26;;;
105376;105402;0;15964;VERDADERO;VERDADERO;-26;;;
105376;105422;0;15965;VERDADERO;VERDADERO;-46;;;
105409;105422;0;15966;VERDADERO;VERDADERO;-13;;;
105409;105422;0;15967;VERDADERO;VERDADERO;-13;;;
105409;105422;0;15968;VERDADERO;VERDADERO;-13;;;
105409;105422;0;15969;VERDADERO;VERDADERO;-13;;;
105409;105422;0;15970;VERDADERO;VERDADERO;-13;;;
105409;105422;0;15971;VERDADERO;VERDADERO;-13;;;
105409;105442;0;15972;VERDADERO;VERDADERO;-33;;;
105448;105442;0;15973;VERDADERO;VERDADERO;6;;;
105448;105442;0;15974;VERDADERO;VERDADERO;6;;;
105448;105462;0;15975;VERDADERO;VERDADERO;-14;;;
105448;105462;0;15976;VERDADERO;VERDADERO;-14;;;
105477;105482;1;15977;VERDADERO;VERDADERO;-5;;;
105477;105482;0;15978;VERDADERO;VERDADERO;-5;;;
105477;105482;0;15979;VERDADERO;VERDADERO;-5;;;
105477;105502;0;15980;VERDADERO;VERDADERO;-25;;;
105477;105502;0;15981;VERDADERO;VERDADERO;-25;;;
105509;105522;1;15982;VERDADERO;VERDADERO;-13;;;
105509;105522;0;15983;VERDADERO;VERDADERO;-13;;;
105509;105522;0;15984;VERDADERO;VERDADERO;-13;;;
105509;105542;0;15985;VERDADERO;VERDADERO;-33;;;
105509;105542;0;15986;VERDADERO;VERDADERO;-33;;;
105509;105542;0;15987;VERDADERO;VERDADERO;-33;;;
105545;105562;1;15988;VERDADERO;VERDADERO;-17;;;
105545;105562;0;15989;VERDADERO;VERDADERO;-17;;;
105545;105582;0;15990;VERDADERO;VERDADERO;-37;;;
105545;105582;0;15991;VERDADERO;VERDADERO;-37;;;
105545;105582;0;15992;VERDADERO;VERDADERO;-37;;;
105581;105582;0;15993;VERDADERO;VERDADERO;-1;;;
105581;105582;0;15994;VERDADERO;VERDADERO;-1;;;
105581;105582;0;15995;VERDADERO;VERDADERO;-1;;;
105581;105582;0;15996;VERDADERO;VERDADERO;-1;;;
105581;105582;0;15997;VERDADERO;VERDADERO;-1;;;
105581;105602;0;15998;VERDADERO;VERDADERO;-21;;;
105613;105602;0;15999;VERDADERO;VERDADERO;11;;;
105613;105622;0;16000;VERDADERO;VERDADERO;-9;;;
105613;105622;0;16001;VERDADERO;VERDADERO;-9;;;
105613;105642;0;16002;VERDADERO;VERDADERO;-29;;;
105645;105642;0;16003;VERDADERO;VERDADERO;3;;;
105645;105642;0;16004;VERDADERO;VERDADERO;3;;;
105645;105642;0;16005;VERDADERO;VERDADERO;3;;;
105645;105662;1;16006;VERDADERO;VERDADERO;-17;;;
105645;105662;0;16007;VERDADERO;VERDADERO;-17;;;
105645;105682;0;16008;VERDADERO;VERDADERO;-37;;;
105681;105682;0;16009;VERDADERO;VERDADERO;-1;;;
105681;105682;0;16010;VERDADERO;VERDADERO;-1;;;
105681;105702;0;16011;VERDADERO;VERDADERO;-21;;;
105681;105702;0;16012;VERDADERO;VERDADERO;-21;;;
105681;105702;0;16013;VERDADERO;VERDADERO;-21;;;
105716;105702;0;16014;VERDADERO;VERDADERO;14;;;
105716;105702;0;16015;VERDADERO;VERDADERO;14;;;
105716;105702;0;16016;VERDADERO;VERDADERO;14;;;
105716;105702;0;16017;VERDADERO;VERDADERO;14;;;
105716;105702;0;16018;VERDADERO;VERDADERO;14;;;
105749;105702;0;16019;VERDADERO;VERDADERO;47;;;
105749;105722;0;16020;VERDADERO;VERDADERO;27;;;
105749;105722;0;16021;VERDADERO;VERDADERO;27;;;
105749;105722;0;16022;VERDADERO;VERDADERO;27;;;
105749;105742;0;16023;VERDADERO;VERDADERO;7;;;
105781;105742;0;16024;VERDADERO;VERDADERO;39;;;
105781;105762;0;16025;VERDADERO;VERDADERO;19;;;
105781;105762;0;16026;VERDADERO;VERDADERO;19;;;
105781;105762;0;16027;VERDADERO;VERDADERO;19;;;
105781;105782;0;16028;VERDADERO;VERDADERO;-1;;;
105813;105782;0;16029;VERDADERO;VERDADERO;31;;;
105813;105802;1;16030;VERDADERO;VERDADERO;11;;;
105813;105802;0;16031;VERDADERO;VERDADERO;11;;;
105813;105802;0;16032;VERDADERO;VERDADERO;11;;;
105813;105822;0;16033;VERDADERO;VERDADERO;-9;;;
105845;105822;0;16034;VERDADERO;VERDADERO;23;;;
105845;105842;0;16035;VERDADERO;VERDADERO;3;;;
105845;105842;0;16036;VERDADERO;VERDADERO;3;;;
105845;105842;0;16037;VERDADERO;VERDADERO;3;;;
105845;105862;0;16038;VERDADERO;VERDADERO;-17;;;
105845;105862;0;16039;VERDADERO;VERDADERO;-17;;;
105881;105882;0;16040;VERDADERO;VERDADERO;-1;;;
105881;105882;0;16041;VERDADERO;VERDADERO;-1;;;
105881;105882;0;16042;VERDADERO;VERDADERO;-1;;;
105881;105902;0;16043;VERDADERO;VERDADERO;-21;;;
105881;105902;0;16044;VERDADERO;VERDADERO;-21;;;
105913;105923;1;16045;VERDADERO;VERDADERO;-10;;;
105913;105923;0;16046;VERDADERO;VERDADERO;-10;;;
105913;105923;0;16047;VERDADERO;VERDADERO;-10;;;
105913;105943;0;16048;VERDADERO;VERDADERO;-30;;;
105913;105943;0;16049;VERDADERO;VERDADERO;-30;;;
105945;105943;0;16050;VERDADERO;VERDADERO;2;;;
105945;105963;0;16051;VERDADERO;VERDADERO;-18;;;
105945;105963;0;16052;VERDADERO;VERDADERO;-18;;;
105945;105983;0;16053;VERDADERO;VERDADERO;-38;;;
105945;105983;0;16054;VERDADERO;VERDADERO;-38;;;
105976;105983;0;16055;VERDADERO;VERDADERO;-7;;;
105976;106003;0;16056;VERDADERO;VERDADERO;-27;;;
105976;106003;0;16057;VERDADERO;VERDADERO;-27;;;
105976;106023;0;16058;VERDADERO;VERDADERO;-47;;;
105976;106023;0;16059;VERDADERO;VERDADERO;-47;;;
106009;106023;0;16060;VERDADERO;VERDADERO;-14;;;
106009;106043;1;16061;VERDADERO;VERDADERO;-34;;;
106009;106043;0;16062;VERDADERO;VERDADERO;-34;;;
106009;106043;0;16063;VERDADERO;VERDADERO;-34;;;
106009;106043;0;16064;VERDADERO;VERDADERO;-34;;;
106009;106043;0;16065;VERDADERO;VERDADERO;-34;;;
106045;106063;1;16066;VERDADERO;VERDADERO;-18;;;
106045;106063;0;16067;VERDADERO;VERDADERO;-18;;;
106045;106063;0;16068;VERDADERO;VERDADERO;-18;;;
106045;106083;1;16069;VERDADERO;VERDADERO;-38;;;
106045;106083;0;16070;VERDADERO;VERDADERO;-38;;;
106077;106083;0;16071;VERDADERO;VERDADERO;-6;;;
106077;106083;0;16072;VERDADERO;VERDADERO;-6;;;
106077;106083;0;16073;VERDADERO;VERDADERO;-6;;;
106077;106083;0;16074;VERDADERO;VERDADERO;-6;;;
106077;106103;0;16075;VERDADERO;VERDADERO;-26;;;
106109;106103;0;16076;VERDADERO;VERDADERO;6;;;
106109;106123;0;16077;VERDADERO;VERDADERO;-14;;;
106109;106123;0;16078;VERDADERO;VERDADERO;-14;;;
106109;106123;0;16079;VERDADERO;VERDADERO;-14;;;
106109;106143;0;16080;VERDADERO;VERDADERO;-34;;;
106109;106143;0;16081;VERDADERO;VERDADERO;-34;;;
106144;106143;0;16082;VERDADERO;VERDADERO;1;;;
106144;106143;0;16083;VERDADERO;VERDADERO;1;;;
106144;106143;0;16084;VERDADERO;VERDADERO;1;;;
106144;106163;0;16085;VERDADERO;VERDADERO;-19;;;
106144;106163;0;16086;VERDADERO;VERDADERO;-19;;;
106177;106183;0;16087;VERDADERO;VERDADERO;-6;;;
106177;106183;0;16088;VERDADERO;VERDADERO;-6;;;
106177;106183;0;16089;VERDADERO;VERDADERO;-6;;;
106177;106183;0;16090;VERDADERO;VERDADERO;-6;;;
106177;106183;0;16091;VERDADERO;VERDADERO;-6;;;
106209;106183;0;16092;VERDADERO;VERDADERO;26;;;
106209;106183;0;16093;VERDADERO;VERDADERO;26;;;
106209;106183;0;16094;VERDADERO;VERDADERO;26;;;
106209;106183;0;16095;VERDADERO;VERDADERO;26;;;
106209;106203;0;16096;VERDADERO;VERDADERO;6;;;
106209;106203;0;16097;VERDADERO;VERDADERO;6;;;
106245;106223;0;16098;VERDADERO;VERDADERO;22;;;
106245;106223;0;16099;VERDADERO;VERDADERO;22;;;
106245;106223;0;16100;VERDADERO;VERDADERO;22;;;
106245;106243;0;16101;VERDADERO;VERDADERO;2;;;
106245;106243;0;16102;VERDADERO;VERDADERO;2;;;
106276;106263;1;16103;VERDADERO;VERDADERO;13;;;
106276;106263;0;16104;VERDADERO;VERDADERO;13;;;
106276;106263;0;16105;VERDADERO;VERDADERO;13;;;
106276;106283;0;16106;VERDADERO;VERDADERO;-7;;;
106276;106283;0;16107;VERDADERO;VERDADERO;-7;;;
106312;106303;0;16108;VERDADERO;VERDADERO;9;;;
106312;106303;0;16109;VERDADERO;VERDADERO;9;;;
106312;106303;0;16110;VERDADERO;VERDADERO;9;;;
106312;106323;1;16111;VERDADERO;VERDADERO;-11;;;
106312;106323;0;16112;VERDADERO;VERDADERO;-11;;;
106344;106343;1;16113;VERDADERO;VERDADERO;1;;;
106344;106343;0;16114;VERDADERO;VERDADERO;1;;;
106344;106343;0;16115;VERDADERO;VERDADERO;1;;;
106344;106363;0;16116;VERDADERO;VERDADERO;-19;;;
106344;106363;0;16117;VERDADERO;VERDADERO;-19;;;
106377;106383;1;16118;VERDADERO;VERDADERO;-6;;;
106377;106383;0;16119;VERDADERO;VERDADERO;-6;;;
106377;106403;0;16120;VERDADERO;VERDADERO;-26;;;
106377;106403;0;16121;VERDADERO;VERDADERO;-26;;;
106377;106403;0;16122;VERDADERO;VERDADERO;-26;;;
106377;106423;0;16123;VERDADERO;VERDADERO;-46;;;
106413;106423;0;16124;VERDADERO;VERDADERO;-10;;;
106413;106443;0;16125;VERDADERO;VERDADERO;-30;;;
106413;106443;0;16126;VERDADERO;VERDADERO;-30;;;
106413;106443;0;16127;VERDADERO;VERDADERO;-30;;;
106413;106443;0;16128;VERDADERO;VERDADERO;-30;;;
106445;106443;0;16129;VERDADERO;VERDADERO;2;;;
106445;106443;0;16130;VERDADERO;VERDADERO;2;;;
106445;106463;0;16131;VERDADERO;VERDADERO;-18;;;
106445;106463;0;16132;VERDADERO;VERDADERO;-18;;;
106445;106463;0;16133;VERDADERO;VERDADERO;-18;;;
106477;106483;0;16134;VERDADERO;VERDADERO;-6;;;
106477;106483;0;16135;VERDADERO;VERDADERO;-6;;;
106477;106483;0;16136;VERDADERO;VERDADERO;-6;;;
106477;106483;0;16137;VERDADERO;VERDADERO;-6;;;
106477;106483;0;16138;VERDADERO;VERDADERO;-6;;;
106477;106483;0;16139;VERDADERO;VERDADERO;-6;;;
106513;106483;0;16140;VERDADERO;VERDADERO;30;;;
106513;106483;0;16141;VERDADERO;VERDADERO;30;;;
106513;106503;0;16142;VERDADERO;VERDADERO;10;;;
106513;106503;0;16143;VERDADERO;VERDADERO;10;;;
106513;106503;0;16144;VERDADERO;VERDADERO;10;;;
106545;106523;1;16145;VERDADERO;VERDADERO;22;;;
106545;106523;0;16146;VERDADERO;VERDADERO;22;;;
106545;106543;0;16147;VERDADERO;VERDADERO;2;;;
106545;106543;0;16148;VERDADERO;VERDADERO;2;;;
106545;106543;0;16149;VERDADERO;VERDADERO;2;;;
106576;106563;0;16150;VERDADERO;VERDADERO;13;;;
106576;106563;0;16151;VERDADERO;VERDADERO;13;;;
106576;106583;0;16152;VERDADERO;VERDADERO;-7;;;
106576;106583;0;16153;VERDADERO;VERDADERO;-7;;;
106576;106583;0;16154;VERDADERO;VERDADERO;-7;;;
106576;106603;0;16155;VERDADERO;VERDADERO;-27;;;
106612;106603;0;16156;VERDADERO;VERDADERO;9;;;
106612;106623;0;16157;VERDADERO;VERDADERO;-11;;;
106612;106623;0;16158;VERDADERO;VERDADERO;-11;;;
106612;106623;0;16159;VERDADERO;VERDADERO;-11;;;
106612;106643;0;16160;VERDADERO;VERDADERO;-31;;;
106645;106643;0;16161;VERDADERO;VERDADERO;2;;;
106645;106663;0;16162;VERDADERO;VERDADERO;-18;;;
106645;106663;0;16163;VERDADERO;VERDADERO;-18;;;
106645;106663;0;16164;VERDADERO;VERDADERO;-18;;;
106645;106683;0;16165;VERDADERO;VERDADERO;-38;;;
106676;106683;0;16166;VERDADERO;VERDADERO;-7;;;
106676;106683;0;16167;VERDADERO;VERDADERO;-7;;;
106676;106683;0;16168;VERDADERO;VERDADERO;-7;;;
106676;106683;0;16169;VERDADERO;VERDADERO;-7;;;
106676;106683;0;16170;VERDADERO;VERDADERO;-7;;;
106713;106683;0;16171;VERDADERO;VERDADERO;30;;;
106713;106683;0;16172;VERDADERO;VERDADERO;30;;;
106713;106683;0;16173;VERDADERO;VERDADERO;30;;;
106713;106683;0;16174;VERDADERO;VERDADERO;30;;;
106713;106683;0;16175;VERDADERO;VERDADERO;30;;;
106744;106683;0;16176;FALSO;VERDADERO;61;;;
106744;106683;0;16177;FALSO;VERDADERO;61;;;
106744;106683;0;16178;FALSO;VERDADERO;61;;;
106744;106683;0;16179;FALSO;VERDADERO;61;;;
106744;106683;0;16180;FALSO;VERDADERO;61;;;
106744;106683;0;16181;FALSO;VERDADERO;61;;;
106777;106683;0;16182;FALSO;VERDADERO;94;;;
106777;106703;0;16183;FALSO;VERDADERO;74;;;
106777;106703;0;16184;FALSO;VERDADERO;74;;;
106777;106703;0;16185;FALSO;VERDADERO;74;;;
106777;106723;0;16186;FALSO;VERDADERO;54;;;
106809;106723;0;16187;FALSO;VERDADERO;86;;;
106809;106743;0;16188;FALSO;VERDADERO;66;;;
106809;106743;0;16189;FALSO;VERDADERO;66;;;
106809;106763;0;16190;VERDADERO;VERDADERO;46;;;
106809;106763;0;16191;VERDADERO;VERDADERO;46;;;
106841;106763;0;16192;FALSO;VERDADERO;78;;;
106841;106783;1;16193;FALSO;VERDADERO;58;;;
106841;106783;0;16194;FALSO;VERDADERO;58;;;
106841;106803;0;16195;VERDADERO;VERDADERO;38;;;
106841;106803;0;16196;VERDADERO;VERDADERO;38;;;
106873;106803;0;16197;FALSO;VERDADERO;70;;;
106873;106823;0;16198;FALSO;VERDADERO;50;;;
106873;106823;0;16199;FALSO;VERDADERO;50;;;
106873;106843;1;16200;VERDADERO;VERDADERO;30;;;
106873;106843;0;16201;VERDADERO;VERDADERO;30;;;
106905;106843;0;16202;FALSO;VERDADERO;62;;;
106905;106863;1;16203;VERDADERO;VERDADERO;42;;;
106905;106863;0;16204;VERDADERO;VERDADERO;42;;;
106905;106863;0;16205;VERDADERO;VERDADERO;42;;;
106905;106863;0;16206;VERDADERO;VERDADERO;42;;;
106905;106863;0;16207;VERDADERO;VERDADERO;42;;;
106941;106863;0;16208;FALSO;VERDADERO;78;;;
106941;106863;0;16209;FALSO;VERDADERO;78;;;
106941;106883;0;16210;FALSO;VERDADERO;58;;;
106941;106883;0;16211;FALSO;VERDADERO;58;;;
106941;106904;0;16212;VERDADERO;VERDADERO;37;;;
106974;106904;0;16213;FALSO;VERDADERO;70;;;
106974;106904;0;16214;FALSO;VERDADERO;70;;;
106974;106924;1;16215;FALSO;VERDADERO;50;;;
106974;106924;0;16216;FALSO;VERDADERO;50;;;
106974;106944;0;16217;VERDADERO;VERDADERO;30;;;
107005;106944;0;16218;FALSO;VERDADERO;61;;;
107005;106944;0;16219;FALSO;VERDADERO;61;;;
107005;106964;0;16220;VERDADERO;VERDADERO;41;;;
107005;106964;0;16221;VERDADERO;VERDADERO;41;;;
107005;106984;0;16222;VERDADERO;VERDADERO;21;;;
107005;106984;0;16223;VERDADERO;VERDADERO;21;;;
107041;106984;0;16224;FALSO;VERDADERO;57;;;
107041;107004;0;16225;VERDADERO;VERDADERO;37;;;
107041;107004;0;16226;VERDADERO;VERDADERO;37;;;
107041;107024;0;16227;VERDADERO;VERDADERO;17;;;
107072;107024;0;16228;VERDADERO;VERDADERO;48;;;
107072;107024;0;16229;VERDADERO;VERDADERO;48;;;
107072;107044;0;16230;VERDADERO;VERDADERO;28;;;
107072;107044;0;16231;VERDADERO;VERDADERO;28;;;
107072;107064;1;16232;VERDADERO;VERDADERO;8;;;
107072;107064;0;16233;VERDADERO;VERDADERO;8;;;
107109;107084;0;16234;VERDADERO;VERDADERO;25;;;
107109;107084;0;16235;VERDADERO;VERDADERO;25;;;
107109;107084;0;16236;VERDADERO;VERDADERO;25;;;
107109;107104;0;16237;VERDADERO;VERDADERO;5;;;
107109;107104;0;16238;VERDADERO;VERDADERO;5;;;
107109;107104;0;16239;VERDADERO;VERDADERO;5;;;
107146;107104;0;16240;VERDADERO;VERDADERO;42;;;
107146;107104;0;16241;VERDADERO;VERDADERO;42;;;
107146;107124;0;16242;VERDADERO;VERDADERO;22;;;
107146;107124;0;16243;VERDADERO;VERDADERO;22;;;
107146;107144;0;16244;VERDADERO;VERDADERO;2;;;
107176;107144;0;16245;VERDADERO;VERDADERO;32;;;
107176;107144;0;16246;VERDADERO;VERDADERO;32;;;
107176;107164;0;16247;VERDADERO;VERDADERO;12;;;
107176;107164;0;16248;VERDADERO;VERDADERO;12;;;
107176;107164;0;16249;VERDADERO;VERDADERO;12;;;
107208;107164;0;16250;VERDADERO;VERDADERO;44;;;
107208;107164;0;16251;VERDADERO;VERDADERO;44;;;
107208;107164;0;16252;VERDADERO;VERDADERO;44;;;
107208;107164;0;16253;VERDADERO;VERDADERO;44;;;
107208;107164;0;16254;VERDADERO;VERDADERO;44;;;
107208;107164;0;16255;VERDADERO;VERDADERO;44;;;
107245;107164;0;16256;FALSO;VERDADERO;81;;;
107245;107164;0;16257;FALSO;VERDADERO;81;;;
107245;107184;1;16258;FALSO;VERDADERO;61;;;
107245;107184;0;16259;FALSO;VERDADERO;61;;;
107245;107184;0;16260;FALSO;VERDADERO;61;;;
107278;107204;0;16261;FALSO;VERDADERO;74;;;
107278;107204;0;16262;FALSO;VERDADERO;74;;;
107278;107224;0;16263;FALSO;VERDADERO;54;;;
107278;107224;0;16264;FALSO;VERDADERO;54;;;
107278;107224;0;16265;FALSO;VERDADERO;54;;;
107278;107244;1;16266;VERDADERO;VERDADERO;34;;;
107313;107244;0;16267;FALSO;VERDADERO;69;;;
107313;107264;0;16268;VERDADERO;VERDADERO;49;;;
107313;107264;0;16269;VERDADERO;VERDADERO;49;;;
107313;107264;0;16270;VERDADERO;VERDADERO;49;;;
107344;107284;0;16271;FALSO;VERDADERO;60;;;
107344;107284;0;16272;FALSO;VERDADERO;60;;;
107344;107304;0;16273;VERDADERO;VERDADERO;40;;;
107344;107304;0;16274;VERDADERO;VERDADERO;40;;;
107344;107304;0;16275;VERDADERO;VERDADERO;40;;;
107344;107324;0;16276;VERDADERO;VERDADERO;20;;;
107377;107324;0;16277;FALSO;VERDADERO;53;;;
107377;107344;0;16278;VERDADERO;VERDADERO;33;;;
107377;107344;0;16279;VERDADERO;VERDADERO;33;;;
107377;107364;0;16280;VERDADERO;VERDADERO;13;;;
107377;107364;0;16281;VERDADERO;VERDADERO;13;;;
107377;107364;0;16282;VERDADERO;VERDADERO;13;;;
107416;107384;0;16283;VERDADERO;VERDADERO;32;;;
107416;107384;0;16284;VERDADERO;VERDADERO;32;;;
107416;107404;0;16285;VERDADERO;VERDADERO;12;;;
107442;107404;0;16286;VERDADERO;VERDADERO;38;;;
107442;107404;0;16287;VERDADERO;VERDADERO;38;;;
107442;107424;0;16288;VERDADERO;VERDADERO;18;;;
107442;107424;0;16289;VERDADERO;VERDADERO;18;;;
107442;107444;0;16290;VERDADERO;VERDADERO;-2;;;
107442;107444;0;16291;VERDADERO;VERDADERO;-2;;;
107477;107444;0;16292;VERDADERO;VERDADERO;33;;;
107477;107464;0;16293;VERDADERO;VERDADERO;13;;;
107477;107464;0;16294;VERDADERO;VERDADERO;13;;;
107477;107484;1;16295;VERDADERO;VERDADERO;-7;;;
107477;107484;0;16296;VERDADERO;VERDADERO;-7;;;
107509;107504;0;16297;VERDADERO;VERDADERO;5;;;
107509;107504;0;16298;VERDADERO;VERDADERO;5;;;
107509;107504;0;16299;VERDADERO;VERDADERO;5;;;
107509;107504;0;16300;VERDADERO;VERDADERO;5;;;
107509;107504;0;16301;VERDADERO;VERDADERO;5;;;
107509;107504;0;16302;VERDADERO;VERDADERO;5;;;
107542;107524;1;16303;VERDADERO;VERDADERO;18;;;
107542;107524;0;16304;VERDADERO;VERDADERO;18;;;
107542;107524;0;16305;VERDADERO;VERDADERO;18;;;
107542;107544;0;16306;VERDADERO;VERDADERO;-2;;;
107573;107544;0;16307;VERDADERO;VERDADERO;29;;;
107573;107564;0;16308;VERDADERO;VERDADERO;9;;;
107573;107564;0;16309;VERDADERO;VERDADERO;9;;;
107573;107564;0;16310;VERDADERO;VERDADERO;9;;;
107573;107564;0;16311;VERDADERO;VERDADERO;9;;;
107605;107564;0;16312;VERDADERO;VERDADERO;41;;;
107605;107564;0;16313;VERDADERO;VERDADERO;41;;;
107605;107564;0;16314;VERDADERO;VERDADERO;41;;;
107605;107564;0;16315;VERDADERO;VERDADERO;41;;;
107605;107564;0;16316;VERDADERO;VERDADERO;41;;;
107636;107564;0;16317;FALSO;VERDADERO;72;;;
107636;107564;0;16318;FALSO;VERDADERO;72;;;
107636;107564;0;16319;FALSO;VERDADERO;72;;;
107636;107564;0;16320;FALSO;VERDADERO;72;;;
107636;107564;0;16321;FALSO;VERDADERO;72;;;
107636;107564;0;16322;FALSO;VERDADERO;72;;;
107669;107564;0;16323;FALSO;VERDADERO;105;;;
107669;107564;0;16324;FALSO;VERDADERO;105;;;
107669;107564;0;16325;FALSO;VERDADERO;105;;;
107669;107564;0;16326;FALSO;VERDADERO;105;;;
107669;107564;0;16327;FALSO;VERDADERO;105;;;
107669;107564;0;16328;FALSO;VERDADERO;105;;;
107705;107564;0;16329;FALSO;VERDADERO;141;;;
107705;107564;0;16330;FALSO;VERDADERO;141;;;
107705;107564;0;16331;FALSO;VERDADERO;141;;;
107705;107564;0;16332;FALSO;VERDADERO;141;;;
107705;107564;0;16333;FALSO;VERDADERO;141;;;
107737;107564;0;16334;FALSO;VERDADERO;173;;;
107737;107564;0;16335;FALSO;VERDADERO;173;;;
107737;107564;0;16336;FALSO;VERDADERO;173;;;
107737;107564;0;16337;FALSO;VERDADERO;173;;;
107737;107564;0;16338;FALSO;VERDADERO;173;;;
107770;107564;0;16339;FALSO;VERDADERO;206;;;
107770;107564;0;16340;FALSO;VERDADERO;206;;;
107770;107564;0;16341;FALSO;VERDADERO;206;;;
107770;107564;0;16342;FALSO;VERDADERO;206;;;
107770;107564;0;16343;FALSO;VERDADERO;206;;;
107770;107564;0;16344;FALSO;VERDADERO;206;;;
107805;107564;0;16345;FALSO;VERDADERO;241;;;
107805;107564;0;16346;FALSO;VERDADERO;241;;;
107805;107564;0;16347;FALSO;VERDADERO;241;;;
107805;107564;0;16348;FALSO;VERDADERO;241;;;
107805;107564;0;16349;FALSO;VERDADERO;241;;;
107805;107564;0;16350;FALSO;VERDADERO;241;;;
107837;107564;0;16351;FALSO;VERDADERO;273;;;
107837;107564;0;16352;FALSO;VERDADERO;273;;;
107837;107564;0;16353;FALSO;VERDADERO;273;;;
107837;107564;0;16354;FALSO;VERDADERO;273;;;
107837;107564;0;16355;FALSO;VERDADERO;273;;;
107837;107564;0;16356;FALSO;VERDADERO;273;;;
107873;107564;0;16357;FALSO;VERDADERO;309;;;
107873;107564;0;16358;FALSO;VERDADERO;309;;;
107873;107564;0;16359;FALSO;VERDADERO;309;;;
107873;107564;0;16360;FALSO;VERDADERO;309;;;
107873;107564;0;16361;FALSO;VERDADERO;309;;;
107905;107564;0;16362;FALSO;VERDADERO;341;;;
107905;107564;0;16363;FALSO;VERDADERO;341;;;
107905;107564;0;16364;FALSO;VERDADERO;341;;;
107905;107564;0;16365;FALSO;VERDADERO;341;;;
107905;107564;0;16366;FALSO;VERDADERO;341;;;
107905;107564;0;16367;FALSO;VERDADERO;341;;;
107940;107564;0;16368;FALSO;VERDADERO;376;;;
107940;107564;0;16369;FALSO;VERDADERO;376;;;
107940;107564;0;16370;FALSO;VERDADERO;376;;;
107940;107564;0;16371;FALSO;VERDADERO;376;;;
107940;107564;0;16372;FALSO;VERDADERO;376;;;
107974;107564;0;16373;FALSO;VERDADERO;410;;;
107974;107564;0;16374;FALSO;VERDADERO;410;;;
107974;107564;0;16375;FALSO;VERDADERO;410;;;
107974;107564;0;16376;FALSO;VERDADERO;410;;;
107974;107564;0;16377;FALSO;VERDADERO;410;;;
108005;107564;0;16378;FALSO;VERDADERO;441;;;
108005;107564;0;16379;FALSO;VERDADERO;441;;;
108005;107564;0;16380;FALSO;VERDADERO;441;;;
108005;107564;0;16381;FALSO;VERDADERO;441;;;
108005;107564;0;16382;FALSO;VERDADERO;441;;;
108005;107564;0;16383;FALSO;VERDADERO;441;;;
108005;107564;0;16384;FALSO;VERDADERO;441;;;
108041;107564;0;16385;FALSO;VERDADERO;477;;;
108041;107564;0;16386;FALSO;VERDADERO;477;;;
108041;107564;0;16387;FALSO;VERDADERO;477;;;
108041;107564;0;16388;FALSO;VERDADERO;477;;;
108041;107564;0;16389;FALSO;VERDADERO;477;;;
108077;107564;0;16390;FALSO;VERDADERO;513;;;
108077;107564;0;16391;FALSO;VERDADERO;513;;;
108077;107564;0;16392;FALSO;VERDADERO;513;;;
108077;107564;0;16393;FALSO;VERDADERO;513;;;
108077;107564;0;16394;FALSO;VERDADERO;513;;;
108109;107564;0;16395;FALSO;VERDADERO;545;;;
108109;107564;0;16396;FALSO;VERDADERO;545;;;
108109;107564;0;16397;FALSO;VERDADERO;545;;;
108109;107564;0;16398;FALSO;VERDADERO;545;;;
108109;107564;0;16399;FALSO;VERDADERO;545;;;
108109;107564;0;16400;FALSO;VERDADERO;545;;;
108145;107564;0;16401;FALSO;VERDADERO;581;;;
108145;107564;0;16402;FALSO;VERDADERO;581;;;
108145;107564;0;16403;FALSO;VERDADERO;581;;;
108145;107564;0;16404;FALSO;VERDADERO;581;;;
108145;107564;0;16405;FALSO;VERDADERO;581;;;
108145;107564;0;16406;FALSO;VERDADERO;581;;;
108177;107564;0;16407;FALSO;VERDADERO;613;;;
108177;107564;0;16408;FALSO;VERDADERO;613;;;
108177;107564;0;16409;FALSO;VERDADERO;613;;;
108177;107564;0;16410;FALSO;VERDADERO;613;;;
108177;107564;0;16411;FALSO;VERDADERO;613;;;
108209;107564;0;16412;FALSO;VERDADERO;645;;;
108209;107564;0;16413;FALSO;VERDADERO;645;;;
108209;107564;0;16414;FALSO;VERDADERO;645;;;
108209;107564;0;16415;FALSO;VERDADERO;645;;;
108209;107564;0;16416;FALSO;VERDADERO;645;;;
108209;107564;0;16417;FALSO;VERDADERO;645;;;
108245;107564;0;16418;FALSO;VERDADERO;681;;;
108245;107564;0;16419;FALSO;VERDADERO;681;;;
108245;107564;0;16420;FALSO;VERDADERO;681;;;
108245;107564;0;16421;FALSO;VERDADERO;681;;;
108245;107564;0;16422;FALSO;VERDADERO;681;;;
108277;107564;0;16423;FALSO;VERDADERO;713;;;
108277;107564;0;16424;FALSO;VERDADERO;713;;;
108277;107564;0;16425;FALSO;VERDADERO;713;;;
108277;107564;0;16426;FALSO;VERDADERO;713;;;
108277;107564;0;16427;FALSO;VERDADERO;713;;;
108309;107564;0;16428;FALSO;VERDADERO;745;;;
108309;107564;0;16429;FALSO;VERDADERO;745;;;
108309;107564;0;16430;FALSO;VERDADERO;745;;;
108309;107564;0;16431;FALSO;VERDADERO;745;;;
108309;107564;0;16432;FALSO;VERDADERO;745;;;
108309;107564;0;16433;FALSO;VERDADERO;745;;;
108341;107564;0;16434;FALSO;VERDADERO;777;;;
108341;107564;0;16435;FALSO;VERDADERO;777;;;
108341;107564;0;16436;FALSO;VERDADERO;777;;;
108341;107564;0;16437;FALSO;VERDADERO;777;;;
108341;107564;0;16438;FALSO;VERDADERO;777;;;
108372;107564;0;16439;FALSO;VERDADERO;808;;;
108372;107564;0;16440;FALSO;VERDADERO;808;;;
108372;107564;0;16441;FALSO;VERDADERO;808;;;
108372;107564;0;16442;FALSO;VERDADERO;808;;;
108372;107564;0;16443;FALSO;VERDADERO;808;;;
108372;107564;0;16444;FALSO;VERDADERO;808;;;
108408;107564;0;16445;FALSO;VERDADERO;844;;;
108408;107564;0;16446;FALSO;VERDADERO;844;;;
108408;107564;0;16447;FALSO;VERDADERO;844;;;
108408;107564;0;16448;FALSO;VERDADERO;844;;;
108408;107564;0;16449;FALSO;VERDADERO;844;;;
108440;107564;0;16450;FALSO;VERDADERO;876;;;
108440;107564;0;16451;FALSO;VERDADERO;876;;;
108440;107564;0;16452;FALSO;VERDADERO;876;;;
108440;107564;0;16453;FALSO;VERDADERO;876;;;
108440;107564;0;16454;FALSO;VERDADERO;876;;;
108473;107564;0;16455;FALSO;VERDADERO;909;;;
108473;107564;0;16456;FALSO;VERDADERO;909;;;
108473;107564;0;16457;FALSO;VERDADERO;909;;;
108473;107564;0;16458;FALSO;VERDADERO;909;;;
108473;107564;0;16459;FALSO;VERDADERO;909;;;
108505;107564;0;16460;FALSO;VERDADERO;941;;;
108505;107564;0;16461;FALSO;VERDADERO;941;;;
108505;107564;0;16462;FALSO;VERDADERO;941;;;
108505;107564;0;16463;FALSO;VERDADERO;941;;;
108505;107564;0;16464;FALSO;VERDADERO;941;;;
108505;107564;0;16465;FALSO;VERDADERO;941;;;
108538;107564;0;16466;FALSO;VERDADERO;974;;;
108538;107564;0;16467;FALSO;VERDADERO;974;;;
108538;107564;0;16468;FALSO;VERDADERO;974;;;
108538;107564;0;16469;FALSO;VERDADERO;974;;;
108538;107564;0;16470;FALSO;VERDADERO;974;;;
108538;107564;0;16471;FALSO;VERDADERO;974;;;
108573;107564;0;16472;FALSO;VERDADERO;1009;;;
108573;107564;0;16473;FALSO;VERDADERO;1009;;;
108573;107564;0;16474;FALSO;VERDADERO;1009;;;
108573;107564;0;16475;FALSO;VERDADERO;1009;;;
108573;107564;0;16476;FALSO;VERDADERO;1009;;;
108605;107564;0;16477;FALSO;VERDADERO;1041;;;
108605;107564;0;16478;FALSO;VERDADERO;1041;;;
108605;107564;0;16479;FALSO;VERDADERO;1041;;;
108605;107564;0;16480;FALSO;VERDADERO;1041;;;
108605;107564;0;16481;FALSO;VERDADERO;1041;;;
108605;107564;0;16482;FALSO;VERDADERO;1041;;;
108641;107564;0;16483;FALSO;VERDADERO;1077;;;
108641;107564;0;16484;FALSO;VERDADERO;1077;;;
108641;107564;0;16485;FALSO;VERDADERO;1077;;;
108641;107564;0;16486;FALSO;VERDADERO;1077;;;
108641;107564;0;16487;FALSO;VERDADERO;1077;;;
108673;107564;0;16488;FALSO;VERDADERO;1109;;;
108673;107564;0;16489;FALSO;VERDADERO;1109;;;
108673;107564;0;16490;FALSO;VERDADERO;1109;;;
108673;107564;0;16491;FALSO;VERDADERO;1109;;;
108673;107564;0;16492;FALSO;VERDADERO;1109;;;
108709;107564;0;16493;FALSO;VERDADERO;1145;;;
108709;107564;0;16494;FALSO;VERDADERO;1145;;;
108709;107564;0;16495;FALSO;VERDADERO;1145;;;
108709;107564;0;16496;FALSO;VERDADERO;1145;;;
108709;107564;0;16497;FALSO;VERDADERO;1145;;;
108709;107564;0;16498;FALSO;VERDADERO;1145;;;
108741;107564;0;16499;FALSO;VERDADERO;1177;;;
108741;107564;0;16500;FALSO;VERDADERO;1177;;;
108741;107564;0;16501;FALSO;VERDADERO;1177;;;
108741;107564;0;16502;FALSO;VERDADERO;1177;;;
108741;107564;0;16503;FALSO;VERDADERO;1177;;;
108773;107564;0;16504;FALSO;VERDADERO;1209;;;
108773;107564;0;16505;FALSO;VERDADERO;1209;;;
108773;107564;0;16506;FALSO;VERDADERO;1209;;;
108773;107564;0;16507;FALSO;VERDADERO;1209;;;
108773;107564;0;16508;FALSO;VERDADERO;1209;;;
108773;107564;0;16509;FALSO;VERDADERO;1209;;;
108809;107564;0;16510;FALSO;VERDADERO;1245;;;
108809;107564;0;16511;FALSO;VERDADERO;1245;;;
108809;107564;0;16512;FALSO;VERDADERO;1245;;;
108809;107564;0;16513;FALSO;VERDADERO;1245;;;
108809;107564;0;16514;FALSO;VERDADERO;1245;;;
108841;107564;0;16515;FALSO;VERDADERO;1277;;;
108841;107564;0;16516;FALSO;VERDADERO;1277;;;
108841;107564;0;16517;FALSO;VERDADERO;1277;;;
108841;107564;0;16518;FALSO;VERDADERO;1277;;;
108841;107564;0;16519;FALSO;VERDADERO;1277;;;
108873;107564;0;16520;FALSO;VERDADERO;1309;;;
108873;107564;0;16521;FALSO;VERDADERO;1309;;;
108873;107564;0;16522;FALSO;VERDADERO;1309;;;
108873;107564;0;16523;FALSO;VERDADERO;1309;;;
108873;107584;0;16524;FALSO;VERDADERO;1289;;;
108873;107584;0;16525;FALSO;VERDADERO;1289;;;
108909;107584;0;16526;FALSO;VERDADERO;1325;;;
108909;107604;0;16527;FALSO;VERDADERO;1305;;;
108909;107604;0;16528;FALSO;VERDADERO;1305;;;
108909;107624;0;16529;FALSO;VERDADERO;1285;;;
108909;107624;0;16530;FALSO;VERDADERO;1285;;;
108941;107624;0;16531;FALSO;VERDADERO;1317;;;
108941;107644;0;16532;FALSO;VERDADERO;1297;;;
108941;107644;0;16533;FALSO;VERDADERO;1297;;;
108941;107664;0;16534;FALSO;VERDADERO;1277;;;
108941;107664;0;16535;FALSO;VERDADERO;1277;;;
108973;107664;0;16536;FALSO;VERDADERO;1309;;;
108973;107684;0;16537;FALSO;VERDADERO;1289;;;
108973;107684;0;16538;FALSO;VERDADERO;1289;;;
108973;107704;0;16539;FALSO;VERDADERO;1269;;;
108973;107704;0;16540;FALSO;VERDADERO;1269;;;
109008;107704;0;16541;FALSO;VERDADERO;1304;;;
109008;107724;0;16542;FALSO;VERDADERO;1284;;;
109008;107724;0;16543;FALSO;VERDADERO;1284;;;
109008;107744;1;16544;FALSO;VERDADERO;1264;;;
109008;107744;0;16545;FALSO;VERDADERO;1264;;;
109008;107744;0;16546;FALSO;VERDADERO;1264;;;
109041;107764;0;16547;FALSO;VERDADERO;1277;;;
109041;107764;0;16548;FALSO;VERDADERO;1277;;;
109041;107784;0;16549;FALSO;VERDADERO;1257;;;
109041;107784;0;16550;FALSO;VERDADERO;1257;;;
109072;107784;0;16551;FALSO;VERDADERO;1288;;;
109072;107804;0;16552;FALSO;VERDADERO;1268;;;
109072;107804;0;16553;FALSO;VERDADERO;1268;;;
109072;107824;0;16554;FALSO;VERDADERO;1248;;;
109072;107824;0;16555;FALSO;VERDADERO;1248;;;
109072;107824;0;16556;FALSO;VERDADERO;1248;;;
109109;107844;0;16557;FALSO;VERDADERO;1265;;;
109109;107844;0;16558;FALSO;VERDADERO;1265;;;
109109;107864;0;16559;FALSO;VERDADERO;1245;;;
109109;107864;0;16560;FALSO;VERDADERO;1245;;;
109109;107864;0;16561;FALSO;VERDADERO;1245;;;
109141;107884;0;16562;FALSO;VERDADERO;1257;;;
109141;107884;0;16563;FALSO;VERDADERO;1257;;;
109141;107904;0;16564;FALSO;VERDADERO;1237;;;
109141;107904;0;16565;FALSO;VERDADERO;1237;;;
109141;107904;0;16566;FALSO;VERDADERO;1237;;;
109172;107924;1;16567;FALSO;VERDADERO;1248;;;
109172;107924;0;16568;FALSO;VERDADERO;1248;;;
109172;107944;0;16569;FALSO;VERDADERO;1228;;;
109172;107944;0;16570;FALSO;VERDADERO;1228;;;
109172;107944;0;16571;FALSO;VERDADERO;1228;;;
109172;107964;0;16572;FALSO;VERDADERO;1208;;;
109209;107964;0;16573;FALSO;VERDADERO;1245;;;
109209;107984;0;16574;FALSO;VERDADERO;1225;;;
109209;107984;0;16575;FALSO;VERDADERO;1225;;;
109209;107984;0;16576;FALSO;VERDADERO;1225;;;
109209;108004;0;16577;FALSO;VERDADERO;1205;;;
109241;108004;0;16578;FALSO;VERDADERO;1237;;;
109241;108024;0;16579;FALSO;VERDADERO;1217;;;
109241;108024;0;16580;FALSO;VERDADERO;1217;;;
109241;108024;0;16581;FALSO;VERDADERO;1217;;;
109241;108044;0;16582;FALSO;VERDADERO;1197;;;
109273;108044;0;16583;FALSO;VERDADERO;1229;;;
109273;108064;0;16584;FALSO;VERDADERO;1209;;;
109273;108064;0;16585;FALSO;VERDADERO;1209;;;
109273;108064;0;16586;FALSO;VERDADERO;1209;;;
109273;108084;0;16587;FALSO;VERDADERO;1189;;;
109305;108084;0;16588;FALSO;VERDADERO;1221;;;
109305;108104;0;16589;FALSO;VERDADERO;1201;;;
109305;108104;0;16590;FALSO;VERDADERO;1201;;;
109305;108104;0;16591;FALSO;VERDADERO;1201;;;
109305;108124;1;16592;FALSO;VERDADERO;1181;;;
109337;108124;0;16593;FALSO;VERDADERO;1213;;;
109337;108144;0;16594;FALSO;VERDADERO;1193;;;
109337;108144;0;16595;FALSO;VERDADERO;1193;;;
109337;108144;0;16596;FALSO;VERDADERO;1193;;;
109337;108164;0;16597;FALSO;VERDADERO;1173;;;
109337;108164;0;16598;FALSO;VERDADERO;1173;;;
109374;108184;0;16599;FALSO;VERDADERO;1190;;;
109374;108184;0;16600;FALSO;VERDADERO;1190;;;
109374;108184;0;16601;FALSO;VERDADERO;1190;;;
109374;108204;0;16602;FALSO;VERDADERO;1170;;;
109374;108204;0;16603;FALSO;VERDADERO;1170;;;
109404;108224;0;16604;FALSO;VERDADERO;1180;;;
109404;108224;0;16605;FALSO;VERDADERO;1180;;;
109404;108224;0;16606;FALSO;VERDADERO;1180;;;
109404;108244;0;16607;FALSO;VERDADERO;1160;;;
109404;108244;0;16608;FALSO;VERDADERO;1160;;;
109437;108264;0;16609;FALSO;VERDADERO;1173;;;
109437;108264;0;16610;FALSO;VERDADERO;1173;;;
109437;108264;0;16611;FALSO;VERDADERO;1173;;;
109437;108284;0;16612;FALSO;VERDADERO;1153;;;
109437;108284;0;16613;FALSO;VERDADERO;1153;;;
109473;108304;0;16614;FALSO;VERDADERO;1169;;;
109473;108304;0;16615;FALSO;VERDADERO;1169;;;
109473;108304;0;16616;FALSO;VERDADERO;1169;;;
109473;108324;0;16617;FALSO;VERDADERO;1149;;;
109473;108324;0;16618;FALSO;VERDADERO;1149;;;
109473;108344;1;16619;FALSO;VERDADERO;1129;;;
109508;108344;0;16620;FALSO;VERDADERO;1164;;;
109508;108344;0;16621;FALSO;VERDADERO;1164;;;
109508;108364;0;16622;FALSO;VERDADERO;1144;;;
109508;108364;0;16623;FALSO;VERDADERO;1144;;;
109508;108384;0;16624;FALSO;VERDADERO;1124;;;
109540;108384;0;16625;FALSO;VERDADERO;1156;;;
109540;108384;0;16626;FALSO;VERDADERO;1156;;;
109540;108404;0;16627;FALSO;VERDADERO;1136;;;
109540;108404;0;16628;FALSO;VERDADERO;1136;;;
109540;108424;0;16629;FALSO;VERDADERO;1116;;;
109573;108424;0;16630;FALSO;VERDADERO;1149;;;
109573;108424;0;16631;FALSO;VERDADERO;1149;;;
109573;108444;0;16632;FALSO;VERDADERO;1129;;;
109573;108444;0;16633;FALSO;VERDADERO;1129;;;
109573;108464;0;16634;FALSO;VERDADERO;1109;;;
109573;108464;0;16635;FALSO;VERDADERO;1109;;;
109609;108464;0;16636;FALSO;VERDADERO;1145;;;
109609;108978;0;16637;FALSO;VERDADERO;631;;;
109609;108978;0;16638;FALSO;VERDADERO;631;;;
109609;108998;0;16639;FALSO;VERDADERO;611;;;
109609;108998;0;16640;FALSO;VERDADERO;611;;;
109645;109018;0;16641;FALSO;VERDADERO;627;;;
109645;109018;0;16642;FALSO;VERDADERO;627;;;
109645;109018;0;16643;FALSO;VERDADERO;627;;;
109645;109038;0;16644;FALSO;VERDADERO;607;;;
109645;109038;0;16645;FALSO;VERDADERO;607;;;
109676;109058;0;16646;FALSO;VERDADERO;618;;;
109676;109058;0;16647;FALSO;VERDADERO;618;;;
109676;109058;0;16648;FALSO;VERDADERO;618;;;
109676;109078;1;16649;FALSO;VERDADERO;598;;;
109676;109078;0;16650;FALSO;VERDADERO;598;;;
109676;109098;1;16651;FALSO;VERDADERO;578;;;
109712;109098;0;16652;FALSO;VERDADERO;614;;;
109712;109098;0;16653;FALSO;VERDADERO;614;;;
109712;109118;0;16654;FALSO;VERDADERO;594;;;
109712;109118;0;16655;FALSO;VERDADERO;594;;;
109712;109138;0;16656;FALSO;VERDADERO;574;;;
109745;109138;0;16657;FALSO;VERDADERO;607;;;
109745;109138;0;16658;FALSO;VERDADERO;607;;;
109745;109158;0;16659;FALSO;VERDADERO;587;;;
109745;109158;0;16660;FALSO;VERDADERO;587;;;
109745;109178;0;16661;FALSO;VERDADERO;567;;;
109776;109178;0;16662;FALSO;VERDADERO;598;;;
109776;109178;0;16663;FALSO;VERDADERO;598;;;
109776;109198;0;16664;FALSO;VERDADERO;578;;;
109776;109198;0;16665;FALSO;VERDADERO;578;;;
109776;109218;1;16666;FALSO;VERDADERO;558;;;
109812;109218;0;16667;FALSO;VERDADERO;594;;;
109812;109218;0;16668;FALSO;VERDADERO;594;;;
109812;109238;0;16669;FALSO;VERDADERO;574;;;
109812;109238;0;16670;FALSO;VERDADERO;574;;;
109812;109258;0;16671;FALSO;VERDADERO;554;;;
109812;109258;0;16672;FALSO;VERDADERO;554;;;
109844;109258;0;16673;FALSO;VERDADERO;586;;;
109844;109278;0;16674;FALSO;VERDADERO;566;;;
109844;109278;0;16675;FALSO;VERDADERO;566;;;
109844;109298;0;16676;FALSO;VERDADERO;546;;;
109877;109298;0;16677;FALSO;VERDADERO;579;;;
109877;109318;0;16678;FALSO;VERDADERO;559;;;
109877;109318;0;16679;FALSO;VERDADERO;559;;;
109877;109318;0;16680;FALSO;VERDADERO;559;;;
109877;109338;0;16681;FALSO;VERDADERO;539;;;
109877;109338;0;16682;FALSO;VERDADERO;539;;;
109913;109358;0;16683;FALSO;VERDADERO;555;;;
109913;109358;0;16684;FALSO;VERDADERO;555;;;
109913;109358;0;16685;FALSO;VERDADERO;555;;;
109913;109378;0;16686;FALSO;VERDADERO;535;;;
109913;109378;0;16687;FALSO;VERDADERO;535;;;
109945;109398;1;16688;FALSO;VERDADERO;547;;;
109945;109398;0;16689;FALSO;VERDADERO;547;;;
109945;109398;0;16690;FALSO;VERDADERO;547;;;
109945;109418;0;16691;FALSO;VERDADERO;527;;;
109945;109418;0;16692;FALSO;VERDADERO;527;;;
109976;109438;0;16693;FALSO;VERDADERO;538;;;
109976;109438;0;16694;FALSO;VERDADERO;538;;;
109976;109438;0;16695;FALSO;VERDADERO;538;;;
109976;109458;1;16696;FALSO;VERDADERO;518;;;
109976;109458;0;16697;FALSO;VERDADERO;518;;;
109976;109478;0;16698;FALSO;VERDADERO;498;;;
110013;109478;0;16699;FALSO;VERDADERO;535;;;
110013;109478;0;16700;FALSO;VERDADERO;535;;;
110013;109498;1;16701;FALSO;VERDADERO;515;;;
110045;109518;0;16702;FALSO;VERDADERO;527;;;
110045;109538;0;16703;FALSO;VERDADERO;507;;;
110045;109538;0;16704;FALSO;VERDADERO;507;;;
110045;109538;0;16705;FALSO;VERDADERO;507;;;
110045;109558;0;16706;FALSO;VERDADERO;487;;;
110077;109558;0;16707;FALSO;VERDADERO;519;;;
110077;109578;0;16708;FALSO;VERDADERO;499;;;
110077;109578;0;16709;FALSO;VERDADERO;499;;;
110077;109578;0;16710;FALSO;VERDADERO;499;;;
110109;109598;0;16711;FALSO;VERDADERO;511;;;
110109;109598;0;16712;FALSO;VERDADERO;511;;;
110109;109618;0;16713;FALSO;VERDADERO;491;;;
110109;109618;0;16714;FALSO;VERDADERO;491;;;
110109;109618;0;16715;FALSO;VERDADERO;491;;;
110141;109638;0;16716;FALSO;VERDADERO;503;;;
110141;109638;0;16717;FALSO;VERDADERO;503;;;
110141;109658;0;16718;FALSO;VERDADERO;483;;;
110141;109658;0;16719;FALSO;VERDADERO;483;;;
110141;109658;0;16720;FALSO;VERDADERO;483;;;
110141;109678;0;16721;FALSO;VERDADERO;463;;;
110177;109678;0;16722;FALSO;VERDADERO;499;;;
110177;109698;1;16723;FALSO;VERDADERO;479;;;
110177;109698;0;16724;FALSO;VERDADERO;479;;;
110177;109698;0;16725;FALSO;VERDADERO;479;;;
110177;109718;0;16726;FALSO;VERDADERO;459;;;
110209;109718;0;16727;FALSO;VERDADERO;491;;;
110209;109738;0;16728;FALSO;VERDADERO;471;;;
110209;109738;0;16729;FALSO;VERDADERO;471;;;
110209;109738;0;16730;FALSO;VERDADERO;471;;;
110209;109758;0;16731;FALSO;VERDADERO;451;;;
110241;109758;0;16732;FALSO;VERDADERO;483;;;
110241;109778;0;16733;FALSO;VERDADERO;463;;;
110241;109778;0;16734;FALSO;VERDADERO;463;;;
110241;109778;0;16735;FALSO;VERDADERO;463;;;
110241;109798;1;16736;FALSO;VERDADERO;443;;;
110241;109798;0;16737;FALSO;VERDADERO;443;;;
110277;109818;0;16738;FALSO;VERDADERO;459;;;
110277;109818;0;16739;FALSO;VERDADERO;459;;;
110277;109838;1;16740;FALSO;VERDADERO;439;;;
110277;109838;0;16741;FALSO;VERDADERO;439;;;
110277;109838;0;16742;FALSO;VERDADERO;439;;;
110309;109858;0;16743;FALSO;VERDADERO;451;;;
110309;109858;0;16744;FALSO;VERDADERO;451;;;
110309;109878;1;16745;FALSO;VERDADERO;431;;;
110309;109878;0;16746;FALSO;VERDADERO;431;;;
110309;109878;0;16747;FALSO;VERDADERO;431;;;
110340;109898;0;16748;FALSO;VERDADERO;442;;;
110340;109898;0;16749;FALSO;VERDADERO;442;;;
110340;109918;0;16750;FALSO;VERDADERO;422;;;
110340;109918;0;16751;FALSO;VERDADERO;422;;;
110340;109918;0;16752;FALSO;VERDADERO;422;;;
110376;109938;0;16753;FALSO;VERDADERO;438;;;
110376;109938;0;16754;FALSO;VERDADERO;438;;;
110376;109958;0;16755;FALSO;VERDADERO;418;;;
110376;109958;0;16756;FALSO;VERDADERO;418;;;
110376;109978;0;16757;FALSO;VERDADERO;398;;;
110409;109978;0;16758;FALSO;VERDADERO;431;;;
110409;109978;0;16759;FALSO;VERDADERO;431;;;
110409;109998;0;16760;FALSO;VERDADERO;411;;;
110409;109998;0;16761;FALSO;VERDADERO;411;;;
110409;110018;1;16762;FALSO;VERDADERO;391;;;
110440;110018;0;16763;FALSO;VERDADERO;422;;;
110440;110018;0;16764;FALSO;VERDADERO;422;;;
110440;110038;0;16765;FALSO;VERDADERO;402;;;
110440;110038;0;16766;FALSO;VERDADERO;402;;;
110440;110058;0;16767;FALSO;VERDADERO;382;;;
110473;110058;0;16768;FALSO;VERDADERO;415;;;
110473;110058;0;16769;FALSO;VERDADERO;415;;;
110473;110078;0;16770;FALSO;VERDADERO;395;;;
110473;110078;0;16771;FALSO;VERDADERO;395;;;
110473;110098;0;16772;FALSO;VERDADERO;375;;;
110505;110098;0;16773;FALSO;VERDADERO;407;;;
110505;110098;0;16774;FALSO;VERDADERO;407;;;
110505;110118;0;16775;FALSO;VERDADERO;387;;;
110505;110118;0;16776;FALSO;VERDADERO;387;;;
110505;110138;0;16777;FALSO;VERDADERO;367;;;
110541;110138;0;16778;FALSO;VERDADERO;403;;;
110541;110158;0;16779;FALSO;VERDADERO;383;;;
110541;110158;0;16780;FALSO;VERDADERO;383;;;
110541;110158;0;16781;FALSO;VERDADERO;383;;;
110541;110178;0;16782;FALSO;VERDADERO;363;;;
110541;110178;0;16783;FALSO;VERDADERO;363;;;
110573;110178;0;16784;FALSO;VERDADERO;395;;;
110573;110198;0;16785;FALSO;VERDADERO;375;;;
110573;110198;0;16786;FALSO;VERDADERO;375;;;
110573;110218;0;16787;FALSO;VERDADERO;355;;;
110573;110218;0;16788;FALSO;VERDADERO;355;;;
110605;110218;0;16789;FALSO;VERDADERO;387;;;
110605;110238;0;16790;FALSO;VERDADERO;367;;;
110605;110238;0;16791;FALSO;VERDADERO;367;;;
110605;110258;1;16792;FALSO;VERDADERO;347;;;
110605;110258;0;16793;FALSO;VERDADERO;347;;;
110640;110258;0;16794;FALSO;VERDADERO;382;;;
110640;110278;0;16795;FALSO;VERDADERO;362;;;
110640;110278;0;16796;FALSO;VERDADERO;362;;;
110640;110298;0;16797;FALSO;VERDADERO;342;;;
110640;110298;0;16798;FALSO;VERDADERO;342;;;
110673;110318;1;16799;FALSO;VERDADERO;355;;;
110673;110318;0;16800;FALSO;VERDADERO;355;;;
110673;110318;0;16801;FALSO;VERDADERO;355;;;
110673;110338;1;16802;FALSO;VERDADERO;335;;;
110673;110338;0;16803;FALSO;VERDADERO;335;;;
110705;110358;0;16804;FALSO;VERDADERO;347;;;
110705;110358;0;16805;FALSO;VERDADERO;347;;;
110705;110358;0;16806;FALSO;VERDADERO;347;;;
110705;110378;0;16807;FALSO;VERDADERO;327;;;
110705;110378;0;16808;FALSO;VERDADERO;327;;;
110737;110398;0;16809;FALSO;VERDADERO;339;;;
110737;110398;0;16810;FALSO;VERDADERO;339;;;
110737;110398;0;16811;FALSO;VERDADERO;339;;;
110737;110418;0;16812;FALSO;VERDADERO;319;;;
110737;110418;0;16813;FALSO;VERDADERO;319;;;
110769;110438;0;16814;FALSO;VERDADERO;331;;;
110769;110438;0;16815;FALSO;VERDADERO;331;;;
110769;110438;0;16816;FALSO;VERDADERO;331;;;
110769;110458;0;16817;FALSO;VERDADERO;311;;;
110769;110458;0;16818;FALSO;VERDADERO;311;;;
110801;110478;0;16819;FALSO;VERDADERO;323;;;
110801;110478;0,00E+00;16820;FALSO;VERDADERO;323;;;
110801;110478;0;16821;FALSO;VERDADERO;323;;;
110801;110498;0;16822;FALSO;VERDADERO;303;;;
110801;110498;0;16823;FALSO;VERDADERO;303;;;
110833;110518;0;16824;FALSO;VERDADERO;315;;;
110833;110518;0;16825;FALSO;VERDADERO;315;;;
110833;110518;0;16826;FALSO;VERDADERO;315;;;
110833;110538;0;16827;FALSO;VERDADERO;295;;;
110833;110538;0;16828;FALSO;VERDADERO;295;;;
110833;110558;0;16829;FALSO;VERDADERO;275;;;
110869;110558;0;16830;FALSO;VERDADERO;311;;;
110869;110558;0;16831;FALSO;VERDADERO;311;;;
110869;110578;0;16832;FALSO;VERDADERO;291;;;
110869;110578;0;16833;FALSO;VERDADERO;291;;;
110869;110598;0;16834;FALSO;VERDADERO;271;;;
110901;110598;0;16835;FALSO;VERDADERO;303;;;
110901;110618;0;16836;FALSO;VERDADERO;283;;;
110901;110618;0;16837;FALSO;VERDADERO;283;;;
110901;110618;0;16838;FALSO;VERDADERO;283;;;
110901;110638;0;16839;FALSO;VERDADERO;263;;;
110933;110638;0;16840;FALSO;VERDADERO;295;;;
110933;110658;0;16841;FALSO;VERDADERO;275;;;
110933;110658;0;16842;FALSO;VERDADERO;275;;;
110933;110658;0;16843;FALSO;VERDADERO;275;;;
110933;110678;0;16844;FALSO;VERDADERO;255;;;
110970;110678;0;16845;FALSO;VERDADERO;292;;;
110970;110698;0;16846;FALSO;VERDADERO;272;;;
110970;110698;0;16847;FALSO;VERDADERO;272;;;
110970;110698;0;16848;FALSO;VERDADERO;272;;;
110970;110718;1;16849;FALSO;VERDADERO;252;;;
111001;110718;0;16850;FALSO;VERDADERO;283;;;
111001;110738;0;16851;FALSO;VERDADERO;263;;;
111001;110738;0;16852;FALSO;VERDADERO;263;;;
111001;110738;0;16853;FALSO;VERDADERO;263;;;
111001;110758;0;16854;FALSO;VERDADERO;243;;;
111033;110758;0;16855;FALSO;VERDADERO;275;;;
111033;110778;1;16856;FALSO;VERDADERO;255;;;
111033;110778;0;16857;FALSO;VERDADERO;255;;;
111033;110778;0;16858;FALSO;VERDADERO;255;;;
111033;110798;0;16859;FALSO;VERDADERO;235;;;
111033;110798;0;16860;FALSO;VERDADERO;235;;;
111068;110798;0;16861;FALSO;VERDADERO;270;;;
111068;110798;0;16862;FALSO;VERDADERO;270;;;
111068;110798;0;16863;FALSO;VERDADERO;270;;;
111068;110798;0;16864;FALSO;VERDADERO;270;;;
111068;110798;0;16865;FALSO;VERDADERO;270;;;
111068;110798;0;16866;FALSO;VERDADERO;270;;;
111104;110798;0;16867;FALSO;VERDADERO;306;;;
111104;110798;0;16868;FALSO;VERDADERO;306;;;
111104;110798;0;16869;FALSO;VERDADERO;306;;;
111104;110798;0;16870;FALSO;VERDADERO;306;;;
111104;110798;0;16871;FALSO;VERDADERO;306;;;
111137;110798;0;16872;FALSO;VERDADERO;339;;;
111137;110798;0;16873;FALSO;VERDADERO;339;;;
111137;110798;0;16874;FALSO;VERDADERO;339;;;
111137;110798;0;16875;FALSO;VERDADERO;339;;;
111137;110798;0;16876;FALSO;VERDADERO;339;;;
111168;110798;0;16877;FALSO;VERDADERO;370;;;
111168;110798;0;16878;FALSO;VERDADERO;370;;;
111168;110798;0;16879;FALSO;VERDADERO;370;;;
111168;110798;0;16880;FALSO;VERDADERO;370;;;
111168;110798;0;16881;FALSO;VERDADERO;370;;;
111168;110798;0;16882;FALSO;VERDADERO;370;;;
111205;110798;0;16883;FALSO;VERDADERO;407;;;
111205;110798;0;16884;FALSO;VERDADERO;407;;;
111205;110798;0;16885;FALSO;VERDADERO;407;;;
111205;110798;0;16886;FALSO;VERDADERO;407;;;
111205;110798;0;16887;FALSO;VERDADERO;407;;;
111205;110798;0;16888;FALSO;VERDADERO;407;;;
111237;110798;0;16889;FALSO;VERDADERO;439;;;
111237;110798;0;16890;FALSO;VERDADERO;439;;;
111237;110798;0;16891;FALSO;VERDADERO;439;;;
111237;110798;0;16892;FALSO;VERDADERO;439;;;
111237;110798;0;16893;FALSO;VERDADERO;439;;;
111269;110798;0;16894;FALSO;VERDADERO;471;;;
111269;110798;0;16895;FALSO;VERDADERO;471;;;
111269;110798;0;16896;FALSO;VERDADERO;471;;;
111269;110798;0;16897;FALSO;VERDADERO;471;;;
111269;110798;0;16898;FALSO;VERDADERO;471;;;
111269;110798;0;16899;FALSO;VERDADERO;471;;;
111304;110798;0;16900;FALSO;VERDADERO;506;;;
111304;110798;0;16901;FALSO;VERDADERO;506;;;
111304;110798;0;16902;FALSO;VERDADERO;506;;;
111304;110798;0;16903;FALSO;VERDADERO;506;;;
111304;110798;0;16904;FALSO;VERDADERO;506;;;
111336;110798;0;16905;FALSO;VERDADERO;538;;;
111336;110798;0;16906;FALSO;VERDADERO;538;;;
111336;110798;0;16907;FALSO;VERDADERO;538;;;
111336;110798;0;16908;FALSO;VERDADERO;538;;;
111336;110798;0;16909;FALSO;VERDADERO;538;;;
111368;110798;0;16910;FALSO;VERDADERO;570;;;
111368;110798;0;16911;FALSO;VERDADERO;570;;;
111368;110798;0;16912;FALSO;VERDADERO;570;;;
111368;110798;0;16913;FALSO;VERDADERO;570;;;
111368;110798;0;16914;FALSO;VERDADERO;570;;;
111368;110798;0;16915;FALSO;VERDADERO;570;;;
111404;110798;0;16916;FALSO;VERDADERO;606;;;
111404;110798;0;16917;FALSO;VERDADERO;606;;;
111404;110798;0;16918;FALSO;VERDADERO;606;;;
111404;110798;0;16919;FALSO;VERDADERO;606;;;
111404;110798;0;16920;FALSO;VERDADERO;606;;;
111404;110798;0;16921;FALSO;VERDADERO;606;;;
111436;110798;0;16922;FALSO;VERDADERO;638;;;
111436;110798;0;16923;FALSO;VERDADERO;638;;;
111436;110798;0;16924;FALSO;VERDADERO;638;;;
111436;110798;0;16925;FALSO;VERDADERO;638;;;
111436;110798;0;16926;FALSO;VERDADERO;638;;;
111436;110798;0;16927;FALSO;VERDADERO;638;;;
111472;110798;0;16928;FALSO;VERDADERO;674;;;
111472;110798;0;16929;FALSO;VERDADERO;674;;;
111472;110798;0;16930;FALSO;VERDADERO;674;;;
111472;110798;0;16931;FALSO;VERDADERO;674;;;
111472;110798;0;16932;FALSO;VERDADERO;674;;;
111505;110798;0;16933;FALSO;VERDADERO;707;;;
111505;110798;0;16934;FALSO;VERDADERO;707;;;
111505;110798;0;16935;FALSO;VERDADERO;707;;;
111505;110798;0;16936;FALSO;VERDADERO;707;;;
111505;110798;0;16937;FALSO;VERDADERO;707;;;
111537;110798;0;16938;FALSO;VERDADERO;739;;;
111537;110798;0;16939;FALSO;VERDADERO;739;;;
111537;110798;0;16940;FALSO;VERDADERO;739;;;
111537;110798;0;16941;FALSO;VERDADERO;739;;;
111537;110798;0;16942;FALSO;VERDADERO;739;;;
111537;110798;0;16943;FALSO;VERDADERO;739;;;
111573;110798;0;16944;FALSO;VERDADERO;775;;;
111573;110798;0;16945;FALSO;VERDADERO;775;;;
111573;110798;0;16946;FALSO;VERDADERO;775;;;
111573;110798;0;16947;FALSO;VERDADERO;775;;;
111573;110798;0;16948;FALSO;VERDADERO;775;;;
111573;110798;0;16949;FALSO;VERDADERO;775;;;
111605;110798;0;16950;FALSO;VERDADERO;807;;;
111605;110798;0;16951;FALSO;VERDADERO;807;;;
111605;110798;0;16952;FALSO;VERDADERO;807;;;
111605;110798;0;16953;FALSO;VERDADERO;807;;;
111605;110798;0;16954;FALSO;VERDADERO;807;;;
111637;110798;0;16955;FALSO;VERDADERO;839;;;
111637;110798;0;16956;FALSO;VERDADERO;839;;;
111637;110798;0;16957;FALSO;VERDADERO;839;;;
111637;110798;0;16958;FALSO;VERDADERO;839;;;
111637;110798;0;16959;FALSO;VERDADERO;839;;;
111637;110798;0;16960;FALSO;VERDADERO;839;;;
111673;110798;0;16961;FALSO;VERDADERO;875;;;
111673;110798;0;16962;FALSO;VERDADERO;875;;;
111673;110798;0;16963;FALSO;VERDADERO;875;;;
111673;110798;0;16964;FALSO;VERDADERO;875;;;
111673;110798;0;16965;FALSO;VERDADERO;875;;;
111704;110798;0;16966;FALSO;VERDADERO;906;;;
111704;110798;0;16967;FALSO;VERDADERO;906;;;
111704;110798;0;16968;FALSO;VERDADERO;906;;;
111704;110798;0;16969;FALSO;VERDADERO;906;;;
111704;110798;0;16970;FALSO;VERDADERO;906;;;
111737;110798;0;16971;FALSO;VERDADERO;939;;;
111737;110798;0;16972;FALSO;VERDADERO;939;;;
111737;110798;0;16973;FALSO;VERDADERO;939;;;
111737;110798;0;16974;FALSO;VERDADERO;939;;;
111737;110798;0;16975;FALSO;VERDADERO;939;;;
111737;110798;0;16976;FALSO;VERDADERO;939;;;
111772;110798;0;16977;FALSO;VERDADERO;974;;;
111772;110798;0;16978;FALSO;VERDADERO;974;;;
111772;110798;0;16979;FALSO;VERDADERO;974;;;
111772;110798;0;16980;FALSO;VERDADERO;974;;;
111772;110798;0;16981;FALSO;VERDADERO;974;;;
111805;110798;0;16982;FALSO;VERDADERO;1007;;;
111805;110798;0;16983;FALSO;VERDADERO;1007;;;
111805;110798;0;16984;FALSO;VERDADERO;1007;;;
111805;110798;0;16985;FALSO;VERDADERO;1007;;;
111805;110798;0;16986;FALSO;VERDADERO;1007;;;
111805;110798;0;16987;FALSO;VERDADERO;1007;;;
111837;110798;0;16988;FALSO;VERDADERO;1039;;;
111837;110798;0;16989;FALSO;VERDADERO;1039;;;
111837;110798;0;16990;FALSO;VERDADERO;1039;;;
111837;110798;0;16991;FALSO;VERDADERO;1039;;;
111837;110798;0;16992;FALSO;VERDADERO;1039;;;
111837;110798;0;16993;FALSO;VERDADERO;1039;;;
111873;110798;0;16994;FALSO;VERDADERO;1075;;;
111873;110798;0;16995;FALSO;VERDADERO;1075;;;
111873;110798;0;16996;FALSO;VERDADERO;1075;;;
111873;110818;0;16997;FALSO;VERDADERO;1055;;;
111873;110818;0;16998;FALSO;VERDADERO;1055;;;
111904;110818;0;16999;FALSO;VERDADERO;1086;;;
111904;110838;0;17000;FALSO;VERDADERO;1066;;;
111904;110838;0;17001;FALSO;VERDADERO;1066;;;
111904;110858;0;17002;FALSO;VERDADERO;1046;;;
111904;110858;0;17003;FALSO;VERDADERO;1046;;;
111936;110858;0;17004;FALSO;VERDADERO;1078;;;
111936;110878;0;17005;FALSO;VERDADERO;1058;;;
111936;110878;0;17006;FALSO;VERDADERO;1058;;;
111936;110898;1;17007;FALSO;VERDADERO;1038;;;
111936;110898;0;17008;FALSO;VERDADERO;1038;;;
111968;110898;0;17009;FALSO;VERDADERO;1070;;;
111968;110918;0;17010;FALSO;VERDADERO;1050;;;
111968;110918;0;17011;FALSO;VERDADERO;1050;;;
111968;110938;0;17012;FALSO;VERDADERO;1030;;;
111968;110938;0;17013;FALSO;VERDADERO;1030;;;
112001;110938;0;17014;FALSO;VERDADERO;1063;;;
112001;110958;0;17015;FALSO;VERDADERO;1043;;;
112001;110958;0;17016;FALSO;VERDADERO;1043;;;
112001;110978;0;17017;FALSO;VERDADERO;1023;;;
112001;110978;0;17018;FALSO;VERDADERO;1023;;;
112001;110978;0;17019;FALSO;VERDADERO;1023;;;
112037;110998;0;17020;FALSO;VERDADERO;1039;;;
112037;110998;0;17021;FALSO;VERDADERO;1039;;;
112037;111018;0;17022;FALSO;VERDADERO;1019;;;
112037;111018;0;17023;FALSO;VERDADERO;1019;;;
112037;111018;0;17024;FALSO;VERDADERO;1019;;;
112069;111038;0;17025;FALSO;VERDADERO;1031;;;
112069;111038;0;17026;FALSO;VERDADERO;1031;;;
112069;111058;1;17027;FALSO;VERDADERO;1011;;;
112069;111058;0;17028;FALSO;VERDADERO;1011;;;
112069;111058;0;17029;FALSO;VERDADERO;1011;;;
112101;111078;1;17030;FALSO;VERDADERO;1023;;;
112101;111078;0;17031;FALSO;VERDADERO;1023;;;
112101;111098;0;17032;FALSO;VERDADERO;1003;;;
112101;111098;0;17033;FALSO;VERDADERO;1003;;;
112101;111118;1;17034;FALSO;VERDADERO;983;;;
112101;111118;0;17035;FALSO;VERDADERO;983;;;
112142;111118;0;17036;FALSO;VERDADERO;1024;;;
112142;111138;0;17037;FALSO;VERDADERO;1004;;;
112142;111138;0;17038;FALSO;VERDADERO;1004;;;
112142;111138;0;17039;FALSO;VERDADERO;1004;;;
112169;111158;0;17040;FALSO;VERDADERO;1011;;;
112169;111158;0;17041;FALSO;VERDADERO;1011;;;
112169;111178;1;17042;FALSO;VERDADERO;991;;;
112169;111178;0;17043;FALSO;VERDADERO;991;;;
112169;111198;1;17044;FALSO;VERDADERO;971;;;
112201;111198;0;17045;FALSO;VERDADERO;1003;;;
112201;111198;0;17046;FALSO;VERDADERO;1003;;;
112201;111218;0;17047;FALSO;VERDADERO;983;;;
112201;111218;0;17048;FALSO;VERDADERO;983;;;
112201;111238;1;17049;FALSO;VERDADERO;963;;;
112236;111238;0;17050;FALSO;VERDADERO;998;;;
112236;111238;0;17051;FALSO;VERDADERO;998;;;
112236;111258;0;17052;FALSO;VERDADERO;978;;;
112236;111258;0;17053;FALSO;VERDADERO;978;;;
112236;111278;0;17054;FALSO;VERDADERO;958;;;
112236;111278;0;17055;FALSO;VERDADERO;958;;;
112236;111278;0;17056;FALSO;VERDADERO;958;;;
112277;111298;0;17057;FALSO;VERDADERO;979;;;
112277;111298;0;17058;FALSO;VERDADERO;979;;;
112277;111318;0;17059;FALSO;VERDADERO;959;;;
112277;111318;0;17060;FALSO;VERDADERO;959;;;
112305;111338;0;17061;FALSO;VERDADERO;967;;;
112305;111338;0;17062;FALSO;VERDADERO;967;;;
112305;111338;0;17063;FALSO;VERDADERO;967;;;
112305;111358;0;17064;FALSO;VERDADERO;947;;;
112305;111358;0;17065;FALSO;VERDADERO;947;;;
112336;111378;0;17066;FALSO;VERDADERO;958;;;
112336;111378;0;17067;FALSO;VERDADERO;958;;;
112336;111378;0;17068;FALSO;VERDADERO;958;;;
112336;111398;0;17069;FALSO;VERDADERO;938;;;
112336;111398;0;17070;FALSO;VERDADERO;938;;;
112368;111418;0;17071;FALSO;VERDADERO;950;;;
112368;111418;0;17072;FALSO;VERDADERO;950;;;
112368;111418;0;17073;FALSO;VERDADERO;950;;;
112368;111438;0;17074;FALSO;VERDADERO;930;;;
112368;111438;0;17075;FALSO;VERDADERO;930;;;
112402;111458;0;17076;FALSO;VERDADERO;944;;;
112402;111458;0;17077;FALSO;VERDADERO;944;;;
112402;111478;0;17078;FALSO;VERDADERO;924;;;
112402;111478;0;17079;FALSO;VERDADERO;924;;;
112402;111478;0;17080;FALSO;VERDADERO;924;;;
112402;111498;0;17081;FALSO;VERDADERO;904;;;
112437;111498;0;17082;FALSO;VERDADERO;939;;;
112437;111518;0;17083;FALSO;VERDADERO;919;;;
112437;111518;0;17084;FALSO;VERDADERO;919;;;
112437;111538;0;17085;FALSO;VERDADERO;899;;;
112469;111538;0;17086;FALSO;VERDADERO;931;;;
112469;111538;0;17087;FALSO;VERDADERO;931;;;
112469;111558;0;17088;FALSO;VERDADERO;911;;;
112469;111558;0;17089;FALSO;VERDADERO;911;;;
112469;111578;0;17090;FALSO;VERDADERO;891;;;
112501;111578;0;17091;FALSO;VERDADERO;923;;;
112501;111578;0;17092;FALSO;VERDADERO;923;;;
112501;111598;0;17093;FALSO;VERDADERO;903;;;
112501;111598;0;17094;FALSO;VERDADERO;903;;;
112501;111618;0;17095;FALSO;VERDADERO;883;;;
112501;111618;0;17096;FALSO;VERDADERO;883;;;
112537;111618;0;17097;FALSO;VERDADERO;919;;;
112537;111638;0;17098;FALSO;VERDADERO;899;;;
112537;111638;0;17099;FALSO;VERDADERO;899;;;
112537;111658;0;17100;FALSO;VERDADERO;879;;;
112564;111658;0;17101;FALSO;VERDADERO;906;;;
112564;111658;0;17102;FALSO;VERDADERO;906;;;
112564;111678;1;17103;FALSO;VERDADERO;886;;;
112564;111678;0;17104;FALSO;VERDADERO;886;;;
112564;111975;0;17105;FALSO;VERDADERO;589;;;
112564;111975;0;17106;FALSO;VERDADERO;589;;;
112601;111975;0;17107;FALSO;VERDADERO;626;;;
112601;111995;0;17108;FALSO;VERDADERO;606;;;
112601;111995;0;17109;FALSO;VERDADERO;606;;;
112601;112015;0;17110;FALSO;VERDADERO;586;;;
112601;112015;0;17111;FALSO;VERDADERO;586;;;
112633;112035;0;17112;FALSO;VERDADERO;598;;;
112633;112035;0;17113;FALSO;VERDADERO;598;;;
112633;112035;0;17114;FALSO;VERDADERO;598;;;
112633;112055;0;17115;FALSO;VERDADERO;578;;;
112633;112055;0;17116;FALSO;VERDADERO;578;;;
112668;112075;0;17117;FALSO;VERDADERO;593;;;
112668;112075;0;17118;FALSO;VERDADERO;593;;;
112668;112075;0;17119;FALSO;VERDADERO;593;;;
112668;112095;0;17120;FALSO;VERDADERO;573;;;
112668;112095;0;17121;FALSO;VERDADERO;573;;;
112701;112115;0;17122;FALSO;VERDADERO;586;;;
112701;112115;0;17123;FALSO;VERDADERO;586;;;
112701;112115;0;17124;FALSO;VERDADERO;586;;;
112701;112135;1;17125;FALSO;VERDADERO;566;;;
112701;112135;0;17126;FALSO;VERDADERO;566;;;
112701;112155;1;17127;FALSO;VERDADERO;546;;;
112737;112155;0;17128;FALSO;VERDADERO;582;;;
112737;112175;0;17129;FALSO;VERDADERO;562;;;
112737;112175;0;17130;FALSO;VERDADERO;562;;;
112737;112175;0;17131;FALSO;VERDADERO;562;;;
112737;112195;1;17132;FALSO;VERDADERO;542;;;
112769;112195;0;17133;FALSO;VERDADERO;574;;;
112769;112215;0;17134;FALSO;VERDADERO;554;;;
112769;112215;0;17135;FALSO;VERDADERO;554;;;
112769;112215;0;17136;FALSO;VERDADERO;554;;;
112769;112235;0;17137;FALSO;VERDADERO;534;;;
112805;112235;0;17138;FALSO;VERDADERO;570;;;
112805;112255;0;17139;FALSO;VERDADERO;550;;;
112805;112255;0;17140;FALSO;VERDADERO;550;;;
112805;112255;0;17141;FALSO;VERDADERO;550;;;
112805;112275;0;17142;FALSO;VERDADERO;530;;;
112805;112275;0;17143;FALSO;VERDADERO;530;;;
112841;112295;0;17144;FALSO;VERDADERO;546;;;
112841;112295;0;17145;FALSO;VERDADERO;546;;;
112841;112295;0;17146;FALSO;VERDADERO;546;;;
112841;112315;1;17147;FALSO;VERDADERO;526;;;
112841;112315;0;17148;FALSO;VERDADERO;526;;;
112873;112335;0;17149;FALSO;VERDADERO;538;;;
112873;112335;0;17150;FALSO;VERDADERO;538;;;
112873;112335;0;17151;FALSO;VERDADERO;538;;;
112873;112355;0;17152;FALSO;VERDADERO;518;;;
112873;112355;0;17153;FALSO;VERDADERO;518;;;
112905;112375;0;17154;FALSO;VERDADERO;530;;;
112905;112375;0;17155;FALSO;VERDADERO;530;;;
112905;112375;0;17156;FALSO;VERDADERO;530;;;
112905;112395;0;17157;FALSO;VERDADERO;510;;;
112905;112395;0;17158;FALSO;VERDADERO;510;;;
112937;112415;1;17159;FALSO;VERDADERO;522;;;
112937;112415;0;17160;FALSO;VERDADERO;522;;;
112937;112415;0;17161;FALSO;VERDADERO;522;;;
112937;112435;0;17162;FALSO;VERDADERO;502;;;
112937;112435;0;17163;FALSO;VERDADERO;502;;;
112970;112455;0;17164;FALSO;VERDADERO;515;;;
112970;112455;0;17165;FALSO;VERDADERO;515;;;
112970;112455;0;17166;FALSO;VERDADERO;515;;;
112970;112475;1;17167;FALSO;VERDADERO;495;;;
112970;112475;0;17168;FALSO;VERDADERO;495;;;
113001;112495;0;17169;FALSO;VERDADERO;506;;;
113001;112495;0;17170;FALSO;VERDADERO;506;;;
113001;112495;0;17171;FALSO;VERDADERO;506;;;
113001;112515;0;17172;FALSO;VERDADERO;486;;;
113001;112515;0;17173;FALSO;VERDADERO;486;;;
113001;112535;0;17174;FALSO;VERDADERO;466;;;
113037;112535;0;17175;FALSO;VERDADERO;502;;;
113037;112535;0;17176;FALSO;VERDADERO;502;;;
113037;112555;0;17177;FALSO;VERDADERO;482;;;
113037;112555;0;17178;FALSO;VERDADERO;482;;;
113037;112575;0;17179;FALSO;VERDADERO;462;;;
113069;112575;0;17180;FALSO;VERDADERO;494;;;
113069;112595;1;17181;FALSO;VERDADERO;474;;;
113069;112595;0;17182;FALSO;VERDADERO;474;;;
113069;112595;0;17183;FALSO;VERDADERO;474;;;
113069;112615;1;17184;FALSO;VERDADERO;454;;;
113102;112615;0;17185;FALSO;VERDADERO;487;;;
113102;112635;0;17186;FALSO;VERDADERO;467;;;
113102;112635;0;17187;FALSO;VERDADERO;467;;;
113102;112635;0;17188;FALSO;VERDADERO;467;;;
113102;112655;0;17189;FALSO;VERDADERO;447;;;
113132;112655;0;17190;FALSO;VERDADERO;477;;;
113132;112675;0;17191;FALSO;VERDADERO;457;;;
113132;112675;0;17192;FALSO;VERDADERO;457;;;
113132;112675;0;17193;FALSO;VERDADERO;457;;;
113132;112695;0;17194;FALSO;VERDADERO;437;;;
113165;112695;0;17195;FALSO;VERDADERO;470;;;
113165;112715;0;17196;FALSO;VERDADERO;450;;;
113165;112715;0;17197;FALSO;VERDADERO;450;;;
113165;112715;0;17198;FALSO;VERDADERO;450;;;
113165;112735;0;17199;FALSO;VERDADERO;430;;;
113196;112735;0;17200;FALSO;VERDADERO;461;;;
113196;112755;0;17201;FALSO;VERDADERO;441;;;
113196;112755;0;17202;FALSO;VERDADERO;441;;;
113196;112755;0;17203;FALSO;VERDADERO;441;;;
113196;112775;0;17204;FALSO;VERDADERO;421;;;
113228;112775;0;17205;FALSO;VERDADERO;453;;;
113228;112795;0;17206;FALSO;VERDADERO;433;;;
113228;112795;0;17207;FALSO;VERDADERO;433;;;
113228;112795;0;17208;FALSO;VERDADERO;433;;;
113228;112815;1;17209;FALSO;VERDADERO;413;;;
113264;112815;0;17210;FALSO;VERDADERO;449;;;
113264;112835;0;17211;FALSO;VERDADERO;429;;;
113264;112835;0;17212;FALSO;VERDADERO;429;;;
113264;112855;0;17213;FALSO;VERDADERO;409;;;
113264;112855;0;17214;FALSO;VERDADERO;409;;;
113297;112855;0;17215;FALSO;VERDADERO;442;;;
113297;112875;0;17216;FALSO;VERDADERO;422;;;
113297;112875;0;17217;FALSO;VERDADERO;422;;;
113297;112895;0;17218;FALSO;VERDADERO;402;;;
113297;112895;0;17219;FALSO;VERDADERO;402;;;
113297;112895;0;17220;FALSO;VERDADERO;402;;;
113297;112915;1;17221;FALSO;VERDADERO;382;;;
113338;112915;0;17222;FALSO;VERDADERO;423;;;
113338;112935;0;17223;FALSO;VERDADERO;403;;;
113338;112935;0;17224;FALSO;VERDADERO;403;;;
113338;112935;0;17225;FALSO;VERDADERO;403;;;
113365;112955;0;17226;FALSO;VERDADERO;410;;;
113365;112955;0;17227;FALSO;VERDADERO;410;;;
113365;112975;0;17228;FALSO;VERDADERO;390;;;
113365;112975;0;17229;FALSO;VERDADERO;390;;;
113365;112975;0;17230;FALSO;VERDADERO;390;;;
113397;112995;1;17231;FALSO;VERDADERO;402;;;
113397;112995;0;17232;FALSO;VERDADERO;402;;;
113397;113015;0;17233;FALSO;VERDADERO;382;;;
113397;113015;0;17234;FALSO;VERDADERO;382;;;
113397;113015;0;17235;FALSO;VERDADERO;382;;;
113397;113035;1;17236;FALSO;VERDADERO;362;;;
113433;113035;0;17237;FALSO;VERDADERO;398;;;
113433;113055;0;17238;FALSO;VERDADERO;378;;;
113433;113055;0;17239;FALSO;VERDADERO;378;;;
113433;113055;0;17240;FALSO;VERDADERO;378;;;
113433;113075;0;17241;FALSO;VERDADERO;358;;;
113469;113075;0;17242;FALSO;VERDADERO;394;;;
113469;113095;0;17243;FALSO;VERDADERO;374;;;
113469;113095;0;17244;FALSO;VERDADERO;374;;;
113469;113095;0;17245;FALSO;VERDADERO;374;;;
113469;113115;0;17246;FALSO;VERDADERO;354;;;
113469;113115;0;17247;FALSO;VERDADERO;354;;;
113501;113135;0;17248;FALSO;VERDADERO;366;;;
113501;113135;0;17249;FALSO;VERDADERO;366;;;
113501;113135;0;17250;FALSO;VERDADERO;366;;;
113501;113155;1;17251;FALSO;VERDADERO;346;;;
113532;113155;0;17252;FALSO;VERDADERO;377;;;
113532;113175;0;17253;FALSO;VERDADERO;357;;;
113532;113175;0;17254;FALSO;VERDADERO;357;;;
113532;113175;0;17255;FALSO;VERDADERO;357;;;
113532;113195;0;17256;FALSO;VERDADERO;337;;;
113532;113195;0;17257;FALSO;VERDADERO;337;;;
113568;113215;0;17258;FALSO;VERDADERO;353;;;
113568;113215;0;17259;FALSO;VERDADERO;353;;;
113568;113215;0;17260;FALSO;VERDADERO;353;;;
113568;113235;1;17261;FALSO;VERDADERO;333;;;
113568;113235;0;17262;FALSO;VERDADERO;333;;;
113601;113255;0;17263;FALSO;VERDADERO;346;;;
113601;113255;0;17264;FALSO;VERDADERO;346;;;
113601;113255;0;17265;FALSO;VERDADERO;346;;;
113601;113275;0;17266;FALSO;VERDADERO;326;;;
113601;113275;0;17267;FALSO;VERDADERO;326;;;
113633;113296;0;17268;FALSO;VERDADERO;337;;;
113633;113296;0;17269;FALSO;VERDADERO;337;;;
113633;113296;0;17270;FALSO;VERDADERO;337;;;
113633;113316;1;17271;FALSO;VERDADERO;317;;;
113633;113316;0;17272;FALSO;VERDADERO;317;;;
113633;113336;0;17273;FALSO;VERDADERO;297;;;
113669;113336;0;17274;FALSO;VERDADERO;333;;;
113669;113336;0;17275;FALSO;VERDADERO;333;;;
113669;113356;0;17276;FALSO;VERDADERO;313;;;
113669;113356;0;17277;FALSO;VERDADERO;313;;;
113669;113376;0;17278;FALSO;VERDADERO;293;;;
113700;113376;0;17279;FALSO;VERDADERO;324;;;
113700;113396;0;17280;FALSO;VERDADERO;304;;;
113700;113396;0;17281;FALSO;VERDADERO;304;;;
113700;113396;0;17282;FALSO;VERDADERO;304;;;
113700;113416;0;17283;FALSO;VERDADERO;284;;;
113733;113416;0;17284;FALSO;VERDADERO;317;;;
113733;113436;0;17285;FALSO;VERDADERO;297;;;
113733;113436;0;17286;FALSO;VERDADERO;297;;;
113733;113456;0;17287;FALSO;VERDADERO;277;;;
113733;113456;0;17288;FALSO;VERDADERO;277;;;
113765;113456;0;17289;FALSO;VERDADERO;309;;;
113765;113476;0;17290;FALSO;VERDADERO;289;;;
113765;113476;0;17291;FALSO;VERDADERO;289;;;
113765;113496;1;17292;FALSO;VERDADERO;269;;;
113765;113496;0;17293;FALSO;VERDADERO;269;;;
113797;113496;0;17294;FALSO;VERDADERO;301;;;
113797;113516;0;17295;FALSO;VERDADERO;281;;;
113797;113516;0;17296;FALSO;VERDADERO;281;;;
113797;113536;0;17297;FALSO;VERDADERO;261;;;
113797;113536;0;17298;FALSO;VERDADERO;261;;;
113833;113536;0;17299;FALSO;VERDADERO;297;;;
113833;113556;0;17300;FALSO;VERDADERO;277;;;
113833;113556;0;17301;FALSO;VERDADERO;277;;;
113833;113576;1;17302;FALSO;VERDADERO;257;;;
113833;113576;0;17303;FALSO;VERDADERO;257;;;
113864;113576;0;17304;FALSO;VERDADERO;288;;;
113864;113596;0;17305;FALSO;VERDADERO;268;;;
113864;113596;0;17306;FALSO;VERDADERO;268;;;
113864;113616;1;17307;FALSO;VERDADERO;248;;;
113864;113616;0;17308;FALSO;VERDADERO;248;;;
113864;113616;0;17309;FALSO;VERDADERO;248;;;
113900;113636;0;17310;FALSO;VERDADERO;264;;;
113900;113636;0;17311;FALSO;VERDADERO;264;;;
113900;113656;1;17312;FALSO;VERDADERO;244;;;
113900;113656;0;17313;FALSO;VERDADERO;244;;;
113900;113676;0;17314;FALSO;VERDADERO;224;;;
113933;113676;0;17315;FALSO;VERDADERO;257;;;
113933;113676;0;17316;FALSO;VERDADERO;257;;;
113933;113696;0;17317;FALSO;VERDADERO;237;;;
113933;113696;0;17318;FALSO;VERDADERO;237;;;
113933;113716;0;17319;FALSO;VERDADERO;217;;;
113969;113716;0;17320;FALSO;VERDADERO;253;;;
113969;113716;0;17321;FALSO;VERDADERO;253;;;
113969;113736;0;17322;FALSO;VERDADERO;233;;;
113969;113736;0;17323;FALSO;VERDADERO;233;;;
113969;113756;0;17324;FALSO;VERDADERO;213;;;
114000;113756;0;17325;FALSO;VERDADERO;244;;;
114000;113756;0;17326;FALSO;VERDADERO;244;;;
114000;113776;0;17327;FALSO;VERDADERO;224;;;
114000;113776;0;17328;FALSO;VERDADERO;224;;;
114000;113796;0;17329;FALSO;VERDADERO;204;;;
114033;113796;0;17330;FALSO;VERDADERO;237;;;
114033;113796;0;17331;FALSO;VERDADERO;237;;;
114033;113816;0;17332;FALSO;VERDADERO;217;;;
114033;113816;0;17333;FALSO;VERDADERO;217;;;
114033;113836;0;17334;FALSO;VERDADERO;197;;;
114033;113836;0;17335;FALSO;VERDADERO;197;;;
114069;113836;0;17336;FALSO;VERDADERO;233;;;
114069;113856;0;17337;FALSO;VERDADERO;213;;;
114069;113856;0;17338;FALSO;VERDADERO;213;;;
114069;113856;0;17339;FALSO;VERDADERO;213;;;
114069;113856;0;17340;FALSO;VERDADERO;213;;;
114069;113856;0;17341;FALSO;VERDADERO;213;;;
114105;113856;0;17342;FALSO;VERDADERO;249;;;
114105;113856;0;17343;FALSO;VERDADERO;249;;;
114105;113856;0;17344;FALSO;VERDADERO;249;;;
114105;113856;0;17345;FALSO;VERDADERO;249;;;
114105;113856;0;17346;FALSO;VERDADERO;249;;;
114137;113856;0;17347;FALSO;VERDADERO;281;;;
114137;113856;0;17348;FALSO;VERDADERO;281;;;
114137;113856;0;17349;FALSO;VERDADERO;281;;;
114137;113856;0;17350;FALSO;VERDADERO;281;;;
114137;113856;0;17351;FALSO;VERDADERO;281;;;
114137;113856;0;17352;FALSO;VERDADERO;281;;;
114169;113856;0;17353;FALSO;VERDADERO;313;;;
114169;113856;0;17354;FALSO;VERDADERO;313;;;
114169;113856;0;17355;FALSO;VERDADERO;313;;;
114169;113856;0;17356;FALSO;VERDADERO;313;;;
114169;113856;0;17357;FALSO;VERDADERO;313;;;
114169;113856;0;17358;FALSO;VERDADERO;313;;;
114205;113856;0;17359;FALSO;VERDADERO;349;;;
114205;113856;0;17360;FALSO;VERDADERO;349;;;
114205;113856;0;17361;FALSO;VERDADERO;349;;;
114205;113856;0;17362;FALSO;VERDADERO;349;;;
114205;113856;0;17363;FALSO;VERDADERO;349;;;
114237;113856;0;17364;FALSO;VERDADERO;381;;;
114237;113856;0;17365;FALSO;VERDADERO;381;;;
114237;113856;0;17366;FALSO;VERDADERO;381;;;
114237;113856;0;17367;FALSO;VERDADERO;381;;;
114237;113856;0;17368;FALSO;VERDADERO;381;;;
114269;113856;0;17369;FALSO;VERDADERO;413;;;
114269;113856;0;17370;FALSO;VERDADERO;413;;;
114269;113856;0;17371;FALSO;VERDADERO;413;;;
114269;113856;0;17372;FALSO;VERDADERO;413;;;
114269;113856;0;17373;FALSO;VERDADERO;413;;;
114269;113856;0;17374;FALSO;VERDADERO;413;;;
114305;113856;0;17375;FALSO;VERDADERO;449;;;
114305;113856;0;17376;FALSO;VERDADERO;449;;;
114305;113856;0;17377;FALSO;VERDADERO;449;;;
114305;113856;0;17378;FALSO;VERDADERO;449;;;
114305;113856;0;17379;FALSO;VERDADERO;449;;;
114305;113856;0;17380;FALSO;VERDADERO;449;;;
114336;113856;0;17381;FALSO;VERDADERO;480;;;
114336;113856;0;17382;FALSO;VERDADERO;480;;;
114336;113856;0;17383;FALSO;VERDADERO;480;;;
114336;113856;0;17384;FALSO;VERDADERO;480;;;
114336;113856;0;17385;FALSO;VERDADERO;480;;;
114368;113856;0;17386;FALSO;VERDADERO;512;;;
114368;113856;0;17387;FALSO;VERDADERO;512;;;
114368;113856;0;17388;FALSO;VERDADERO;512;;;
114368;113856;0;17389;FALSO;VERDADERO;512;;;
114368;113856;0;17390;FALSO;VERDADERO;512;;;
114368;113856;0;17391;FALSO;VERDADERO;512;;;
114404;113856;0;17392;FALSO;VERDADERO;548;;;
114404;113856;0;17393;FALSO;VERDADERO;548;;;
114404;113856;0;17394;FALSO;VERDADERO;548;;;
114404;113856;0;17395;FALSO;VERDADERO;548;;;
114404;113856;0;17396;FALSO;VERDADERO;548;;;
114437;113856;0;17397;FALSO;VERDADERO;581;;;
114437;113856;0;17398;FALSO;VERDADERO;581;;;
114437;113856;0;17399;FALSO;VERDADERO;581;;;
114437;113856;0;17400;FALSO;VERDADERO;581;;;
114437;113856;0;17401;FALSO;VERDADERO;581;;;
114437;113856;0;17402;FALSO;VERDADERO;581;;;
114469;113856;0;17403;FALSO;VERDADERO;613;;;
114469;113856;0;17404;FALSO;VERDADERO;613;;;
114469;113856;0;17405;FALSO;VERDADERO;613;;;
114469;113856;0;17406;FALSO;VERDADERO;613;;;
114469;113856;0;17407;FALSO;VERDADERO;613;;;
114501;113856;0;17408;FALSO;VERDADERO;645;;;
114501;113856;0;17409;FALSO;VERDADERO;645;;;
114501;113856;0;17410;FALSO;VERDADERO;645;;;
114501;113856;0;17411;FALSO;VERDADERO;645;;;
114501;113856;0;17412;FALSO;VERDADERO;645;;;
114533;113856;0;17413;FALSO;VERDADERO;677;;;
114533;113856;0;17414;FALSO;VERDADERO;677;;;
114533;113856;0;17415;FALSO;VERDADERO;677;;;
114533;113856;0;17416;FALSO;VERDADERO;677;;;
114533;113856;0;17417;FALSO;VERDADERO;677;;;
114533;113856;0;17418;FALSO;VERDADERO;677;;;
114565;113856;0;17419;FALSO;VERDADERO;709;;;
114565;113856;0;17420;FALSO;VERDADERO;709;;;
114565;113856;0;17421;FALSO;VERDADERO;709;;;
114565;113856;0;17422;FALSO;VERDADERO;709;;;
114565;113856;0;17423;FALSO;VERDADERO;709;;;
114597;113856;0;17424;FALSO;VERDADERO;741;;;
114597;113856;0;17425;FALSO;VERDADERO;741;;;
114597;113856;0;17426;FALSO;VERDADERO;741;;;
114597;113856;0;17427;FALSO;VERDADERO;741;;;
114597;113856;0;17428;FALSO;VERDADERO;741;;;
114597;113856;0;17429;FALSO;VERDADERO;741;;;
114636;113856;0;17430;FALSO;VERDADERO;780;;;
114636;113856;0;17431;FALSO;VERDADERO;780;;;
114636;113856;0;17432;FALSO;VERDADERO;780;;;
114636;113856;0;17433;FALSO;VERDADERO;780;;;
114636;113856;0;17434;FALSO;VERDADERO;780;;;
114665;113856;0;17435;FALSO;VERDADERO;809;;;
114665;113856;0;17436;FALSO;VERDADERO;809;;;
114665;113856;0;17437;FALSO;VERDADERO;809;;;
114665;113856;0;17438;FALSO;VERDADERO;809;;;
114665;113856;0;17439;FALSO;VERDADERO;809;;;
114696;113856;0;17440;FALSO;VERDADERO;840;;;
114696;113856;0;17441;FALSO;VERDADERO;840;;;
114696;113856;0;17442;FALSO;VERDADERO;840;;;
114696;113856;0;17443;FALSO;VERDADERO;840;;;
114696;113856;0;17444;FALSO;VERDADERO;840;;;
114696;113856;0;17445;FALSO;VERDADERO;840;;;
114732;113856;0;17446;FALSO;VERDADERO;876;;;
114732;113856;0;17447;FALSO;VERDADERO;876;;;
114732;113856;0;17448;FALSO;VERDADERO;876;;;
114732;113856;0;17449;FALSO;VERDADERO;876;;;
114732;113856;0;17450;FALSO;VERDADERO;876;;;
114732;113856;0;17451;FALSO;VERDADERO;876;;;
114769;113856;0;17452;FALSO;VERDADERO;913;;;
114769;113856;0;17453;FALSO;VERDADERO;913;;;
114769;113856;0;17454;FALSO;VERDADERO;913;;;
114769;113856;0;17455;FALSO;VERDADERO;913;;;
114769;113856;0;17456;FALSO;VERDADERO;913;;;
114801;113856;0;17457;FALSO;VERDADERO;945;;;
114801;113856;0;17458;FALSO;VERDADERO;945;;;
114801;113856;0;17459;FALSO;VERDADERO;945;;;
114801;113856;0;17460;FALSO;VERDADERO;945;;;
114801;113856;0;17461;FALSO;VERDADERO;945;;;
114801;113856;0;17462;FALSO;VERDADERO;945;;;
114833;113856;0;17463;FALSO;VERDADERO;977;;;
114833;113856;0;17464;FALSO;VERDADERO;977;;;
114833;113856;0;17465;FALSO;VERDADERO;977;;;
114833;113856;0;17466;FALSO;VERDADERO;977;;;
114833;113856;0;17467;FALSO;VERDADERO;977;;;
114833;113856;0;17468;FALSO;VERDADERO;977;;;
114869;113856;0;17469;FALSO;VERDADERO;1013;;;
114869;113856;0;17470;FALSO;VERDADERO;1013;;;
114869;113856;0;17471;FALSO;VERDADERO;1013;;;
114869;113856;0;17472;FALSO;VERDADERO;1013;;;
114869;113856;0;17473;FALSO;VERDADERO;1013;;;
114901;113876;0;17474;FALSO;VERDADERO;1025;;;
114901;113876;0;17475;FALSO;VERDADERO;1025;;;
114901;113896;0;17476;FALSO;VERDADERO;1005;;;
114901;113896;0;17477;FALSO;VERDADERO;1005;;;
114901;113896;0;17478;FALSO;VERDADERO;1005;;;
114901;113916;0;17479;FALSO;VERDADERO;985;;;
114936;113916;0;17480;FALSO;VERDADERO;1020;;;
114936;113936;0;17481;FALSO;VERDADERO;1000;;;
114936;113936;0;17482;FALSO;VERDADERO;1000;;;
114936;113956;0;17483;FALSO;VERDADERO;980;;;
114968;113956;0;17484;FALSO;VERDADERO;1012;;;
114968;113956;0;17485;FALSO;VERDADERO;1012;;;
114968;113976;0;17486;FALSO;VERDADERO;992;;;
114968;113976;0;17487;FALSO;VERDADERO;992;;;
114968;113996;1;17488;FALSO;VERDADERO;972;;;
114968;113996;0;17489;FALSO;VERDADERO;972;;;
115001;113996;0;17490;FALSO;VERDADERO;1005;;;
115001;114016;0;17491;FALSO;VERDADERO;985;;;
115001;114016;0;17492;FALSO;VERDADERO;985;;;
115001;114036;0;17493;FALSO;VERDADERO;965;;;
115032;114036;0;17494;FALSO;VERDADERO;996;;;
115032;114036;0;17495;FALSO;VERDADERO;996;;;
115032;114056;0;17496;FALSO;VERDADERO;976;;;
115032;114056;0;17497;FALSO;VERDADERO;976;;;
115032;114076;0;17498;FALSO;VERDADERO;956;;;
115065;114076;0;17499;FALSO;VERDADERO;989;;;
115065;114076;0;17500;FALSO;VERDADERO;989;;;
115065;114096;0;17501;FALSO;VERDADERO;969;;;
115065;114096;0;17502;FALSO;VERDADERO;969;;;
115065;114116;1;17503;FALSO;VERDADERO;949;;;
115065;114116;0;17504;FALSO;VERDADERO;949;;;
115101;114116;0;17505;FALSO;VERDADERO;985;;;
115101;114136;0;17506;FALSO;VERDADERO;965;;;
115101;114136;0;17507;FALSO;VERDADERO;965;;;
115101;114156;0;17508;FALSO;VERDADERO;945;;;
115101;114156;0;17509;FALSO;VERDADERO;945;;;
115133;114156;0;17510;FALSO;VERDADERO;977;;;
115133;114176;0;17511;FALSO;VERDADERO;957;;;
115133;114176;0;17512;FALSO;VERDADERO;957;;;
115133;114196;0;17513;FALSO;VERDADERO;937;;;
115161;114196;0;17514;FALSO;VERDADERO;965;;;
115161;114196;0;17515;FALSO;VERDADERO;965;;;
115161;114216;0;17516;FALSO;VERDADERO;945;;;
115161;114216;0;17517;FALSO;VERDADERO;945;;;
115161;114236;0;17518;FALSO;VERDADERO;925;;;
115161;114236;0;17519;FALSO;VERDADERO;925;;;
115161;114236;0;17520;FALSO;VERDADERO;925;;;
115205;114256;0;17521;FALSO;VERDADERO;949;;;
115205;114256;0;17522;FALSO;VERDADERO;949;;;
115205;114276;0;17523;FALSO;VERDADERO;929;;;
115205;114276;0;17524;FALSO;VERDADERO;929;;;
115229;114276;0;17525;FALSO;VERDADERO;953;;;
115229;114296;0;17526;FALSO;VERDADERO;933;;;
115229;114296;0;17527;FALSO;VERDADERO;933;;;
115229;114316;0;17528;FALSO;VERDADERO;913;;;
115229;114316;0;17529;FALSO;VERDADERO;913;;;
115229;114316;0;17530;FALSO;VERDADERO;913;;;
115265;114336;0;17531;FALSO;VERDADERO;929;;;
115265;114336;0;17532;FALSO;VERDADERO;929;;;
115265;114356;0;17533;FALSO;VERDADERO;909;;;
115265;114356;0;17534;FALSO;VERDADERO;909;;;
115265;114356;0;17535;FALSO;VERDADERO;909;;;
115297;114376;0;17536;FALSO;VERDADERO;921;;;
115297;114376;0;17537;FALSO;VERDADERO;921;;;
115297;114396;0;17538;FALSO;VERDADERO;901;;;
115297;114396;0;17539;FALSO;VERDADERO;901;;;
115297;114396;0;17540;FALSO;VERDADERO;901;;;
115333;114416;0;17541;FALSO;VERDADERO;917;;;
115333;114416;0;17542;FALSO;VERDADERO;917;;;
115333;114436;0;17543;FALSO;VERDADERO;897;;;
115333;114436;0;17544;FALSO;VERDADERO;897;;;
115333;114436;0;17545;FALSO;VERDADERO;897;;;
115333;114456;0;17546;FALSO;VERDADERO;877;;;
115368;114456;0;17547;FALSO;VERDADERO;912;;;
115368;114476;0;17548;FALSO;VERDADERO;892;;;
115368;114476;0;17549;FALSO;VERDADERO;892;;;
115368;114496;0;17550;FALSO;VERDADERO;872;;;
115368;114496;0;17551;FALSO;VERDADERO;872;;;
115401;114496;0;17552;FALSO;VERDADERO;905;;;
115401;114516;0;17553;FALSO;VERDADERO;885;;;
115401;114516;0;17554;FALSO;VERDADERO;885;;;
115401;114536;0;17555;FALSO;VERDADERO;865;;;
115401;114536;0;17556;FALSO;VERDADERO;865;;;
115433;114536;0;17557;FALSO;VERDADERO;897;;;
115433;114556;0;17558;FALSO;VERDADERO;877;;;
115433;114556;0;17559;FALSO;VERDADERO;877;;;
115433;114576;0;17560;FALSO;VERDADERO;857;;;
115433;114576;0;17561;FALSO;VERDADERO;857;;;
115469;114576;0;17562;FALSO;VERDADERO;893;;;
115469;114596;0;17563;FALSO;VERDADERO;873;;;
115469;114596;0;17564;FALSO;VERDADERO;873;;;
115469;114616;0;17565;FALSO;VERDADERO;853;;;
115469;114616;0;17566;FALSO;VERDADERO;853;;;
115469;114616;0;17567;FALSO;VERDADERO;853;;;
115501;114636;0;17568;FALSO;VERDADERO;865;;;
115501;114636;0;17569;FALSO;VERDADERO;865;;;
115501;114656;0;17570;FALSO;VERDADERO;845;;;
115501;114656;0;17571;FALSO;VERDADERO;845;;;
115501;114656;0;17572;FALSO;VERDADERO;845;;;
115537;114676;0;17573;FALSO;VERDADERO;861;;;
115537;114676;0;17574;FALSO;VERDADERO;861;;;
115537;114696;0;17575;FALSO;VERDADERO;841;;;
115537;114696;0;17576;FALSO;VERDADERO;841;;;
115537;114716;1;17577;FALSO;VERDADERO;821;;;
115569;114716;0;17578;FALSO;VERDADERO;853;;;
115569;114716;0;17579;FALSO;VERDADERO;853;;;
115569;114736;0;17580;FALSO;VERDADERO;833;;;
115569;114736;0;17581;FALSO;VERDADERO;833;;;
115569;114756;1;17582;FALSO;VERDADERO;813;;;
115600;114756;0;17583;FALSO;VERDADERO;844;;;
115600;114756;0;17584;FALSO;VERDADERO;844;;;
115600;114979;0;17585;FALSO;VERDADERO;621;;;
115600;114979;0;17586;FALSO;VERDADERO;621;;;
115600;114999;1;17587;FALSO;VERDADERO;601;;;
115600;114999;0;17588;FALSO;VERDADERO;601;;;
115638;114999;0;17589;FALSO;VERDADERO;639;;;
115638;115019;0;17590;FALSO;VERDADERO;619;;;
115638;115019;0;17591;FALSO;VERDADERO;619;;;
115638;115039;0;17592;FALSO;VERDADERO;599;;;
115667;115039;0;17593;FALSO;VERDADERO;628;;;
115667;115039;0;17594;FALSO;VERDADERO;628;;;
115667;115059;0;17595;FALSO;VERDADERO;608;;;
115667;115059;0;17596;FALSO;VERDADERO;608;;;
115667;115079;0;17597;FALSO;VERDADERO;588;;;
115700;115079;0;17598;FALSO;VERDADERO;621;;;
115700;115099;0;17599;FALSO;VERDADERO;601;;;
115700;115099;0;17600;FALSO;VERDADERO;601;;;
115700;115099;0;17601;FALSO;VERDADERO;601;;;
115700;115119;0;17602;FALSO;VERDADERO;581;;;
115733;115119;0;17603;FALSO;VERDADERO;614;;;
115733;115139;0;17604;FALSO;VERDADERO;594;;;
115733;115139;0;17605;FALSO;VERDADERO;594;;;
115733;115139;0;17606;FALSO;VERDADERO;594;;;
115733;115159;1;17607;FALSO;VERDADERO;574;;;
115733;115159;0;17608;FALSO;VERDADERO;574;;;
115770;115179;0;17609;FALSO;VERDADERO;591;;;
115770;115179;0;17610;FALSO;VERDADERO;591;;;
115770;115179;0;17611;FALSO;VERDADERO;591;;;
115770;115199;0;17612;FALSO;VERDADERO;571;;;
115770;115199;0;17613;FALSO;VERDADERO;571;;;
115796;115219;0;17614;FALSO;VERDADERO;577;;;
115796;115219;0;17615;FALSO;VERDADERO;577;;;
115796;115219;0;17616;FALSO;VERDADERO;577;;;
115796;115239;0;17617;FALSO;VERDADERO;557;;;
115829;115239;0;17618;FALSO;VERDADERO;590;;;
115829;115259;0;17619;FALSO;VERDADERO;570;;;
115829;115259;0;17620;FALSO;VERDADERO;570;;;
115829;115259;0;17621;FALSO;VERDADERO;570;;;
115829;115279;0;17622;FALSO;VERDADERO;550;;;
115861;115279;0;17623;FALSO;VERDADERO;582;;;
115861;115299;0;17624;FALSO;VERDADERO;562;;;
115861;115299;0;17625;FALSO;VERDADERO;562;;;
115861;115299;0;17626;FALSO;VERDADERO;562;;;
115861;115319;0;17627;FALSO;VERDADERO;542;;;
115893;115319;0;17628;FALSO;VERDADERO;574;;;
115893;115339;0;17629;FALSO;VERDADERO;554;;;
115893;115339;0;17630;FALSO;VERDADERO;554;;;
115893;115339;0;17631;FALSO;VERDADERO;554;;;
115893;115359;0;17632;FALSO;VERDADERO;534;;;
115893;115359;0;17633;FALSO;VERDADERO;534;;;
115929;115379;0;17634;FALSO;VERDADERO;550;;;
115929;115379;0;17635;FALSO;VERDADERO;550;;;
115929;115379;0;17636;FALSO;VERDADERO;550;;;
115929;115399;0;17637;FALSO;VERDADERO;530;;;
115929;115399;0;17638;FALSO;VERDADERO;530;;;
115929;115419;0;17639;FALSO;VERDADERO;510;;;
115967;115419;0;17640;FALSO;VERDADERO;548;;;
115967;115419;0;17641;FALSO;VERDADERO;548;;;
115967;115439;0;17642;FALSO;VERDADERO;528;;;
115967;115439;0;17643;FALSO;VERDADERO;528;;;
115993;115459;0;17644;FALSO;VERDADERO;534;;;
115993;115459;0;17645;FALSO;VERDADERO;534;;;
115993;115459;0;17646;FALSO;VERDADERO;534;;;
115993;115479;1;17647;FALSO;VERDADERO;514;;;
115993;115479;0;17648;FALSO;VERDADERO;514;;;
115993;115499;1;17649;FALSO;VERDADERO;494;;;
116028;115499;0;17650;FALSO;VERDADERO;529;;;
116028;115499;0;17651;FALSO;VERDADERO;529;;;
116028;115519;0;17652;FALSO;VERDADERO;509;;;
116028;115519;0;17653;FALSO;VERDADERO;509;;;
116028;115539;0;17654;FALSO;VERDADERO;489;;;
116061;115539;0;17655;FALSO;VERDADERO;522;;;
116061;115559;0;17656;FALSO;VERDADERO;502;;;
116061;115559;0;17657;FALSO;VERDADERO;502;;;
116061;115559;0;17658;FALSO;VERDADERO;502;;;
116061;115579;0;17659;FALSO;VERDADERO;482;;;
116097;115579;0;17660;FALSO;VERDADERO;518;;;
116097;115579;0;17661;FALSO;VERDADERO;518;;;
116097;115599;0;17662;FALSO;VERDADERO;498;;;
116097;115599;0;17663;FALSO;VERDADERO;498;;;
116097;115619;1;17664;FALSO;VERDADERO;478;;;
116097;115619;0;17665;FALSO;VERDADERO;478;;;
116129;115619;0;17666;FALSO;VERDADERO;510;;;
116129;115639;0;17667;FALSO;VERDADERO;490;;;
116129;115639;0;17668;FALSO;VERDADERO;490;;;
116129;115659;0;17669;FALSO;VERDADERO;470;;;
116129;115659;0;17670;FALSO;VERDADERO;470;;;
116129;115679;0;17671;FALSO;VERDADERO;450;;;
116172;115679;0;17672;FALSO;VERDADERO;493;;;
116172;115679;0;17673;FALSO;VERDADERO;493;;;
116172;115699;0;17674;FALSO;VERDADERO;473;;;
116172;115699;0;17675;FALSO;VERDADERO;473;;;
116197;115719;1;17676;FALSO;VERDADERO;478;;;
116197;115719;0;17677;FALSO;VERDADERO;478;;;
116197;115719;0;17678;FALSO;VERDADERO;478;;;
116197;115739;0;17679;FALSO;VERDADERO;458;;;
116197;115739;0;17680;FALSO;VERDADERO;458;;;
116229;115759;0;17681;FALSO;VERDADERO;470;;;
116229;115759;0;17682;FALSO;VERDADERO;470;;;
116229;115759;0;17683;FALSO;VERDADERO;470;;;
116229;115779;0;17684;FALSO;VERDADERO;450;;;
116229;115779;0;17685;FALSO;VERDADERO;450;;;
116229;115799;1;17686;FALSO;VERDADERO;430;;;
116265;115799;0;17687;FALSO;VERDADERO;466;;;
116265;115799;0;17688;FALSO;VERDADERO;466;;;
116265;115819;0;17689;FALSO;VERDADERO;446;;;
116265;115819;0;17690;FALSO;VERDADERO;446;;;
116265;115839;0;17691;FALSO;VERDADERO;426;;;
116300;115839;0;17692;FALSO;VERDADERO;461;;;
116300;115839;0;17693;FALSO;VERDADERO;461;;;
116300;115859;0;17694;FALSO;VERDADERO;441;;;
116300;115859;0;17695;FALSO;VERDADERO;441;;;
116300;115879;1;17696;FALSO;VERDADERO;421;;;
116333;115879;0;17697;FALSO;VERDADERO;454;;;
116333;115879;0;17698;FALSO;VERDADERO;454;;;
116333;115899;0;17699;FALSO;VERDADERO;434;;;
116333;115899;0;17700;FALSO;VERDADERO;434;;;
116333;115919;0;17701;FALSO;VERDADERO;414;;;
116364;115919;0;17702;FALSO;VERDADERO;445;;;
116364;115919;0;17703;FALSO;VERDADERO;445;;;
116364;115939;1;17704;FALSO;VERDADERO;425;;;
116364;115939;0;17705;FALSO;VERDADERO;425;;;
116364;115959;0;17706;FALSO;VERDADERO;405;;;
116364;115959;0;17707;FALSO;VERDADERO;405;;;
116400;115959;0;17708;FALSO;VERDADERO;441;;;
116400;115979;0;17709;FALSO;VERDADERO;421;;;
116400;115979;0;17710;FALSO;VERDADERO;421;;;
116400;115999;0;17711;FALSO;VERDADERO;401;;;
116400;115999;0;17712;FALSO;VERDADERO;401;;;
116400;116019;0;17713;FALSO;VERDADERO;381;;;
116437;116019;0;17714;FALSO;VERDADERO;418;;;
116437;116019;0;17715;FALSO;VERDADERO;418;;;
116437;116039;1;17716;FALSO;VERDADERO;398;;;
116437;116039;0;17717;FALSO;VERDADERO;398;;;
116437;116039;0;17718;FALSO;VERDADERO;398;;;
116469;116059;0;17719;FALSO;VERDADERO;410;;;
116469;116059;0;17720;FALSO;VERDADERO;410;;;
116469;116079;0;17721;FALSO;VERDADERO;390;;;
116469;116079;0;17722;FALSO;VERDADERO;390;;;
116469;116079;0;17723;FALSO;VERDADERO;390;;;
116500;116099;0;17724;FALSO;VERDADERO;401;;;
116500;116099;0;17725;FALSO;VERDADERO;401;;;
116500;116119;0;17726;FALSO;VERDADERO;381;;;
116500;116119;0;17727;FALSO;VERDADERO;381;;;
116500;116119;0;17728;FALSO;VERDADERO;381;;;
116533;116139;0;17729;FALSO;VERDADERO;394;;;
116533;116139;0;17730;FALSO;VERDADERO;394;;;
116533;116159;0;17731;FALSO;VERDADERO;374;;;
116533;116159;0;17732;FALSO;VERDADERO;374;;;
116533;116159;0;17733;FALSO;VERDADERO;374;;;
116564;116179;0;17734;FALSO;VERDADERO;385;;;
116564;116179;0;17735;FALSO;VERDADERO;385;;;
116564;116199;0;17736;FALSO;VERDADERO;365;;;
116564;116199;0;17737;FALSO;VERDADERO;365;;;
116564;116219;0;17738;FALSO;VERDADERO;345;;;
116600;116219;0;17739;FALSO;VERDADERO;381;;;
116600;116219;0;17740;FALSO;VERDADERO;381;;;
116600;116239;0;17741;FALSO;VERDADERO;361;;;
116600;116239;0;17742;FALSO;VERDADERO;361;;;
116600;116259;0;17743;FALSO;VERDADERO;341;;;
116633;116259;0;17744;FALSO;VERDADERO;374;;;
116633;116259;0;17745;FALSO;VERDADERO;374;;;
116633;116279;0;17746;FALSO;VERDADERO;354;;;
116633;116279;0;17747;FALSO;VERDADERO;354;;;
116633;116299;0;17748;FALSO;VERDADERO;334;;;
116665;116299;0;17749;FALSO;VERDADERO;366;;;
116665;116299;0;17750;FALSO;VERDADERO;366;;;
116665;116319;0;17751;FALSO;VERDADERO;346;;;
116665;116319;0;17752;FALSO;VERDADERO;346;;;
116665;116339;0;17753;FALSO;VERDADERO;326;;;
116665;116339;0;17754;FALSO;VERDADERO;326;;;
116701;116339;0;17755;FALSO;VERDADERO;362;;;
116701;116359;0;17756;FALSO;VERDADERO;342;;;
116701;116359;0;17757;FALSO;VERDADERO;342;;;
116701;116379;0;17758;FALSO;VERDADERO;322;;;
116701;116379;0;17759;FALSO;VERDADERO;322;;;
116733;116379;0;17760;FALSO;VERDADERO;354;;;
116733;116399;0;17761;FALSO;VERDADERO;334;;;
116733;116399;0;17762;FALSO;VERDADERO;334;;;
116733;116419;0;17763;FALSO;VERDADERO;314;;;
116733;116419;0;17764;FALSO;VERDADERO;314;;;
116765;116419;0;17765;FALSO;VERDADERO;346;;;
116765;116439;0;17766;FALSO;VERDADERO;326;;;
116765;116439;0;17767;FALSO;VERDADERO;326;;;
116765;116459;0;17768;FALSO;VERDADERO;306;;;
116765;116459;0;17769;FALSO;VERDADERO;306;;;
116800;116459;0;17770;FALSO;VERDADERO;341;;;
116800;116479;0;17771;FALSO;VERDADERO;321;;;
116800;116479;0;17772;FALSO;VERDADERO;321;;;
116800;116499;0;17773;FALSO;VERDADERO;301;;;
116800;116499;0;17774;FALSO;VERDADERO;301;;;
116833;116519;0;17775;FALSO;VERDADERO;314;;;
116833;116519;0;17776;FALSO;VERDADERO;314;;;
116833;116519;0;17777;FALSO;VERDADERO;314;;;
116833;116539;0;17778;FALSO;VERDADERO;294;;;
116833;116539;0;17779;FALSO;VERDADERO;294;;;
116866;116559;0;17780;FALSO;VERDADERO;307;;;
116866;116559;0;17781;FALSO;VERDADERO;307;;;
116866;116559;0;17782;FALSO;VERDADERO;307;;;
116866;116579;0;17783;FALSO;VERDADERO;287;;;
116866;116579;0;17784;FALSO;VERDADERO;287;;;
116866;116599;1;17785;FALSO;VERDADERO;267;;;
116901;116599;0;17786;FALSO;VERDADERO;302;;;
116901;116599;0;17787;FALSO;VERDADERO;302;;;
116901;116619;0;17788;FALSO;VERDADERO;282;;;
116901;116619;0;17789;FALSO;VERDADERO;282;;;
116901;116639;1;17790;FALSO;VERDADERO;262;;;
116932;116639;0;17791;FALSO;VERDADERO;293;;;
116932;116639;0;17792;FALSO;VERDADERO;293;;;
116932;116659;0;17793;FALSO;VERDADERO;273;;;
116932;116659;0;17794;FALSO;VERDADERO;273;;;
116932;116679;0;17795;FALSO;VERDADERO;253;;;
116968;116679;0;17796;FALSO;VERDADERO;289;;;
116968;116679;0;17797;FALSO;VERDADERO;289;;;
116968;116699;0;17798;FALSO;VERDADERO;269;;;
116968;116699;0;17799;FALSO;VERDADERO;269;;;
116968;116719;0;17800;FALSO;VERDADERO;249;;;
117001;116719;0;17801;FALSO;VERDADERO;282;;;
117001;116719;0;17802;FALSO;VERDADERO;282;;;
117001;116739;0;17803;FALSO;VERDADERO;262;;;
117001;116739;0;17804;FALSO;VERDADERO;262;;;
117001;116760;0;17805;FALSO;VERDADERO;241;;;
117001;116760;0;17806;FALSO;VERDADERO;241;;;
117032;116760;0;17807;FALSO;VERDADERO;272;;;
117032;116780;0;17808;FALSO;VERDADERO;252;;;
117032;116780;0;17809;FALSO;VERDADERO;252;;;
117032;116800;0;17810;FALSO;VERDADERO;232;;;
117032;116800;0;17811;FALSO;VERDADERO;232;;;
117069;116800;0;17812;FALSO;VERDADERO;269;;;
117069;116820;0;17813;FALSO;VERDADERO;249;;;
117069;116820;0;17814;FALSO;VERDADERO;249;;;
117069;116840;0;17815;FALSO;VERDADERO;229;;;
117069;116840;0;17816;FALSO;VERDADERO;229;;;
117101;116840;0;17817;FALSO;VERDADERO;261;;;
117101;116860;0;17818;FALSO;VERDADERO;241;;;
117101;116860;0;17819;FALSO;VERDADERO;241;;;
117101;116880;0;17820;FALSO;VERDADERO;221;;;
117101;116880;0;17821;FALSO;VERDADERO;221;;;
117133;116880;0;17822;FALSO;VERDADERO;253;;;
117133;116900;0;17823;FALSO;VERDADERO;233;;;
117133;116900;0;17824;FALSO;VERDADERO;233;;;
117133;116920;0;17825;FALSO;VERDADERO;213;;;
117133;116920;0;17826;FALSO;VERDADERO;213;;;
117133;116920;0;17827;FALSO;VERDADERO;213;;;
117169;116940;0;17828;FALSO;VERDADERO;229;;;
117169;116940;0;17829;FALSO;VERDADERO;229;;;
117169;116960;0;17830;FALSO;VERDADERO;209;;;
117169;116960;0;17831;FALSO;VERDADERO;209;;;
117169;116960;0;17832;FALSO;VERDADERO;209;;;
117200;116980;0;17833;FALSO;VERDADERO;220;;;
117200;116980;0;17834;FALSO;VERDADERO;220;;;
117200;117000;0;17835;FALSO;VERDADERO;200;;;
117200;117000;0;17836;FALSO;VERDADERO;200;;;
117200;117000;0;17837;FALSO;VERDADERO;200;;;
117233;117020;0;17838;FALSO;VERDADERO;213;;;
117233;117020;0;17839;FALSO;VERDADERO;213;;;
117233;117040;0;17840;FALSO;VERDADERO;193;;;
117233;117040;0;17841;FALSO;VERDADERO;193;;;
117233;117040;0;17842;FALSO;VERDADERO;193;;;
117269;117060;0;17843;FALSO;VERDADERO;209;;;
117269;117060;0;17844;FALSO;VERDADERO;209;;;
117269;117080;0;17845;FALSO;VERDADERO;189;;;
117269;117080;0;17846;FALSO;VERDADERO;189;;;
117269;117100;0;17847;FALSO;VERDADERO;169;;;
117269;117100;0;17848;FALSO;VERDADERO;169;;;
117301;117100;0;17849;FALSO;VERDADERO;201;;;
117301;117120;0;17850;FALSO;VERDADERO;181;;;
117301;117120;0;17851;FALSO;VERDADERO;181;;;
117301;117140;0;17852;FALSO;VERDADERO;161;;;
117333;117140;0;17853;FALSO;VERDADERO;193;;;
117333;117140;0;17854;FALSO;VERDADERO;193;;;
117333;117160;0;17855;FALSO;VERDADERO;173;;;
117333;117160;0;17856;FALSO;VERDADERO;173;;;
117333;117180;0;17857;FALSO;VERDADERO;153;;;
117333;117180;0;17858;FALSO;VERDADERO;153;;;
117369;117180;0;17859;FALSO;VERDADERO;189;;;
117369;117200;0;17860;FALSO;VERDADERO;169;;;
117369;117200;0;17861;FALSO;VERDADERO;169;;;
117369;117220;0;17862;FALSO;VERDADERO;149;;;
117369;117220;0;17863;FALSO;VERDADERO;149;;;
117401;117220;0;17864;FALSO;VERDADERO;181;;;
117401;117240;0;17865;FALSO;VERDADERO;161;;;
117401;117240;0;17866;FALSO;VERDADERO;161;;;
117401;117260;0;17867;FALSO;VERDADERO;141;;;
117401;117260;0;17868;FALSO;VERDADERO;141;;;
117433;117260;0;17869;FALSO;VERDADERO;173;;;
117433;117280;0;17870;FALSO;VERDADERO;153;;;
117433;117280;0;17871;FALSO;VERDADERO;153;;;
117433;117300;1;17872;FALSO;VERDADERO;133;;;
117433;117300;0;17873;FALSO;VERDADERO;133;;;
117465;117300;0;17874;FALSO;VERDADERO;165;;;
117465;117320;0,00E+00;17875;FALSO;VERDADERO;145;;;
117465;117320;0;17876;FALSO;VERDADERO;145;;;
117465;117340;0;17877;FALSO;VERDADERO;125;;;
117465;117340;0;17878;FALSO;VERDADERO;125;;;
117496;117340;0;17879;FALSO;VERDADERO;156;;;
117496;117360;0;17880;FALSO;VERDADERO;136;;;
117496;117360;0;17881;FALSO;VERDADERO;136;;;
117496;117380;0;17882;FALSO;VERDADERO;116;;;
117496;117380;0;17883;FALSO;VERDADERO;116;;;
117496;117400;0;17884;FALSO;VERDADERO;96;;;
117532;117400;0;17885;FALSO;VERDADERO;132;;;
117532;117400;0;17886;FALSO;VERDADERO;132;;;
117532;117420;0;17887;FALSO;VERDADERO;112;;;
117532;117420;0;17888;FALSO;VERDADERO;112;;;
117532;117440;0;17889;FALSO;VERDADERO;92;;;
117564;117440;0;17890;FALSO;VERDADERO;124;;;
117564;117440;0;17891;FALSO;VERDADERO;124;;;
117564;117460;1;17892;FALSO;VERDADERO;104;;;
117564;117460;0;17893;FALSO;VERDADERO;104;;;
117564;117480;0;17894;FALSO;VERDADERO;84;;;
117596;117480;0;17895;FALSO;VERDADERO;116;;;
117596;117480;0;17896;FALSO;VERDADERO;116;;;
117596;117500;0;17897;FALSO;VERDADERO;96;;;
117596;117500;0;17898;FALSO;VERDADERO;96;;;
117596;117520;0;17899;FALSO;VERDADERO;76;;;
117628;117520;0;17900;FALSO;VERDADERO;108;;;
117628;117520;0;17901;FALSO;VERDADERO;108;;;
117628;117540;0;17902;FALSO;VERDADERO;88;;;
117628;117540;0;17903;FALSO;VERDADERO;88;;;
117628;117560;0;17904;FALSO;VERDADERO;68;;;
117661;117560;0;17905;FALSO;VERDADERO;101;;;
117661;117560;0;17906;FALSO;VERDADERO;101;;;
117661;117581;0;17907;FALSO;VERDADERO;80;;;
117661;117581;0;17908;FALSO;VERDADERO;80;;;
117661;117601;1;17909;FALSO;VERDADERO;60;;;
117696;117601;0;17910;FALSO;VERDADERO;95;;;
117696;117601;0;17911;FALSO;VERDADERO;95;;;
117696;117621;0;17912;FALSO;VERDADERO;75;;;
117696;117621;0;17913;FALSO;VERDADERO;75;;;
117696;117641;0;17914;FALSO;VERDADERO;55;;;
117729;117641;0;17915;FALSO;VERDADERO;88;;;
117729;117661;0;17916;FALSO;VERDADERO;68;;;
117729;117661;0;17917;FALSO;VERDADERO;68;;;
117729;117661;0;17918;FALSO;VERDADERO;68;;;
117729;117681;0;17919;VERDADERO;VERDADERO;48;;;
117760;117681;0;17920;FALSO;VERDADERO;79;;;
117760;117701;1;17921;FALSO;VERDADERO;59;;;
117760;117701;0;17922;FALSO;VERDADERO;59;;;
117760;117701;0;17923;FALSO;VERDADERO;59;;;
117760;117721;0;17924;VERDADERO;VERDADERO;39;;;
117760;117721;0;17925;VERDADERO;VERDADERO;39;;;
117800;117741;0;17926;FALSO;VERDADERO;59;;;
117800;117741;0;17927;FALSO;VERDADERO;59;;;
117800;117741;0;17928;FALSO;VERDADERO;59;;;
117800;117761;0;17929;VERDADERO;VERDADERO;39;;;
117825;117761;0;17930;FALSO;VERDADERO;64;;;
117825;117781;0;17931;VERDADERO;VERDADERO;44;;;
117825;117781;0;17932;VERDADERO;VERDADERO;44;;;
117825;117781;0;17933;VERDADERO;VERDADERO;44;;;
117825;117801;1;17934;VERDADERO;VERDADERO;24;;;
117825;117801;0;17935;VERDADERO;VERDADERO;24;;;
117860;117821;0;17936;VERDADERO;VERDADERO;39;;;
117860;117821;0;17937;VERDADERO;VERDADERO;39;;;
117860;117821;0;17938;VERDADERO;VERDADERO;39;;;
117860;117841;0;17939;VERDADERO;VERDADERO;19;;;
117860;117841;0;17940;VERDADERO;VERDADERO;19;;;
117892;117861;0;17941;VERDADERO;VERDADERO;31;;;
117892;117861;0;17942;VERDADERO;VERDADERO;31;;;
117892;117881;0;17943;VERDADERO;VERDADERO;11;;;
117892;117881;0;17944;VERDADERO;VERDADERO;11;;;
117892;117881;0;17945;VERDADERO;VERDADERO;11;;;
117892;117901;0;17946;VERDADERO;VERDADERO;-9;;;
117928;117901;0;17947;VERDADERO;VERDADERO;27;;;
117928;117921;0;17948;VERDADERO;VERDADERO;7;;;
117928;117921;0;17949;VERDADERO;VERDADERO;7;;;
117928;117921;0;17950;VERDADERO;VERDADERO;7;;;
117928;117941;0;17951;VERDADERO;VERDADERO;-13;;;
117960;117941;0;17952;VERDADERO;VERDADERO;19;;;
117960;117961;0;17953;VERDADERO;VERDADERO;-1;;;
117960;117961;0;17954;VERDADERO;VERDADERO;-1;;;
117960;117961;0;17955;VERDADERO;VERDADERO;-1;;;
117960;117981;0;17956;VERDADERO;VERDADERO;-21;;;
117997;117981;0;17957;VERDADERO;VERDADERO;16;;;
117997;118001;0;17958;VERDADERO;VERDADERO;-4;;;
117997;118001;0;17959;VERDADERO;VERDADERO;-4;;;
117997;118001;0;17960;VERDADERO;VERDADERO;-4;;;
117997;118022;0;17961;VERDADERO;VERDADERO;-25;;;
118029;118022;0;17962;VERDADERO;VERDADERO;7;;;
118029;118042;0;17963;VERDADERO;VERDADERO;-13;;;
118029;118042;0;17964;VERDADERO;VERDADERO;-13;;;
118029;118062;0;17965;VERDADERO;VERDADERO;-33;;;
118029;118062;0;17966;VERDADERO;VERDADERO;-33;;;
118064;118062;0;17967;VERDADERO;VERDADERO;2;;;
118064;118082;0;17968;VERDADERO;VERDADERO;-18;;;
118064;118082;0;17969;VERDADERO;VERDADERO;-18;;;
118064;118082;0;17970;VERDADERO;VERDADERO;-18;;;
118064;118082;0;17971;VERDADERO;VERDADERO;-18;;;
118064;118102;0;17972;VERDADERO;VERDADERO;-38;;;
118097;118102;0;17973;VERDADERO;VERDADERO;-5;;;
118097;118122;0;17974;VERDADERO;VERDADERO;-25;;;
118097;118122;0;17975;VERDADERO;VERDADERO;-25;;;
118097;118122;0;17976;VERDADERO;VERDADERO;-25;;;
118097;118142;1;17977;VERDADERO;VERDADERO;-45;;;
118132;118142;0;17978;VERDADERO;VERDADERO;-10;;;
118132;118142;0;17979;VERDADERO;VERDADERO;-10;;;
118132;118162;0;17980;VERDADERO;VERDADERO;-30;;;
118132;118162;0;17981;VERDADERO;VERDADERO;-30;;;
118132;118182;0;17982;VERDADERO;FALSO;-50;;;
118165;118182;0;17983;VERDADERO;VERDADERO;-17;;;
118165;118182;0;17984;VERDADERO;VERDADERO;-17;;;
118165;118182;0;17985;VERDADERO;VERDADERO;-17;;;
118165;118182;0;17986;VERDADERO;VERDADERO;-17;;;
118165;118202;0;17987;VERDADERO;VERDADERO;-37;;;
118197;118202;0;17988;VERDADERO;VERDADERO;-5;;;
118197;118222;0;17989;VERDADERO;VERDADERO;-25;;;
118197;118222;0;17990;VERDADERO;VERDADERO;-25;;;
118197;118222;0;17991;VERDADERO;VERDADERO;-25;;;
118197;118222;0;17992;VERDADERO;VERDADERO;-25;;;
118197;118222;0;17993;VERDADERO;VERDADERO;-25;;;
118233;118242;0;17994;VERDADERO;VERDADERO;-9;;;
118233;118242;0;17995;VERDADERO;VERDADERO;-9;;;
118233;118242;0;17996;VERDADERO;VERDADERO;-9;;;
118233;118262;0;17997;VERDADERO;VERDADERO;-29;;;
118233;118262;0;17998;VERDADERO;VERDADERO;-29;;;
118265;118282;0;17999;VERDADERO;VERDADERO;-17;;;
118265;118282;0;18000;VERDADERO;VERDADERO;-17;;;
118265;118302;0;18001;VERDADERO;VERDADERO;-37;;;
118265;118302;0;18002;VERDADERO;VERDADERO;-37;;;
118265;118302;0;18003;VERDADERO;VERDADERO;-37;;;
118297;118322;1;18004;VERDADERO;VERDADERO;-25;;;
118297;118322;0;18005;VERDADERO;VERDADERO;-25;;;
118297;118322;0;18006;VERDADERO;VERDADERO;-25;;;
118297;118322;0;18007;VERDADERO;VERDADERO;-25;;;
118297;118322;0;18008;VERDADERO;VERDADERO;-25;;;
118297;118342;0;18009;VERDADERO;VERDADERO;-45;;;
118332;118342;0;18010;VERDADERO;VERDADERO;-10;;;
118332;118342;0;18011;VERDADERO;VERDADERO;-10;;;
118332;118362;0;18012;VERDADERO;VERDADERO;-30;;;
118332;118362;0;18013;VERDADERO;VERDADERO;-30;;;
118332;118382;1;18014;VERDADERO;FALSO;-50;;;
118365;118382;0;18015;VERDADERO;VERDADERO;-17;;;
118365;118382;0;18016;VERDADERO;VERDADERO;-17;;;
118365;118402;0;18017;VERDADERO;VERDADERO;-37;;;
118365;118402;0;18018;VERDADERO;VERDADERO;-37;;;
118365;118422;0;18019;VERDADERO;FALSO;-57;;;
118396;118422;0;18020;VERDADERO;VERDADERO;-26;;;
118396;118422;0;18021;VERDADERO;VERDADERO;-26;;;
118396;118422;0;18022;VERDADERO;VERDADERO;-26;;;
118396;118422;0;18023;VERDADERO;VERDADERO;-26;;;
118396;118442;1;18024;VERDADERO;VERDADERO;-46;;;
118396;118442;0;18025;VERDADERO;VERDADERO;-46;;;
118432;118462;1;18026;VERDADERO;VERDADERO;-30;;;
118432;118462;0;18027;VERDADERO;VERDADERO;-30;;;
118432;118462;0;18028;VERDADERO;VERDADERO;-30;;;
118432;118462;0;18029;VERDADERO;VERDADERO;-30;;;
118432;118462;0;18030;VERDADERO;VERDADERO;-30;;;
118465;118462;0;18031;VERDADERO;VERDADERO;3;;;
118465;118462;0;18032;VERDADERO;VERDADERO;3;;;
118465;118462;0;18033;VERDADERO;VERDADERO;3;;;
118465;118462;0;18034;VERDADERO;VERDADERO;3;;;
118465;118462;0;18035;VERDADERO;VERDADERO;3;;;
118496;118462;0;18036;VERDADERO;VERDADERO;34;;;
118496;118482;0;18037;VERDADERO;VERDADERO;14;;;
118496;118482;0;18038;VERDADERO;VERDADERO;14;;;
118496;118482;0;18039;VERDADERO;VERDADERO;14;;;
118496;118502;0;18040;VERDADERO;VERDADERO;-6;;;
118529;118502;0;18041;VERDADERO;VERDADERO;27;;;
118529;118522;0;18042;VERDADERO;VERDADERO;7;;;
118529;118522;0;18043;VERDADERO;VERDADERO;7;;;
118529;118522;0;18044;VERDADERO;VERDADERO;7;;;
118529;118542;0;18045;VERDADERO;VERDADERO;-13;;;
118561;118542;0;18046;VERDADERO;VERDADERO;19;;;
118561;118562;0;18047;VERDADERO;VERDADERO;-1;;;
118561;118562;0;18048;VERDADERO;VERDADERO;-1;;;
118561;118562;0;18049;VERDADERO;VERDADERO;-1;;;
118561;118582;0;18050;VERDADERO;VERDADERO;-21;;;
118561;118582;0;18051;VERDADERO;VERDADERO;-21;;;
118597;118602;0;18052;VERDADERO;VERDADERO;-5;;;
118597;118602;0;18053;VERDADERO;VERDADERO;-5;;;
118597;118602;0;18054;VERDADERO;VERDADERO;-5;;;
118597;118622;0;18055;VERDADERO;VERDADERO;-25;;;
118597;118622;0;18056;VERDADERO;VERDADERO;-25;;;
118629;118642;1;18057;VERDADERO;VERDADERO;-13;;;
118629;118642;0;18058;VERDADERO;VERDADERO;-13;;;
118629;118642;0;18059;VERDADERO;VERDADERO;-13;;;
118629;118662;1;18060;VERDADERO;VERDADERO;-33;;;
118629;118662;0;18061;VERDADERO;VERDADERO;-33;;;
118665;118682;1;18062;VERDADERO;VERDADERO;-17;;;
118665;118682;0;18063;VERDADERO;VERDADERO;-17;;;
118665;118682;0;18064;VERDADERO;VERDADERO;-17;;;
118665;118702;1;18065;VERDADERO;VERDADERO;-37;;;
118665;118702;0;18066;VERDADERO;VERDADERO;-37;;;
118696;118702;0;18067;VERDADERO;VERDADERO;-6;;;
118696;118702;0;18068;VERDADERO;VERDADERO;-6;;;
118696;118702;0;18069;VERDADERO;VERDADERO;-6;;;
118696;118702;0;18070;VERDADERO;VERDADERO;-6;;;
118696;118702;0;18071;VERDADERO;VERDADERO;-6;;;
118729;118702;0;18072;VERDADERO;VERDADERO;27;;;
118729;118722;0;18073;VERDADERO;VERDADERO;7;;;
118729;118722;0;18074;VERDADERO;VERDADERO;7;;;
118729;118742;0;18075;VERDADERO;VERDADERO;-13;;;
118729;118742;0;18076;VERDADERO;VERDADERO;-13;;;
118729;118762;0;18077;VERDADERO;VERDADERO;-33;;;
118761;118762;0;18078;VERDADERO;VERDADERO;-1;;;
118761;118762;0;18079;VERDADERO;VERDADERO;-1;;;
118761;118782;0;18080;VERDADERO;VERDADERO;-21;;;
118761;118782;0;18081;VERDADERO;VERDADERO;-21;;;
118793;118802;1;18082;VERDADERO;VERDADERO;-9;;;
118793;118802;0;18083;VERDADERO;VERDADERO;-9;;;
118793;118802;0;18084;VERDADERO;VERDADERO;-9;;;
118793;118822;0;18085;VERDADERO;VERDADERO;-29;;;
118793;118822;0;18086;VERDADERO;VERDADERO;-29;;;
118793;118822;0;18087;VERDADERO;VERDADERO;-29;;;
118829;118842;0;18088;VERDADERO;VERDADERO;-13;;;
118829;118842;0;18089;VERDADERO;VERDADERO;-13;;;
118829;118842;0;18090;VERDADERO;VERDADERO;-13;;;
118829;118862;0;18091;VERDADERO;VERDADERO;-33;;;
118829;118862;0;18092;VERDADERO;VERDADERO;-33;;;
118861;118882;1;18093;VERDADERO;VERDADERO;-21;;;
118861;118882;0;18094;VERDADERO;VERDADERO;-21;;;
118861;118882;0;18095;VERDADERO;VERDADERO;-21;;;
118861;118902;0;18096;VERDADERO;VERDADERO;-41;;;
118861;118902;0;18097;VERDADERO;VERDADERO;-41;;;
118892;118922;0;18098;VERDADERO;VERDADERO;-30;;;
118892;118922;0;18099;VERDADERO;VERDADERO;-30;;;
118892;118922;0;18100;VERDADERO;VERDADERO;-30;;;
118892;118922;0;18101;VERDADERO;VERDADERO;-30;;;
118892;118922;0;18102;VERDADERO;VERDADERO;-30;;;
118927;118922;0;18103;VERDADERO;VERDADERO;5;;;
118927;118942;0;18104;VERDADERO;VERDADERO;-15;;;
118927;118942;0;18105;VERDADERO;VERDADERO;-15;;;
118927;118962;0;18106;VERDADERO;VERDADERO;-35;;;
118927;118962;0;18107;VERDADERO;VERDADERO;-35;;;
118957;118962;0;18108;VERDADERO;VERDADERO;-5;;;
118957;118982;0;18109;VERDADERO;VERDADERO;-25;;;
118957;118982;0;18110;VERDADERO;VERDADERO;-25;;;
118957;119002;0;18111;VERDADERO;VERDADERO;-45;;;
118957;119002;0;18112;VERDADERO;VERDADERO;-45;;;
118957;119002;0;18113;VERDADERO;VERDADERO;-45;;;
118992;119022;0;18114;VERDADERO;VERDADERO;-30;;;
118992;119022;0;18115;VERDADERO;VERDADERO;-30;;;
118992;119022;0;18116;VERDADERO;VERDADERO;-30;;;
118992;119022;0;18117;VERDADERO;VERDADERO;-30;;;
118992;119022;0;18118;VERDADERO;VERDADERO;-30;;;
119024;119022;0;18119;VERDADERO;VERDADERO;2;;;
119024;119042;0;18120;VERDADERO;VERDADERO;-18;;;
119024;119042;0;18121;VERDADERO;VERDADERO;-18;;;
119024;119042;0;18122;VERDADERO;VERDADERO;-18;;;
119024;119062;0;18123;VERDADERO;VERDADERO;-38;;;
119024;119062;0;18124;VERDADERO;VERDADERO;-38;;;
119060;119062;0;18125;VERDADERO;VERDADERO;-2;;;
119060;119062;0;18126;VERDADERO;VERDADERO;-2;;;
119060;119062;0;18127;VERDADERO;VERDADERO;-2;;;
119060;119062;0;18128;VERDADERO;VERDADERO;-2;;;
119060;119062;0;18129;VERDADERO;VERDADERO;-2;;;
119093;119082;1;18130;VERDADERO;VERDADERO;11;;;
119093;119082;0;18131;VERDADERO;VERDADERO;11;;;
119093;119102;0;18132;VERDADERO;VERDADERO;-9;;;
119093;119102;0;18133;VERDADERO;VERDADERO;-9;;;
119093;119102;0;18134;VERDADERO;VERDADERO;-9;;;
119093;119122;0;18135;VERDADERO;VERDADERO;-29;;;
119128;119122;0;18136;VERDADERO;VERDADERO;6;;;
119128;119142;0;18137;VERDADERO;VERDADERO;-14;;;
119128;119142;0;18138;VERDADERO;VERDADERO;-14;;;
119128;119142;0;18139;VERDADERO;VERDADERO;-14;;;
119128;119162;1;18140;VERDADERO;VERDADERO;-34;;;
119161;119162;0;18141;VERDADERO;VERDADERO;-1;;;
119161;119182;0;18142;VERDADERO;VERDADERO;-21;;;
119161;119182;0;18143;VERDADERO;VERDADERO;-21;;;
119161;119182;0;18144;VERDADERO;VERDADERO;-21;;;
119161;119202;0;18145;VERDADERO;VERDADERO;-41;;;
119192;119202;0;18146;VERDADERO;VERDADERO;-10;;;
119192;119222;0;18147;VERDADERO;VERDADERO;-30;;;
119192;119222;0;18148;VERDADERO;VERDADERO;-30;;;
119192;119222;0;18149;VERDADERO;VERDADERO;-30;;;
119192;119222;0;18150;VERDADERO;VERDADERO;-30;;;
119192;119222;0;18151;VERDADERO;VERDADERO;-30;;;
119228;119242;1;18152;VERDADERO;VERDADERO;-14;;;
119228;119242;0;18153;VERDADERO;VERDADERO;-14;;;
119228;119242;0;18154;VERDADERO;VERDADERO;-14;;;
119228;119262;0;18155;VERDADERO;VERDADERO;-34;;;
119228;119262;0;18156;VERDADERO;VERDADERO;-34;;;
119261;119282;0;18157;VERDADERO;VERDADERO;-21;;;
119261;119282;0;18158;VERDADERO;VERDADERO;-21;;;
119261;119282;0;18159;VERDADERO;VERDADERO;-21;;;
119261;119282;0;18160;VERDADERO;VERDADERO;-21;;;
119261;119282;0;18161;VERDADERO;VERDADERO;-21;;;
119293;119282;0;18162;VERDADERO;VERDADERO;11;;;
119293;119302;0;18163;VERDADERO;VERDADERO;-9;;;
119293;119302;0;18164;VERDADERO;VERDADERO;-9;;;
119293;119322;1;18165;VERDADERO;VERDADERO;-29;;;
119293;119322;0;18166;VERDADERO;VERDADERO;-29;;;
119325;119322;0;18167;VERDADERO;VERDADERO;3;;;
119325;119322;0;18168;VERDADERO;VERDADERO;3;;;
119325;119322;0;18169;VERDADERO;VERDADERO;3;;;
119325;119322;0;18170;VERDADERO;VERDADERO;3;;;
119325;119322;0;18171;VERDADERO;VERDADERO;3;;;
119357;119342;0;18172;VERDADERO;VERDADERO;15;;;
119357;119342;0;18173;VERDADERO;VERDADERO;15;;;
119357;119342;0;18174;VERDADERO;VERDADERO;15;;;
119357;119362;0;18175;VERDADERO;VERDADERO;-5;;;
119357;119362;0;18176;VERDADERO;VERDADERO;-5;;;
119357;119382;0;18177;VERDADERO;VERDADERO;-25;;;
119392;119382;0;18178;VERDADERO;VERDADERO;10;;;
119392;119382;0;18179;VERDADERO;VERDADERO;10;;;
119392;119382;0;18180;VERDADERO;VERDADERO;10;;;
119392;119402;0;18181;VERDADERO;VERDADERO;-10;;;
119392;119402;0;18182;VERDADERO;VERDADERO;-10;;;
119425;119422;1;18183;VERDADERO;VERDADERO;3;;;
119425;119422;0;18184;VERDADERO;VERDADERO;3;;;
119425;119422;0;18185;VERDADERO;VERDADERO;3;;;
119425;119442;0;18186;VERDADERO;VERDADERO;-17;;;
119425;119442;0;18187;VERDADERO;VERDADERO;-17;;;
119457;119462;1;18188;VERDADERO;VERDADERO;-5;;;
119457;119462;0;18189;VERDADERO;VERDADERO;-5;;;
119457;119462;0;18190;VERDADERO;VERDADERO;-5;;;
119457;119482;0;18191;VERDADERO;VERDADERO;-25;;;
119457;119482;0;18192;VERDADERO;VERDADERO;-25;;;
119457;119502;0;18193;VERDADERO;VERDADERO;-45;;;
119492;119502;0;18194;VERDADERO;VERDADERO;-10;;;
119492;119502;0;18195;VERDADERO;VERDADERO;-10;;;
119492;119502;0;18196;VERDADERO;VERDADERO;-10;;;
119492;119522;0;18197;VERDADERO;VERDADERO;-30;;;
119492;119522;0;18198;VERDADERO;VERDADERO;-30;;;
119525;119542;0;18199;VERDADERO;VERDADERO;-17;;;
119525;119542;0;18200;VERDADERO;VERDADERO;-17;;;
119525;119542;0;18201;VERDADERO;VERDADERO;-17;;;
119525;119542;0;18202;VERDADERO;VERDADERO;-17;;;
119525;119542;0;18203;VERDADERO;VERDADERO;-17;;;
119525;119542;0;18204;VERDADERO;VERDADERO;-17;;;
119560;119542;0;18205;VERDADERO;VERDADERO;18;;;
119560;119542;0;18206;VERDADERO;VERDADERO;18;;;
119597;119602;1;18207;VERDADERO;VERDADERO;-5;;;
119629;119642;1;18208;VERDADERO;VERDADERO;-13;;;
119661;119662;1;18209;VERDADERO;VERDADERO;-1;;;
119697;119702;0;18210;VERDADERO;VERDADERO;-5;;;
119731;119742;0;18211;VERDADERO;VERDADERO;-11;;;
119765;119782;1;18212;VERDADERO;VERDADERO;-17;;;
119797;119802;1;18213;VERDADERO;VERDADERO;-5;;;
119829;119842;0;18214;VERDADERO;VERDADERO;-13;;;
119863;119882;0;18215;VERDADERO;VERDADERO;-19;;;
119893;119902;1;18216;VERDADERO;VERDADERO;-9;;;
119929;119942;1;18217;VERDADERO;VERDADERO;-13;;;
119961;119962;1;18218;VERDADERO;VERDADERO;-1;;;
119998;120002;0;18219;VERDADERO;VERDADERO;-4;;;
120024;120042;0;18220;VERDADERO;VERDADERO;-18;;;
120057;120062;1;18221;VERDADERO;VERDADERO;-5;;;
120089;120102;1;18222;VERDADERO;VERDADERO;-13;;;
120089;120122;0;18223;VERDADERO;VERDADERO;-33;;;
120120;120142;0;18224;VERDADERO;VERDADERO;-22;;;
120120;120142;0;18225;VERDADERO;VERDADERO;-22;;;
120120;120162;1;18226;VERDADERO;VERDADERO;-42;;;
120120;120162;0;18227;VERDADERO;VERDADERO;-42;;;
120120;120162;0;18228;VERDADERO;VERDADERO;-42;;;
120157;120162;0;18229;VERDADERO;VERDADERO;-5;;;
120157;120162;0;18230;VERDADERO;VERDADERO;-5;;;
120157;120162;0;18231;VERDADERO;VERDADERO;-5;;;
120157;120182;0;18232;VERDADERO;VERDADERO;-25;;;
120157;120182;0;18233;VERDADERO;VERDADERO;-25;;;
120189;120182;0;18234;VERDADERO;VERDADERO;7;;;
120189;120202;0;18235;VERDADERO;VERDADERO;-13;;;
120189;120202;0;18236;VERDADERO;VERDADERO;-13;;;
120189;120202;0;18237;VERDADERO;VERDADERO;-13;;;
120189;120202;0;18238;VERDADERO;VERDADERO;-13;;;
120189;120202;0;18239;VERDADERO;VERDADERO;-13;;;
120222;120222;1;18240;VERDADERO;VERDADERO;0;;;
120222;120222;0;18241;VERDADERO;VERDADERO;0;;;
120222;120243;0;18242;VERDADERO;VERDADERO;-21;;;
120222;120243;0;18243;VERDADERO;VERDADERO;-21;;;
120222;120243;0;18244;VERDADERO;VERDADERO;-21;;;
120256;120263;0;18245;VERDADERO;VERDADERO;-7;;;
120256;120263;0;18246;VERDADERO;VERDADERO;-7;;;
120256;120283;1;18247;VERDADERO;VERDADERO;-27;;;
120256;120283;0;18248;VERDADERO;VERDADERO;-27;;;
120256;120283;0;18249;VERDADERO;VERDADERO;-27;;;
120288;120303;0;18250;VERDADERO;VERDADERO;-15;;;
120288;120303;0;18251;VERDADERO;VERDADERO;-15;;;
120288;120323;0;18252;VERDADERO;VERDADERO;-35;;;
120288;120323;0;18253;VERDADERO;VERDADERO;-35;;;
120288;120323;0;18254;VERDADERO;VERDADERO;-35;;;
120288;120343;0;18255;VERDADERO;FALSO;-55;;;
120325;120343;0;18256;VERDADERO;VERDADERO;-18;;;
120325;120363;0;18257;VERDADERO;VERDADERO;-38;;;
120325;120363;0;18258;VERDADERO;VERDADERO;-38;;;
120325;120363;0;18259;VERDADERO;VERDADERO;-38;;;
120356;120363;0;18260;VERDADERO;VERDADERO;-7;;;
120356;120383;0;18261;VERDADERO;VERDADERO;-27;;;
120356;120383;0;18262;VERDADERO;VERDADERO;-27;;;
120356;120403;0;18263;VERDADERO;VERDADERO;-47;;;
120356;120403;0;18264;VERDADERO;VERDADERO;-47;;;
120356;120403;0;18265;VERDADERO;VERDADERO;-47;;;
120392;120403;0;18266;VERDADERO;VERDADERO;-11;;;
120392;120403;0;18267;VERDADERO;VERDADERO;-11;;;
120392;120423;0;18268;VERDADERO;VERDADERO;-31;;;
120392;120423;0;18269;VERDADERO;VERDADERO;-31;;;
120392;120423;0;18270;VERDADERO;VERDADERO;-31;;;
120425;120443;0;18271;VERDADERO;VERDADERO;-18;;;
120425;120443;0;18272;VERDADERO;VERDADERO;-18;;;
120425;120443;0;18273;VERDADERO;VERDADERO;-18;;;
120425;120443;0;18274;VERDADERO;VERDADERO;-18;;;
120425;120443;0;18275;VERDADERO;VERDADERO;-18;;;
120457;120463;0;18276;VERDADERO;VERDADERO;-6;;;
120457;120463;0;18277;VERDADERO;VERDADERO;-6;;;
120457;120463;0;18278;VERDADERO;VERDADERO;-6;;;
120457;120483;0;18279;VERDADERO;VERDADERO;-26;;;
120457;120483;0;18280;VERDADERO;VERDADERO;-26;;;
120457;120503;0;18281;VERDADERO;VERDADERO;-46;;;
120493;120503;0;18282;VERDADERO;VERDADERO;-10;;;
120493;120503;0;18283;VERDADERO;VERDADERO;-10;;;
120493;120523;0;18284;VERDADERO;VERDADERO;-30;;;
120493;120523;0;18285;VERDADERO;VERDADERO;-30;;;
120493;120543;0;18286;VERDADERO;FALSO;-50;;;
120528;120543;0;18287;VERDADERO;VERDADERO;-15;;;
120528;120543;0;18288;VERDADERO;VERDADERO;-15;;;
120528;120543;0;18289;VERDADERO;VERDADERO;-15;;;
120528;120543;0;18290;VERDADERO;VERDADERO;-15;;;
120528;120563;0;18291;VERDADERO;VERDADERO;-35;;;
120528;120563;0;18292;VERDADERO;VERDADERO;-35;;;
120560;120583;0;18293;VERDADERO;VERDADERO;-23;;;
120560;120583;0;18294;VERDADERO;VERDADERO;-23;;;
120560;120583;0,00E+00;18295;VERDADERO;VERDADERO;-23;;;
120560;120583;0;18296;VERDADERO;VERDADERO;-23;;;
120560;120583;0;18297;VERDADERO;VERDADERO;-23;;;
120560;120583;0;18298;VERDADERO;VERDADERO;-23;;;
120597;120603;0;18299;VERDADERO;VERDADERO;-6;;;
120597;120603;0;18300;VERDADERO;VERDADERO;-6;;;
120597;120603;0;18301;VERDADERO;VERDADERO;-6;;;
120597;120623;0;18302;VERDADERO;VERDADERO;-26;;;
120597;120623;0;18303;VERDADERO;VERDADERO;-26;;;
120628;120643;0;18304;VERDADERO;VERDADERO;-15;;;
120628;120643;0;18305;VERDADERO;VERDADERO;-15;;;
120628;120643;0;18306;VERDADERO;VERDADERO;-15;;;
120628;120663;0;18307;VERDADERO;VERDADERO;-35;;;
120628;120663;0;18308;VERDADERO;VERDADERO;-35;;;
120661;120663;0;18309;VERDADERO;VERDADERO;-2;;;
120661;120683;0;18310;VERDADERO;VERDADERO;-22;;;
120661;120683;0;18311;VERDADERO;VERDADERO;-22;;;
120661;120703;0;18312;VERDADERO;VERDADERO;-42;;;
120661;120703;0;18313;VERDADERO;VERDADERO;-42;;;
120693;120703;0;18314;VERDADERO;VERDADERO;-10;;;
120693;120723;0;18315;VERDADERO;VERDADERO;-30;;;
120693;120723;0;18316;VERDADERO;VERDADERO;-30;;;
120693;120743;0;18317;VERDADERO;FALSO;-50;;;
120693;120743;0;18318;VERDADERO;FALSO;-50;;;
120724;120743;0;18319;VERDADERO;VERDADERO;-19;;;
120724;120743;0;18320;VERDADERO;VERDADERO;-19;;;
120724;120743;0;18321;VERDADERO;VERDADERO;-19;;;
120724;120743;0;18322;VERDADERO;VERDADERO;-19;;;
120724;120763;0;18323;VERDADERO;VERDADERO;-39;;;
120761;120763;0;18324;VERDADERO;VERDADERO;-2;;;
120761;120763;0;18325;VERDADERO;VERDADERO;-2;;;
120761;120783;0;18326;VERDADERO;VERDADERO;-22;;;
120761;120783;0;18327;VERDADERO;VERDADERO;-22;;;
120761;120803;0;18328;VERDADERO;VERDADERO;-42;;;
120792;120803;0;18329;VERDADERO;VERDADERO;-11;;;
120792;120803;0;18330;VERDADERO;VERDADERO;-11;;;
120792;120803;0;18331;VERDADERO;VERDADERO;-11;;;
120792;120823;1;18332;VERDADERO;VERDADERO;-31;;;
120792;120823;0;18333;VERDADERO;VERDADERO;-31;;;
120825;120843;0;18334;VERDADERO;VERDADERO;-18;;;
120825;120843;0;18335;VERDADERO;VERDADERO;-18;;;
120825;120843;0;18336;VERDADERO;VERDADERO;-18;;;
120825;120843;0;18337;VERDADERO;VERDADERO;-18;;;
120825;120843;0;18338;VERDADERO;VERDADERO;-18;;;
120825;120843;0;18339;VERDADERO;VERDADERO;-18;;;
120857;120843;0;18340;VERDADERO;VERDADERO;14;;;
120857;120863;0;18341;VERDADERO;VERDADERO;-6;;;
120857;120863;0;18342;VERDADERO;VERDADERO;-6;;;
120857;120863;0;18343;VERDADERO;VERDADERO;-6;;;
120857;120883;0;18344;VERDADERO;VERDADERO;-26;;;
120889;120883;0;18345;VERDADERO;VERDADERO;6;;;
120889;120903;0;18346;VERDADERO;VERDADERO;-14;;;
120889;120903;0;18347;VERDADERO;VERDADERO;-14;;;
120889;120903;0;18348;VERDADERO;VERDADERO;-14;;;
120889;120923;0;18349;VERDADERO;VERDADERO;-34;;;
120925;120923;0;18350;VERDADERO;VERDADERO;2;;;
120925;120943;0;18351;VERDADERO;VERDADERO;-18;;;
120925;120943;0;18352;VERDADERO;VERDADERO;-18;;;
120925;120943;0;18353;VERDADERO;VERDADERO;-18;;;
120925;120963;0;18354;VERDADERO;VERDADERO;-38;;;
120957;120963;0;18355;VERDADERO;VERDADERO;-6;;;
120957;120983;0;18356;VERDADERO;VERDADERO;-26;;;
120957;120983;0;18357;VERDADERO;VERDADERO;-26;;;
120957;120983;0;18358;VERDADERO;VERDADERO;-26;;;
120957;121003;0;18359;VERDADERO;VERDADERO;-46;;;
120989;121003;0;18360;VERDADERO;VERDADERO;-14;;;
120989;121003;0;18361;VERDADERO;VERDADERO;-14;;;
120989;121003;0;18362;VERDADERO;VERDADERO;-14;;;
120989;121003;0;18363;VERDADERO;VERDADERO;-14;;;
120989;121023;0;18364;VERDADERO;VERDADERO;-34;;;
121021;121023;0;18365;VERDADERO;VERDADERO;-2;;;
121021;121043;1;18366;VERDADERO;VERDADERO;-22;;;
121021;121043;0;18367;VERDADERO;VERDADERO;-22;;;
121021;121043;0;18368;VERDADERO;VERDADERO;-22;;;
121021;121063;0;18369;VERDADERO;VERDADERO;-42;;;
121053;121063;0;18370;VERDADERO;VERDADERO;-10;;;
121053;121063;0;18371;VERDADERO;VERDADERO;-10;;;
121053;121063;0;18372;VERDADERO;VERDADERO;-10;;;
121053;121083;0;18373;VERDADERO;VERDADERO;-30;;;
121053;121083;0;18374;VERDADERO;VERDADERO;-30;;;
121053;121103;0;18375;VERDADERO;FALSO;-50;;;
121088;121103;0;18376;VERDADERO;VERDADERO;-15;;;
121088;121103;0;18377;VERDADERO;VERDADERO;-15;;;
121088;121103;0;18378;VERDADERO;VERDADERO;-15;;;
121088;121103;0;18379;VERDADERO;VERDADERO;-15;;;
121088;121123;1;18380;VERDADERO;VERDADERO;-35;;;
121121;121123;0;18381;VERDADERO;VERDADERO;-2;;;
121121;121123;0;18382;VERDADERO;VERDADERO;-2;;;
121121;121143;0;18383;VERDADERO;VERDADERO;-22;;;
121121;121143;0;18384;VERDADERO;VERDADERO;-22;;;
121121;121163;0;18385;VERDADERO;VERDADERO;-42;;;
121121;121163;0;18386;VERDADERO;VERDADERO;-42;;;
121157;121163;0;18387;VERDADERO;VERDADERO;-6;;;
121157;121183;0;18388;VERDADERO;VERDADERO;-26;;;
121157;121183;0;18389;VERDADERO;VERDADERO;-26;;;
121157;121203;0;18390;VERDADERO;VERDADERO;-46;;;
121157;121203;0;18391;VERDADERO;VERDADERO;-46;;;
121189;121203;0;18392;VERDADERO;VERDADERO;-14;;;
121189;121203;0;18393;VERDADERO;VERDADERO;-14;;;
121189;121203;0;18394;VERDADERO;VERDADERO;-14;;;
121189;121203;0;18395;VERDADERO;VERDADERO;-14;;;
121189;121223;1;18396;VERDADERO;VERDADERO;-34;;;
121225;121223;0;18397;VERDADERO;VERDADERO;2;;;
121225;121223;0;18398;VERDADERO;VERDADERO;2;;;
121225;121243;0;18399;VERDADERO;VERDADERO;-18;;;
121225;121243;0;18400;VERDADERO;VERDADERO;-18;;;
121225;121263;0;18401;VERDADERO;VERDADERO;-38;;;
121225;121263;0;18402;VERDADERO;VERDADERO;-38;;;
121259;121263;0;18403;VERDADERO;VERDADERO;-4;;;
121259;121283;0;18404;VERDADERO;VERDADERO;-24;;;
121259;121283;0;18405;VERDADERO;VERDADERO;-24;;;
121259;121303;0;18406;VERDADERO;VERDADERO;-44;;;
121259;121303;0;18407;VERDADERO;VERDADERO;-44;;;
121288;121303;0;18408;VERDADERO;VERDADERO;-15;;;
121288;121303;0;18409;VERDADERO;VERDADERO;-15;;;
121288;121303;0;18410;VERDADERO;VERDADERO;-15;;;
121288;121303;0;18411;VERDADERO;VERDADERO;-15;;;
121288;121323;0;18412;VERDADERO;VERDADERO;-35;;;
121324;121323;0;18413;VERDADERO;VERDADERO;1;;;
121324;121343;0;18414;VERDADERO;VERDADERO;-19;;;
121324;121343;0;18415;VERDADERO;VERDADERO;-19;;;
121324;121343;0;18416;VERDADERO;VERDADERO;-19;;;
121324;121363;1;18417;VERDADERO;VERDADERO;-39;;;
121357;121363;0;18418;VERDADERO;VERDADERO;-6;;;
121357;121363;0;18419;VERDADERO;VERDADERO;-6;;;
121357;121383;0;18420;VERDADERO;VERDADERO;-26;;;
121357;121383;0;18421;VERDADERO;VERDADERO;-26;;;
121357;121403;0;18422;VERDADERO;VERDADERO;-46;;;
121357;121403;0;18423;VERDADERO;VERDADERO;-46;;;
121392;121403;0;18424;VERDADERO;VERDADERO;-11;;;
121392;121403;0;18425;VERDADERO;VERDADERO;-11;;;
121392;121403;0;18426;VERDADERO;VERDADERO;-11;;;
121392;121403;0;18427;VERDADERO;VERDADERO;-11;;;
121392;121423;0;18428;VERDADERO;VERDADERO;-31;;;
121425;121423;0;18429;VERDADERO;VERDADERO;2;;;
121425;121443;0;18430;VERDADERO;VERDADERO;-18;;;
121425;121443;0;18431;VERDADERO;VERDADERO;-18;;;
121425;121443;0;18432;VERDADERO;VERDADERO;-18;;;
121425;121463;0;18433;VERDADERO;VERDADERO;-38;;;
121461;121463;0;18434;VERDADERO;VERDADERO;-2;;;
121461;121463;0;18435;VERDADERO;VERDADERO;-2;;;
121461;121463;0;18436;VERDADERO;VERDADERO;-2;;;
121461;121483;0;18437;VERDADERO;VERDADERO;-22;;;
121461;121483;0;18438;VERDADERO;VERDADERO;-22;;;
121493;121503;0;18439;VERDADERO;VERDADERO;-10;;;
121493;121503;0;18440;VERDADERO;VERDADERO;-10;;;
121493;121523;0;18441;VERDADERO;VERDADERO;-30;;;
121493;121523;0;18442;VERDADERO;VERDADERO;-30;;;
121493;121523;0;18443;VERDADERO;VERDADERO;-30;;;
121525;121523;0;18444;VERDADERO;VERDADERO;2;;;
121525;121543;0;18445;VERDADERO;VERDADERO;-18;;;
121525;121543;0;18446;VERDADERO;VERDADERO;-18;;;
121525;121563;0;18447;VERDADERO;VERDADERO;-38;;;
121525;121563;0;18448;VERDADERO;VERDADERO;-38;;;
121525;121563;0;18449;VERDADERO;VERDADERO;-38;;;
121561;121583;1;18450;VERDADERO;VERDADERO;-22;;;
121561;121583;0;18451;VERDADERO;VERDADERO;-22;;;
121561;121603;1;18452;VERDADERO;VERDADERO;-42;;;
121561;121603;0;18453;VERDADERO;VERDADERO;-42;;;
121561;121603;0;18454;VERDADERO;VERDADERO;-42;;;
121592;121623;0;18455;VERDADERO;VERDADERO;-31;;;
121592;121623;0;18456;VERDADERO;VERDADERO;-31;;;
121592;121623;0;18457;VERDADERO;VERDADERO;-31;;;
121592;121623;0;18458;VERDADERO;VERDADERO;-31;;;
121592;121623;0;18459;VERDADERO;VERDADERO;-31;;;
121625;121623;0;18460;VERDADERO;VERDADERO;2;;;
121625;121643;0;18461;VERDADERO;VERDADERO;-18;;;
121625;121643;0;18462;VERDADERO;VERDADERO;-18;;;
121625;121663;0;18463;VERDADERO;VERDADERO;-38;;;
121625;121663;0;18464;VERDADERO;VERDADERO;-38;;;
121625;121663;0;18465;VERDADERO;VERDADERO;-38;;;
121661;121663;0;18466;VERDADERO;VERDADERO;-2;;;
121661;121663;0;18467;VERDADERO;VERDADERO;-2;;;
121661;121663;0;18468;VERDADERO;VERDADERO;-2;;;
121661;121663;0;18469;VERDADERO;VERDADERO;-2;;;
121661;121683;1;18470;VERDADERO;VERDADERO;-22;;;
121693;121683;0;18471;VERDADERO;VERDADERO;10;;;
121693;121683;0;18472;VERDADERO;VERDADERO;10;;;
121693;121703;0;18473;VERDADERO;VERDADERO;-10;;;
121693;121703;0;18474;VERDADERO;VERDADERO;-10;;;
121693;121723;0;18475;VERDADERO;VERDADERO;-30;;;
121725;121723;0;18476;VERDADERO;VERDADERO;2;;;
121725;121723;0;18477;VERDADERO;VERDADERO;2;;;
121725;121743;0;18478;VERDADERO;VERDADERO;-18;;;
121725;121743;0;18479;VERDADERO;VERDADERO;-18;;;
121725;121743;0;18480;VERDADERO;VERDADERO;-18;;;
121725;121763;0;18481;VERDADERO;VERDADERO;-38;;;
121761;121763;0;18482;VERDADERO;VERDADERO;-2;;;
121761;121783;0;18483;VERDADERO;VERDADERO;-22;;;
121761;121783;0;18484;VERDADERO;VERDADERO;-22;;;
121761;121783;0;18485;VERDADERO;VERDADERO;-22;;;
121761;121803;0;18486;VERDADERO;VERDADERO;-42;;;
121793;121803;0;18487;VERDADERO;VERDADERO;-10;;;
121793;121803;0;18488;VERDADERO;VERDADERO;-10;;;
121793;121823;1;18489;VERDADERO;VERDADERO;-30;;;
121793;121823;0;18490;VERDADERO;VERDADERO;-30;;;
121793;121823;0;18491;VERDADERO;VERDADERO;-30;;;
121825;121823;0;18492;VERDADERO;VERDADERO;2;;;
121825;121823;0;18493;VERDADERO;VERDADERO;2;;;
121825;121843;0;18494;VERDADERO;VERDADERO;-18;;;
121825;121843;0;18495;VERDADERO;VERDADERO;-18;;;
121825;121843;0;18496;VERDADERO;VERDADERO;-18;;;
121861;121864;0;18497;VERDADERO;VERDADERO;-3;;;
121861;121864;0;18498;VERDADERO;VERDADERO;-3;;;
121861;121884;0;18499;VERDADERO;VERDADERO;-23;;;
121861;121884;0;18500;VERDADERO;VERDADERO;-23;;;
121861;121884;0;18501;VERDADERO;VERDADERO;-23;;;
121892;121904;0;18502;VERDADERO;VERDADERO;-12;;;
121892;121904;0;18503;VERDADERO;VERDADERO;-12;;;
121892;121904;0;18504;VERDADERO;VERDADERO;-12;;;
121892;121924;0;18505;VERDADERO;VERDADERO;-32;;;
121892;121924;0;18506;VERDADERO;VERDADERO;-32;;;
121892;121944;0;18507;VERDADERO;FALSO;-52;;;
121924;121944;0;18508;VERDADERO;VERDADERO;-20;;;
121924;121944;0;18509;VERDADERO;VERDADERO;-20;;;
121924;121944;0;18510;VERDADERO;VERDADERO;-20;;;
121924;121944;0;18511;VERDADERO;VERDADERO;-20;;;
121957;121944;0;18512;VERDADERO;VERDADERO;13;;;
121957;121944;0;18513;VERDADERO;VERDADERO;13;;;
121957;121944;0;18514;VERDADERO;VERDADERO;13;;;
121957;121944;0;18515;VERDADERO;VERDADERO;13;;;
121957;121944;0;18516;VERDADERO;VERDADERO;13;;;
121957;121944;0;18517;VERDADERO;VERDADERO;13;;;
121988;121964;0;18518;VERDADERO;VERDADERO;24;;;
121988;121964;0;18519;VERDADERO;VERDADERO;24;;;
121988;121984;0;18520;VERDADERO;VERDADERO;4;;;
121988;121984;0;18521;VERDADERO;VERDADERO;4;;;
121988;121984;0;18522;VERDADERO;VERDADERO;4;;;
122021;121984;0;18523;VERDADERO;VERDADERO;37;;;
122021;121984;0;18524;VERDADERO;VERDADERO;37;;;
122021;122004;1;18525;VERDADERO;VERDADERO;17;;;
122021;122004;0;18526;VERDADERO;VERDADERO;17;;;
122021;122004;0;18527;VERDADERO;VERDADERO;17;;;
122052;122024;0;18528;VERDADERO;VERDADERO;28;;;
122052;122024;0;18529;VERDADERO;VERDADERO;28;;;
122052;122044;0;18530;VERDADERO;VERDADERO;8;;;
122052;122044;0;18531;VERDADERO;VERDADERO;8;;;
122052;122044;0;18532;VERDADERO;VERDADERO;8;;;
122052;122064;0;18533;VERDADERO;VERDADERO;-12;;;
122088;122064;0;18534;VERDADERO;VERDADERO;24;;;
122088;122084;0;18535;VERDADERO;VERDADERO;4;;;
122088;122084;0;18536;VERDADERO;VERDADERO;4;;;
122088;122104;0;18537;VERDADERO;VERDADERO;-16;;;
122088;122104;0;18538;VERDADERO;VERDADERO;-16;;;
122121;122104;0;18539;VERDADERO;VERDADERO;17;;;
122121;122124;0;18540;VERDADERO;VERDADERO;-3;;;
122121;122124;0;18541;VERDADERO;VERDADERO;-3;;;
122121;122144;0;18542;VERDADERO;VERDADERO;-23;;;
122153;122144;0;18543;VERDADERO;VERDADERO;9;;;
122153;122144;0;18544;VERDADERO;VERDADERO;9;;;
122153;122164;0;18545;VERDADERO;VERDADERO;-11;;;
122153;122164;0;18546;VERDADERO;VERDADERO;-11;;;
122153;122184;1;18547;VERDADERO;VERDADERO;-31;;;
122153;122184;0;18548;VERDADERO;VERDADERO;-31;;;
122188;122184;0;18549;VERDADERO;VERDADERO;4;;;
122188;122184;0;18550;VERDADERO;VERDADERO;4;;;
122188;122184;0;18551;VERDADERO;VERDADERO;4;;;
122188;122204;0;18552;VERDADERO;VERDADERO;-16;;;
122188;122204;0;18553;VERDADERO;VERDADERO;-16;;;
122188;122204;0;18554;VERDADERO;VERDADERO;-16;;;
122221;122224;0;18555;VERDADERO;VERDADERO;-3;;;
122221;122224;0;18556;VERDADERO;VERDADERO;-3;;;
122221;122244;1;18557;VERDADERO;VERDADERO;-23;;;
122221;122244;0;18558;VERDADERO;VERDADERO;-23;;;
122221;122244;0;18559;VERDADERO;VERDADERO;-23;;;
122257;122244;0;18560;VERDADERO;VERDADERO;13;;;
122257;122244;0;18561;VERDADERO;VERDADERO;13;;;
122257;122244;0;18562;VERDADERO;VERDADERO;13;;;
122257;122244;0;18563;VERDADERO;VERDADERO;13;;;
122257;122244;0;18564;VERDADERO;VERDADERO;13;;;
122288;122264;0;18565;VERDADERO;VERDADERO;24;;;
122288;122264;0;18566;VERDADERO;VERDADERO;24;;;
122288;122264;0;18567;VERDADERO;VERDADERO;24;;;
122288;122284;0;18568;VERDADERO;VERDADERO;4;;;
122288;122284;0;18569;VERDADERO;VERDADERO;4;;;
122288;122304;0;18570;VERDADERO;VERDADERO;-16;;;
122324;122304;0;18571;VERDADERO;VERDADERO;20;;;
122324;122304;0;18572;VERDADERO;VERDADERO;20;;;
122324;122324;0;18573;VERDADERO;VERDADERO;0;;;
122324;122324;0;18574;VERDADERO;VERDADERO;0;;;
122324;122344;1;18575;VERDADERO;VERDADERO;-20;;;
122356;122344;0;18576;VERDADERO;VERDADERO;12;;;
122356;122344;0;18577;VERDADERO;VERDADERO;12;;;
122356;122364;0;18578;VERDADERO;VERDADERO;-8;;;
122356;122364;0;18579;VERDADERO;VERDADERO;-8;;;
122356;122384;0;18580;VERDADERO;VERDADERO;-28;;;
122393;122384;0;18581;VERDADERO;VERDADERO;9;;;
122393;122384;0;18582;VERDADERO;VERDADERO;9;;;
122393;122384;0;18583;VERDADERO;VERDADERO;9;;;
122393;122384;0;18584;VERDADERO;VERDADERO;9;;;
122393;122404;1;18585;VERDADERO;VERDADERO;-11;;;
122393;122404;0;18586;VERDADERO;VERDADERO;-11;;;
122428;122404;0;18587;VERDADERO;VERDADERO;24;;;
122428;122424;0;18588;VERDADERO;VERDADERO;4;;;
122428;122424;0;18589;VERDADERO;VERDADERO;4;;;
122428;122444;0;18590;VERDADERO;VERDADERO;-16;;;
122428;122444;0;18591;VERDADERO;VERDADERO;-16;;;
122460;122444;0;18592;VERDADERO;VERDADERO;16;;;
122460;122464;0;18593;VERDADERO;VERDADERO;-4;;;
122460;122464;0;18594;VERDADERO;VERDADERO;-4;;;
122460;122464;0;18595;VERDADERO;VERDADERO;-4;;;
122460;122484;0;18596;VERDADERO;VERDADERO;-24;;;
122492;122484;0;18597;VERDADERO;VERDADERO;8;;;
122492;122504;0;18598;VERDADERO;VERDADERO;-12;;;
122492;122504;0;18599;VERDADERO;VERDADERO;-12;;;
122492;122504;0;18600;VERDADERO;VERDADERO;-12;;;
122492;122524;0;18601;VERDADERO;VERDADERO;-32;;;
122525;122524;0;18602;VERDADERO;VERDADERO;1;;;
122525;122544;0;18603;VERDADERO;VERDADERO;-19;;;
122525;122544;0;18604;VERDADERO;VERDADERO;-19;;;
122525;122544;0;18605;VERDADERO;VERDADERO;-19;;;
122525;122564;0;18606;VERDADERO;VERDADERO;-39;;;
122557;122564;0;18607;VERDADERO;VERDADERO;-7;;;
122557;122564;0;18608;VERDADERO;VERDADERO;-7;;;
122557;122584;0;18609;VERDADERO;VERDADERO;-27;;;
122557;122584;0;18610;VERDADERO;VERDADERO;-27;;;
122557;122584;0;18611;VERDADERO;VERDADERO;-27;;;
122557;122604;0;18612;VERDADERO;VERDADERO;-47;;;
122592;122604;0;18613;VERDADERO;VERDADERO;-12;;;
122592;122604;0;18614;VERDADERO;VERDADERO;-12;;;
122592;122604;0;18615;VERDADERO;VERDADERO;-12;;;
122592;122604;0;18616;VERDADERO;VERDADERO;-12;;;
122592;122624;0;18617;VERDADERO;VERDADERO;-32;;;
122624;122624;0;18618;VERDADERO;VERDADERO;0;;;
122624;122624;0;18619;VERDADERO;VERDADERO;0;;;
122624;122644;0,00E+00;18620;VERDADERO;VERDADERO;-20;;;
122624;122644;0;18621;VERDADERO;VERDADERO;-20;;;
122624;122664;0;18622;VERDADERO;VERDADERO;-40;;;
122657;122664;0;18623;VERDADERO;VERDADERO;-7;;;
122657;122664;0;18624;VERDADERO;VERDADERO;-7;;;
122657;122664;0;18625;VERDADERO;VERDADERO;-7;;;
122657;122684;0;18626;VERDADERO;VERDADERO;-27;;;
122657;122684;0;18627;VERDADERO;VERDADERO;-27;;;
122657;122704;1;18628;VERDADERO;VERDADERO;-47;;;
122693;122704;0;18629;VERDADERO;VERDADERO;-11;;;
122693;122704;0;18630;VERDADERO;VERDADERO;-11;;;
122693;122704;0;18631;VERDADERO;VERDADERO;-11;;;
122693;122704;0;18632;VERDADERO;VERDADERO;-11;;;
122693;122724;0;18633;VERDADERO;VERDADERO;-31;;;
122725;122724;0;18634;VERDADERO;VERDADERO;1;;;
122725;122724;0;18635;VERDADERO;VERDADERO;1;;;
122725;122744;0;18636;VERDADERO;VERDADERO;-19;;;
122725;122744;0;18637;VERDADERO;VERDADERO;-19;;;
122725;122764;0;18638;VERDADERO;VERDADERO;-39;;;
122757;122764;0;18639;VERDADERO;VERDADERO;-7;;;
122757;122764;0;18640;VERDADERO;VERDADERO;-7;;;
122757;122784;0;18641;VERDADERO;VERDADERO;-27;;;
122757;122784;0;18642;VERDADERO;VERDADERO;-27;;;
122757;122784;0;18643;VERDADERO;VERDADERO;-27;;;
122757;122804;0;18644;VERDADERO;VERDADERO;-47;;;
122792;122804;0;18645;VERDADERO;VERDADERO;-12;;;
122792;122824;0;18646;VERDADERO;VERDADERO;-32;;;
122792;122824;0;18647;VERDADERO;VERDADERO;-32;;;
122792;122824;0;18648;VERDADERO;VERDADERO;-32;;;
122792;122844;0;18649;VERDADERO;FALSO;-52;;;
122824;122844;0;18650;VERDADERO;VERDADERO;-20;;;
122824;122864;0;18651;VERDADERO;VERDADERO;-40;;;
122824;122864;0;18652;VERDADERO;VERDADERO;-40;;;
122824;122864;0;18653;VERDADERO;VERDADERO;-40;;;
122824;122864;0;18654;VERDADERO;VERDADERO;-40;;;
122857;122884;0;18655;VERDADERO;VERDADERO;-27;;;
122857;122884;0;18656;VERDADERO;VERDADERO;-27;;;
122857;122884;0;18657;VERDADERO;VERDADERO;-27;;;
122857;122904;0;18658;VERDADERO;VERDADERO;-47;;;
122857;122904;0;18659;VERDADERO;VERDADERO;-47;;;
122893;122904;0;18660;VERDADERO;VERDADERO;-11;;;
122893;122904;0;18661;VERDADERO;VERDADERO;-11;;;
122893;122904;0;18662;VERDADERO;VERDADERO;-11;;;
122893;122904;0;18663;VERDADERO;VERDADERO;-11;;;
122893;122904;0;18664;VERDADERO;VERDADERO;-11;;;
122893;122924;0;18665;VERDADERO;VERDADERO;-31;;;
122924;122924;0;18666;VERDADERO;VERDADERO;0;;;
122924;122924;0;18667;VERDADERO;VERDADERO;0;;;
122924;122944;0;18668;VERDADERO;VERDADERO;-20;;;
122924;122944;0;18669;VERDADERO;VERDADERO;-20;;;
122956;122964;0;18670;VERDADERO;VERDADERO;-8;;;
122956;122964;0;18671;VERDADERO;VERDADERO;-8;;;
122956;122964;0;18672;VERDADERO;VERDADERO;-8;;;
122956;122984;0;18673;VERDADERO;VERDADERO;-28;;;
122956;122984;0;18674;VERDADERO;VERDADERO;-28;;;
122956;123004;1;18675;VERDADERO;VERDADERO;-48;;;
122993;123004;0;18676;VERDADERO;VERDADERO;-11;;;
122993;123004;0;18677;VERDADERO;VERDADERO;-11;;;
122993;123004;0;18678;VERDADERO;VERDADERO;-11;;;
122993;123004;0;18679;VERDADERO;VERDADERO;-11;;;
122993;123004;0;18680;VERDADERO;VERDADERO;-11;;;
123025;123024;1;18681;VERDADERO;VERDADERO;1;;;
123025;123024;0;18682;VERDADERO;VERDADERO;1;;;
123025;123045;0;18683;VERDADERO;VERDADERO;-20;;;
123025;123045;0;18684;VERDADERO;VERDADERO;-20;;;
123025;123045;0;18685;VERDADERO;VERDADERO;-20;;;
123056;123065;0;18686;VERDADERO;VERDADERO;-9;;;
123056;123065;0;18687;VERDADERO;VERDADERO;-9;;;
123056;123065;0;18688;VERDADERO;VERDADERO;-9;;;
123056;123065;0;18689;VERDADERO;VERDADERO;-9;;;
123056;123085;0;18690;VERDADERO;VERDADERO;-29;;;
123056;123085;0;18691;VERDADERO;VERDADERO;-29;;;
123093;123105;0;18692;VERDADERO;VERDADERO;-12;;;
123093;123105;0;18693;VERDADERO;VERDADERO;-12;;;
123093;123105;0;18694;VERDADERO;VERDADERO;-12;;;
123093;123125;0;18695;VERDADERO;VERDADERO;-32;;;
123093;123125;0;18696;VERDADERO;VERDADERO;-32;;;
123125;123125;0;18697;VERDADERO;VERDADERO;0;;;
123125;123125;0;18698;VERDADERO;VERDADERO;0;;;
123125;123125;0;18699;VERDADERO;VERDADERO;0;;;
123125;123145;0;18700;VERDADERO;VERDADERO;-20;;;
123125;123145;0;18701;VERDADERO;VERDADERO;-20;;;
123156;123165;0;18702;VERDADERO;VERDADERO;-9;;;
123156;123165;0;18703;VERDADERO;VERDADERO;-9;;;
123156;123165;0;18704;VERDADERO;VERDADERO;-9;;;
123156;123165;0;18705;VERDADERO;VERDADERO;-9;;;
123156;123165;0;18706;VERDADERO;VERDADERO;-9;;;
123189;123165;0;18707;VERDADERO;VERDADERO;24;;;
123189;123165;0;18708;VERDADERO;VERDADERO;24;;;
123189;123185;0;18709;VERDADERO;VERDADERO;4;;;
123189;123185;0;18710;VERDADERO;VERDADERO;4;;;
123189;123185;0;18711;VERDADERO;VERDADERO;4;;;
123221;123205;0;18712;VERDADERO;VERDADERO;16;;;
123221;123205;0;18713;VERDADERO;VERDADERO;16;;;
123221;123225;0;18714;VERDADERO;VERDADERO;-4;;;
123221;123225;0;18715;VERDADERO;VERDADERO;-4;;;
123221;123225;0;18716;VERDADERO;VERDADERO;-4;;;
123221;123245;0;18717;VERDADERO;VERDADERO;-24;;;
123256;123245;0;18718;VERDADERO;VERDADERO;11;;;
123256;123245;0;18719;VERDADERO;VERDADERO;11;;;
123256;123245;0;18720;VERDADERO;VERDADERO;11;;;
123256;123245;0;18721;VERDADERO;VERDADERO;11;;;
123256;123245;0;18722;VERDADERO;VERDADERO;11;;;
123288;123245;0;18723;VERDADERO;VERDADERO;43;;;
123288;123245;0;18724;VERDADERO;VERDADERO;43;;;
123288;123265;0;18725;VERDADERO;VERDADERO;23;;;
123288;123265;0;18726;VERDADERO;VERDADERO;23;;;
123288;123265;0;18727;VERDADERO;VERDADERO;23;;;
123321;123285;1;18728;VERDADERO;VERDADERO;36;;;
123321;123285;0;18729;VERDADERO;VERDADERO;36;;;
123321;123285;0;18730;VERDADERO;VERDADERO;36;;;
123321;123285;0;18731;VERDADERO;VERDADERO;36;;;
123321;123285;0;18732;VERDADERO;VERDADERO;36;;;
123321;123305;0;18733;VERDADERO;VERDADERO;16;;;
123357;123305;0;18734;FALSO;VERDADERO;52;;;
123357;123325;0;18735;VERDADERO;VERDADERO;32;;;
123357;123325;0;18736;VERDADERO;VERDADERO;32;;;
123357;123325;0;18737;VERDADERO;VERDADERO;32;;;
123357;123345;0;18738;VERDADERO;VERDADERO;12;;;
123389;123345;0;18739;VERDADERO;VERDADERO;44;;;
123389;123365;0;18740;VERDADERO;VERDADERO;24;;;
123389;123365;0;18741;VERDADERO;VERDADERO;24;;;
123389;123365;0;18742;VERDADERO;VERDADERO;24;;;
123389;123385;0;18743;VERDADERO;VERDADERO;4;;;
123421;123385;0;18744;VERDADERO;VERDADERO;36;;;
123421;123405;1;18745;VERDADERO;VERDADERO;16;;;
123421;123405;0;18746;VERDADERO;VERDADERO;16;;;
123421;123405;0;18747;VERDADERO;VERDADERO;16;;;
123421;123425;0;18748;VERDADERO;VERDADERO;-4;;;
123421;123425;0;18749;VERDADERO;VERDADERO;-4;;;
123457;123445;1;18750;VERDADERO;VERDADERO;12;;;
123457;123445;0;18751;VERDADERO;VERDADERO;12;;;
123457;123465;0;18752;VERDADERO;VERDADERO;-8;;;
123457;123465;0;18753;VERDADERO;VERDADERO;-8;;;
123457;123465;0;18754;VERDADERO;VERDADERO;-8;;;
123488;123485;0;18755;VERDADERO;VERDADERO;3;;;
123488;123485;0;18756;VERDADERO;VERDADERO;3;;;
123488;123485;0;18757;VERDADERO;VERDADERO;3;;;
123488;123485;0;18758;VERDADERO;VERDADERO;3;;;
123488;123485;0;18759;VERDADERO;VERDADERO;3;;;
123520;123485;0;18760;VERDADERO;VERDADERO;35;;;
123520;123505;0;18761;VERDADERO;VERDADERO;15;;;
123520;123505;0;18762;VERDADERO;VERDADERO;15;;;
123520;123505;0;18763;VERDADERO;VERDADERO;15;;;
123520;123525;0;18764;VERDADERO;VERDADERO;-5;;;
123557;123525;0;18765;VERDADERO;VERDADERO;32;;;
123557;123525;0;18766;VERDADERO;VERDADERO;32;;;
123557;123525;0;18767;VERDADERO;VERDADERO;32;;;
123557;123545;0;18768;VERDADERO;VERDADERO;12;;;
123557;123545;0;18769;VERDADERO;VERDADERO;12;;;
123588;123545;0;18770;VERDADERO;VERDADERO;43;;;
123588;123565;0;18771;VERDADERO;VERDADERO;23;;;
123588;123565;0;18772;VERDADERO;VERDADERO;23;;;
123588;123585;0;18773;VERDADERO;VERDADERO;3;;;
123588;123585;0;18774;VERDADERO;VERDADERO;3;;;
123588;123585;0;18775;VERDADERO;VERDADERO;3;;;
123620;123605;0;18776;VERDADERO;VERDADERO;15;;;
123620;123605;0;18777;VERDADERO;VERDADERO;15;;;
123620;123625;0;18778;VERDADERO;VERDADERO;-5;;;
123620;123625;0;18779;VERDADERO;VERDADERO;-5;;;
123620;123625;0;18780;VERDADERO;VERDADERO;-5;;;
123653;123645;0;18781;VERDADERO;VERDADERO;8;;;
123653;123645;0;18782;VERDADERO;VERDADERO;8;;;
123653;123665;0;18783;VERDADERO;VERDADERO;-12;;;
123653;123665;0;18784;VERDADERO;VERDADERO;-12;;;
123685;123665;0;18785;VERDADERO;VERDADERO;20;;;
123685;123665;0;18786;VERDADERO;VERDADERO;20;;;
123685;123685;0;18787;VERDADERO;VERDADERO;0;;;
123685;123685;0;18788;VERDADERO;VERDADERO;0;;;
123685;123685;0;18789;VERDADERO;VERDADERO;0;;;
123685;123705;0;18790;VERDADERO;VERDADERO;-20;;;
123721;123705;0;18791;VERDADERO;VERDADERO;16;;;
123721;123705;0;18792;VERDADERO;VERDADERO;16;;;
123721;123725;0;18793;VERDADERO;VERDADERO;-4;;;
123721;123725;0;18794;VERDADERO;VERDADERO;-4;;;
123721;123725;0;18795;VERDADERO;VERDADERO;-4;;;
123753;123745;0;18796;VERDADERO;VERDADERO;8;;;
123753;123745;0;18797;VERDADERO;VERDADERO;8;;;
123753;123765;1;18798;VERDADERO;VERDADERO;-12;;;
123753;123765;0;18799;VERDADERO;VERDADERO;-12;;;
123753;123765;0;18800;VERDADERO;VERDADERO;-12;;;
123784;123785;0;18801;VERDADERO;VERDADERO;-1;;;
123784;123785;0;18802;VERDADERO;VERDADERO;-1;;;
123784;123805;0;18803;VERDADERO;VERDADERO;-21;;;
123784;123805;0;18804;VERDADERO;VERDADERO;-21;;;
123784;123805;0;18805;VERDADERO;VERDADERO;-21;;;
123816;123825;0;18806;VERDADERO;VERDADERO;-9;;;
123816;123825;0;18807;VERDADERO;VERDADERO;-9;;;
123816;123845;1;18808;VERDADERO;VERDADERO;-29;;;
123816;123845;0;18809;VERDADERO;VERDADERO;-29;;;
123816;123845;0;18810;VERDADERO;VERDADERO;-29;;;
123816;123865;0;18811;VERDADERO;VERDADERO;-49;;;
123850;123865;0;18812;VERDADERO;VERDADERO;-15;;;
123850;123885;0;18813;VERDADERO;VERDADERO;-35;;;
123850;123885;0;18814;VERDADERO;VERDADERO;-35;;;
123850;123885;0;18815;VERDADERO;VERDADERO;-35;;;
123850;123885;0;18816;VERDADERO;VERDADERO;-35;;;
123885;123885;0;18817;VERDADERO;VERDADERO;0;;;
123885;123885;0;18818;VERDADERO;VERDADERO;0;;;
123885;123905;1;18819;VERDADERO;VERDADERO;-20;;;
123885;123905;0;18820;VERDADERO;VERDADERO;-20;;;
123885;123925;0;18821;VERDADERO;VERDADERO;-40;;;
123917;123925;0;18822;VERDADERO;VERDADERO;-8;;;
123917;123925;0;18823;VERDADERO;VERDADERO;-8;;;
123917;123925;0;18824;VERDADERO;VERDADERO;-8;;;
123917;123925;0;18825;VERDADERO;VERDADERO;-8;;;
123917;123945;0;18826;VERDADERO;VERDADERO;-28;;;
123949;123945;0;18827;VERDADERO;VERDADERO;4;;;
123949;123945;0;18828;VERDADERO;VERDADERO;4;;;
123949;123966;0;18829;VERDADERO;VERDADERO;-17;;;
123949;123966;0;18830;VERDADERO;VERDADERO;-17;;;
123949;123986;0;18831;VERDADERO;VERDADERO;-37;;;
123949;123986;0;18832;VERDADERO;VERDADERO;-37;;;
123984;123986;0;18833;VERDADERO;VERDADERO;-2;;;
123984;123986;0;18834;VERDADERO;VERDADERO;-2;;;
123984;124006;0;18835;VERDADERO;VERDADERO;-22;;;
123984;124006;0;18836;VERDADERO;VERDADERO;-22;;;
123984;124026;0;18837;VERDADERO;VERDADERO;-42;;;
124016;124026;0;18838;VERDADERO;VERDADERO;-10;;;
124016;124026;0;18839;VERDADERO;VERDADERO;-10;;;
124016;124046;0;18840;VERDADERO;VERDADERO;-30;;;
124016;124046;0;18841;VERDADERO;VERDADERO;-30;;;
124016;124046;0;18842;VERDADERO;VERDADERO;-30;;;
124048;124046;0;18843;VERDADERO;VERDADERO;2;;;
124048;124046;0;18844;VERDADERO;VERDADERO;2;;;
124048;124046;0;18845;VERDADERO;VERDADERO;2;;;
124048;124046;0;18846;VERDADERO;VERDADERO;2;;;
124048;124046;0;18847;VERDADERO;VERDADERO;2;;;
124048;124066;0;18848;VERDADERO;VERDADERO;-18;;;
124085;124066;0;18849;VERDADERO;VERDADERO;19;;;
124085;124066;0;18850;VERDADERO;VERDADERO;19;;;
124085;124086;0;18851;VERDADERO;VERDADERO;-1;;;
124085;124086;0;18852;VERDADERO;VERDADERO;-1;;;
124085;124086;0;18853;VERDADERO;VERDADERO;-1;;;
124116;124086;0;18854;VERDADERO;VERDADERO;30;;;
124116;124086;0;18855;VERDADERO;VERDADERO;30;;;
124116;124086;0;18856;VERDADERO;VERDADERO;30;;;
124116;124086;0;18857;VERDADERO;VERDADERO;30;;;
124116;124106;0;18858;VERDADERO;VERDADERO;10;;;
124116;124106;0;18859;VERDADERO;VERDADERO;10;;;
124153;124106;0;18860;VERDADERO;VERDADERO;47;;;
124153;124126;0;18861;VERDADERO;VERDADERO;27;;;
124153;124126;0;18862;VERDADERO;VERDADERO;27;;;
124153;124146;0;18863;VERDADERO;VERDADERO;7;;;
124153;124146;0;18864;VERDADERO;VERDADERO;7;;;
124184;124146;0;18865;VERDADERO;VERDADERO;38;;;
124184;124166;0;18866;VERDADERO;VERDADERO;18;;;
124184;124166;0;18867;VERDADERO;VERDADERO;18;;;
124184;124186;0;18868;VERDADERO;VERDADERO;-2;;;
124184;124186;0;18869;VERDADERO;VERDADERO;-2;;;
124184;124186;0;18870;VERDADERO;VERDADERO;-2;;;
124221;124206;1;18871;VERDADERO;VERDADERO;15;;;
124221;124206;0;18872;VERDADERO;VERDADERO;15;;;
124221;124226;0;18873;VERDADERO;VERDADERO;-5;;;
124221;124226;0;18874;VERDADERO;VERDADERO;-5;;;
124253;124226;0;18875;VERDADERO;VERDADERO;27;;;
124253;124246;0;18876;VERDADERO;VERDADERO;7;;;
124253;124246;0;18877;VERDADERO;VERDADERO;7;;;
124253;124266;0;18878;VERDADERO;VERDADERO;-13;;;
124253;124266;0;18879;VERDADERO;VERDADERO;-13;;;
124253;124266;0;18880;VERDADERO;VERDADERO;-13;;;
124288;124286;0;18881;VERDADERO;VERDADERO;2;;;
124288;124286;0;18882;VERDADERO;VERDADERO;2;;;
124288;124306;0;18883;VERDADERO;VERDADERO;-18;;;
124288;124306;0;18884;VERDADERO;VERDADERO;-18;;;
124288;124306;0;18885;VERDADERO;VERDADERO;-18;;;
124321;124326;0;18886;VERDADERO;VERDADERO;-5;;;
124321;124326;0;18887;VERDADERO;VERDADERO;-5;;;
124321;124326;0;18888;VERDADERO;VERDADERO;-5;;;
124321;124346;0;18889;VERDADERO;VERDADERO;-25;;;
124321;124346;0;18890;VERDADERO;VERDADERO;-25;;;
124321;124346;0;18891;VERDADERO;VERDADERO;-25;;;
124356;124366;0;18892;VERDADERO;VERDADERO;-10;;;
124356;124366;0;18893;VERDADERO;VERDADERO;-10;;;
124356;124386;0;18894;VERDADERO;VERDADERO;-30;;;
124356;124386;0;18895;VERDADERO;VERDADERO;-30;;;
124356;124386;0;18896;VERDADERO;VERDADERO;-30;;;
124388;124386;0;18897;VERDADERO;VERDADERO;2;;;
124388;124386;0;18898;VERDADERO;VERDADERO;2;;;
124388;124386;0;18899;VERDADERO;VERDADERO;2;;;
124388;124406;0;18900;VERDADERO;VERDADERO;-18;;;
124388;124406;0;18901;VERDADERO;VERDADERO;-18;;;
124425;124406;0;18902;VERDADERO;VERDADERO;19;;;
124425;124426;0;18903;VERDADERO;VERDADERO;-1;;;
124425;124426;0;18904;VERDADERO;VERDADERO;-1;;;
124425;124426;0;18905;VERDADERO;VERDADERO;-1;;;
124425;124426;0;18906;VERDADERO;VERDADERO;-1;;;
124425;124426;0;18907;VERDADERO;VERDADERO;-1;;;
124456;124446;1;18908;VERDADERO;VERDADERO;10;;;
124456;124446;0;18909;VERDADERO;VERDADERO;10;;;
124456;124466;0;18910;VERDADERO;VERDADERO;-10;;;
124456;124466;0;18911;VERDADERO;VERDADERO;-10;;;
124456;124466;0;18912;VERDADERO;VERDADERO;-10;;;
124488;124486;0;18913;VERDADERO;VERDADERO;2;;;
124488;124486;0;18914;VERDADERO;VERDADERO;2;;;
124488;124506;0;18915;VERDADERO;VERDADERO;-18;;;
124488;124506;0;18916;VERDADERO;VERDADERO;-18;;;
124488;124506;0;18917;VERDADERO;VERDADERO;-18;;;
124524;124526;0;18918;VERDADERO;VERDADERO;-2;;;
124524;124526;0;18919;VERDADERO;VERDADERO;-2;;;
124524;124546;1;18920;VERDADERO;VERDADERO;-22;;;
124524;124546;0;18921;VERDADERO;VERDADERO;-22;;;
124524;124546;0;18922;VERDADERO;VERDADERO;-22;;;
124557;124566;1;18923;VERDADERO;VERDADERO;-9;;;
124557;124566;0;18924;VERDADERO;VERDADERO;-9;;;
124557;124566;0;18925;VERDADERO;VERDADERO;-9;;;
124557;124586;1;18926;VERDADERO;VERDADERO;-29;;;
124557;124586;0;18927;VERDADERO;VERDADERO;-29;;;
124588;124606;0;18928;VERDADERO;VERDADERO;-18;;;
124588;124606;0;18929;VERDADERO;VERDADERO;-18;;;
124588;124606;0;18930;VERDADERO;VERDADERO;-18;;;
124588;124626;1;18931;VERDADERO;VERDADERO;-38;;;
124588;124626;0;18932;VERDADERO;VERDADERO;-38;;;
124588;124646;0;18933;VERDADERO;FALSO;-58;;;
124624;124646;0;18934;VERDADERO;VERDADERO;-22;;;
124624;124646;0;18935;VERDADERO;VERDADERO;-22;;;
124624;124646;0;18936;VERDADERO;VERDADERO;-22;;;
124624;124646;0;18937;VERDADERO;VERDADERO;-22;;;
124624;124666;0;18938;VERDADERO;VERDADERO;-42;;;
124657;124666;0;18939;VERDADERO;VERDADERO;-9;;;
124657;124686;0;18940;VERDADERO;VERDADERO;-29;;;
124657;124686;0;18941;VERDADERO;VERDADERO;-29;;;
124657;124686;0;18942;VERDADERO;VERDADERO;-29;;;
124657;124686;0;18943;VERDADERO;VERDADERO;-29;;;
124689;124686;0;18944;VERDADERO;VERDADERO;3;;;
124689;124686;0;18945;VERDADERO;VERDADERO;3;;;
124689;124706;0;18946;VERDADERO;VERDADERO;-17;;;
124689;124706;0;18947;VERDADERO;VERDADERO;-17;;;
124689;124726;0;18948;VERDADERO;VERDADERO;-37;;;
124725;124726;0;18949;VERDADERO;VERDADERO;-1;;;
124725;124726;0;18950;VERDADERO;VERDADERO;-1;;;
124725;124746;0;18951;VERDADERO;VERDADERO;-21;;;
124725;124746;0;18952;VERDADERO;VERDADERO;-21;;;
124725;124746;0;18953;VERDADERO;VERDADERO;-21;;;
124757;124746;0;18954;VERDADERO;VERDADERO;11;;;
124757;124746;0;18955;VERDADERO;VERDADERO;11;;;
124757;124746;0;18956;VERDADERO;VERDADERO;11;;;
124757;124746;0;18957;VERDADERO;VERDADERO;11;;;
124757;124766;0;18958;VERDADERO;VERDADERO;-9;;;
124789;124766;0;18959;VERDADERO;VERDADERO;23;;;
124789;124766;0;18960;VERDADERO;VERDADERO;23;;;
124789;124786;0;18961;VERDADERO;VERDADERO;3;;;
124789;124786;0;18962;VERDADERO;VERDADERO;3;;;
124789;124806;0;18963;VERDADERO;VERDADERO;-17;;;
124820;124806;0;18964;VERDADERO;VERDADERO;14;;;
124820;124806;0;18965;VERDADERO;VERDADERO;14;;;
124820;124826;0;18966;VERDADERO;VERDADERO;-6;;;
124820;124826;0;18967;VERDADERO;VERDADERO;-6;;;
124820;124846;1;18968;VERDADERO;VERDADERO;-26;;;
124852;124846;0;18969;VERDADERO;VERDADERO;6;;;
124852;124846;0;18970;VERDADERO;VERDADERO;6;;;
124852;124866;0;18971;VERDADERO;VERDADERO;-14;;;
124852;124866;0;18972;VERDADERO;VERDADERO;-14;;;
124852;124866;0;18973;VERDADERO;VERDADERO;-14;;;
124852;124866;0;18974;VERDADERO;VERDADERO;-14;;;
124888;124866;0;18975;VERDADERO;VERDADERO;22;;;
124888;124886;0;18976;VERDADERO;VERDADERO;2;;;
124888;124886;0;18977;VERDADERO;VERDADERO;2;;;
124888;124906;1;18978;VERDADERO;VERDADERO;-18;;;
124888;124906;0;18979;VERDADERO;VERDADERO;-18;;;
124920;124906;0;18980;VERDADERO;VERDADERO;14;;;
124920;124926;1;18981;VERDADERO;VERDADERO;-6;;;
124920;124926;0;18982;VERDADERO;VERDADERO;-6;;;
124920;124946;1;18983;VERDADERO;VERDADERO;-26;;;
124920;124946;0;18984;VERDADERO;VERDADERO;-26;;;
124953;124946;0;18985;VERDADERO;VERDADERO;7;;;
124953;124966;1;18986;VERDADERO;VERDADERO;-13;;;
124953;124966;0;18987;VERDADERO;VERDADERO;-13;;;
124953;124986;0;18988;VERDADERO;VERDADERO;-33;;;
124953;124986;0;18989;VERDADERO;VERDADERO;-33;;;
124953;124986;0;18990;VERDADERO;VERDADERO;-33;;;
124988;125006;0;18991;VERDADERO;VERDADERO;-18;;;
124988;125006;0;18992;VERDADERO;VERDADERO;-18;;;
124988;125006;0;18993;VERDADERO;VERDADERO;-18;;;
124988;125026;0;18994;VERDADERO;VERDADERO;-38;;;
124988;125026;0;18995;VERDADERO;VERDADERO;-38;;;
125021;125026;0;18996;VERDADERO;VERDADERO;-5;;;
125021;125026;0;18997;VERDADERO;VERDADERO;-5;;;
125021;125026;0;18998;VERDADERO;VERDADERO;-5;;;
125021;125026;0;18999;VERDADERO;VERDADERO;-5;;;
125053;125026;0;19000;VERDADERO;VERDADERO;27;;;
125053;125026;0;19001;VERDADERO;VERDADERO;27;;;
125053;125026;0;19002;VERDADERO;VERDADERO;27;;;
125053;125026;0;19003;VERDADERO;VERDADERO;27;;;
125053;125026;0;19004;VERDADERO;VERDADERO;27;;;
125053;125046;0;19005;VERDADERO;VERDADERO;7;;;
125085;125046;0;19006;VERDADERO;VERDADERO;39;;;
125085;125066;0;19007;VERDADERO;VERDADERO;19;;;
125085;125066;0;19008;VERDADERO;VERDADERO;19;;;
125085;125066;0;19009;VERDADERO;VERDADERO;19;;;
125085;125086;1;19010;VERDADERO;VERDADERO;-1;;;
125116;125086;0;19011;VERDADERO;VERDADERO;30;;;
125116;125106;0;19012;VERDADERO;VERDADERO;10;;;
125116;125106;0;19013;VERDADERO;VERDADERO;10;;;
125116;125106;0;19014;VERDADERO;VERDADERO;10;;;
125116;125126;0;19015;VERDADERO;VERDADERO;-10;;;
125152;125126;0;19016;VERDADERO;VERDADERO;26;;;
125152;125146;0;19017;VERDADERO;VERDADERO;6;;;
125152;125146;0;19018;VERDADERO;VERDADERO;6;;;
125152;125146;0;19019;VERDADERO;VERDADERO;6;;;
125152;125166;0;19020;VERDADERO;VERDADERO;-14;;;
125185;125166;0;19021;VERDADERO;VERDADERO;19;;;
125185;125186;0;19022;VERDADERO;VERDADERO;-1;;;
125185;125186;0;19023;VERDADERO;VERDADERO;-1;;;
125185;125186;0;19024;VERDADERO;VERDADERO;-1;;;
125185;125206;0;19025;VERDADERO;VERDADERO;-21;;;
125217;125206;0;19026;VERDADERO;VERDADERO;11;;;
125217;125226;1;19027;VERDADERO;VERDADERO;-9;;;
125217;125226;0;19028;VERDADERO;VERDADERO;-9;;;
125217;125226;0;19029;VERDADERO;VERDADERO;-9;;;
125217;125246;0;19030;VERDADERO;VERDADERO;-29;;;
125249;125246;0;19031;VERDADERO;VERDADERO;3;;;
125249;125266;0;19032;VERDADERO;VERDADERO;-17;;;
125249;125266;0;19033;VERDADERO;VERDADERO;-17;;;
125249;125266;0;19034;VERDADERO;VERDADERO;-17;;;
125249;125286;0;19035;VERDADERO;VERDADERO;-37;;;
125282;125286;0;19036;VERDADERO;VERDADERO;-4;;;
125282;125306;0;19037;VERDADERO;VERDADERO;-24;;;
125282;125306;0;19038;VERDADERO;VERDADERO;-24;;;
125282;125306;0;19039;VERDADERO;VERDADERO;-24;;;
125282;125306;0;19040;VERDADERO;VERDADERO;-24;;;
125282;125306;0;19041;VERDADERO;VERDADERO;-24;;;
125316;125326;0;19042;VERDADERO;VERDADERO;-10;;;
125316;125326;0;19043;VERDADERO;VERDADERO;-10;;;
125316;125326;0;19044;VERDADERO;VERDADERO;-10;;;
125316;125346;0;19045;VERDADERO;VERDADERO;-30;;;
125316;125346;0;19046;VERDADERO;VERDADERO;-30;;;
125349;125366;1;19047;VERDADERO;VERDADERO;-17;;;
125349;125366;0;19048;VERDADERO;VERDADERO;-17;;;
125349;125366;0;19049;VERDADERO;VERDADERO;-17;;;
125349;125386;0;19050;VERDADERO;VERDADERO;-37;;;
125349;125386;0;19051;VERDADERO;VERDADERO;-37;;;
125349;125386;0;19052;VERDADERO;VERDADERO;-37;;;
125385;125406;0;19053;VERDADERO;VERDADERO;-21;;;
125385;125406;0;19054;VERDADERO;VERDADERO;-21;;;
125385;125406;0;19055;VERDADERO;VERDADERO;-21;;;
125385;125406;0;19056;VERDADERO;VERDADERO;-21;;;
125385;125406;0;19057;VERDADERO;VERDADERO;-21;;;
125416;125426;0;19058;VERDADERO;VERDADERO;-10;;;
125416;125426;0;19059;VERDADERO;VERDADERO;-10;;;
125416;125446;0;19060;VERDADERO;VERDADERO;-30;;;
125416;125446;0;19061;VERDADERO;VERDADERO;-30;;;
125416;125446;0;19062;VERDADERO;VERDADERO;-30;;;
125416;125466;1;19063;VERDADERO;FALSO;-50;;;
125453;125466;0;19064;VERDADERO;VERDADERO;-13;;;
125453;125466;0;19065;VERDADERO;VERDADERO;-13;;;
125453;125486;1;19066;VERDADERO;VERDADERO;-33;;;
125453;125486;0;19067;VERDADERO;VERDADERO;-33;;;
125485;125486;0;19068;VERDADERO;VERDADERO;-1;;;
125485;125506;0;19069;VERDADERO;VERDADERO;-21;;;
125485;125506;0;19070;VERDADERO;VERDADERO;-21;;;
125485;125506;0;19071;VERDADERO;VERDADERO;-21;;;
125485;125506;0;19072;VERDADERO;VERDADERO;-21;;;
125516;125526;0;19073;VERDADERO;VERDADERO;-10;;;
125516;125526;0;19074;VERDADERO;VERDADERO;-10;;;
125516;125526;0;19075;VERDADERO;VERDADERO;-10;;;
125516;125546;1;19076;VERDADERO;VERDADERO;-30;;;
125516;125546;0;19077;VERDADERO;VERDADERO;-30;;;
125516;125566;1;19078;VERDADERO;FALSO;-50;;;
125553;125566;0;19079;VERDADERO;VERDADERO;-13;;;
125553;125566;0;19080;VERDADERO;VERDADERO;-13;;;
125553;125566;0;19081;VERDADERO;VERDADERO;-13;;;
125553;125586;0;19082;VERDADERO;VERDADERO;-33;;;
125553;125586;0;19083;VERDADERO;VERDADERO;-33;;;
125585;125606;0;19084;VERDADERO;VERDADERO;-21;;;
125585;125606;0;19085;VERDADERO;VERDADERO;-21;;;
125585;125606;0;19086;VERDADERO;VERDADERO;-21;;;
125585;125606;0;19087;VERDADERO;VERDADERO;-21;;;
125585;125606;0;19088;VERDADERO;VERDADERO;-21;;;
125585;125606;0;19089;VERDADERO;VERDADERO;-21;;;
125620;125626;1;19090;VERDADERO;VERDADERO;-6;;;
125620;125626;0;19091;VERDADERO;VERDADERO;-6;;;
125620;125646;1;19092;VERDADERO;VERDADERO;-26;;;
125620;125646;0;19093;VERDADERO;VERDADERO;-26;;;
125620;125646;0;19094;VERDADERO;VERDADERO;-26;;;
125653;125666;0;19095;VERDADERO;VERDADERO;-13;;;
125653;125666;0;19096;VERDADERO;VERDADERO;-13;;;
125653;125686;0;19097;VERDADERO;VERDADERO;-33;;;
125653;125686;0;19098;VERDADERO;VERDADERO;-33;;;
125653;125686;0;19099;VERDADERO;VERDADERO;-33;;;
125688;125706;0;19100;VERDADERO;VERDADERO;-18;;;
125688;125706;0;19101;VERDADERO;VERDADERO;-18;;;
125688;125706;0;19102;VERDADERO;VERDADERO;-18;;;
125688;125726;0;19103;VERDADERO;VERDADERO;-38;;;
125688;125726;0;19104;VERDADERO;VERDADERO;-38;;;
125721;125726;0;19105;VERDADERO;VERDADERO;-5;;;
125721;125746;0;19106;VERDADERO;VERDADERO;-25;;;
125721;125746;0;19107;VERDADERO;VERDADERO;-25;;;
125721;125746;0;19108;VERDADERO;VERDADERO;-25;;;
125721;125746;0;19109;VERDADERO;VERDADERO;-25;;;
125721;125746;0;19110;VERDADERO;VERDADERO;-25;;;
125757;125766;1;19111;VERDADERO;VERDADERO;-9;;;
125757;125766;0;19112;VERDADERO;VERDADERO;-9;;;
125757;125766;0;19113;VERDADERO;VERDADERO;-9;;;
125757;125786;0;19114;VERDADERO;VERDADERO;-29;;;
125757;125786;0;19115;VERDADERO;VERDADERO;-29;;;
125789;125806;0;19116;VERDADERO;VERDADERO;-17;;;
125789;125806;0;19117;VERDADERO;VERDADERO;-17;;;
125789;125806;0;19118;VERDADERO;VERDADERO;-17;;;
125789;125826;0;19119;VERDADERO;VERDADERO;-37;;;
125789;125826;0;19120;VERDADERO;VERDADERO;-37;;;
125821;125826;0;19121;VERDADERO;VERDADERO;-5;;;
125821;125846;0;19122;VERDADERO;VERDADERO;-25;;;
125821;125846;0;19123;VERDADERO;VERDADERO;-25;;;
125821;125846;0;19124;VERDADERO;VERDADERO;-25;;;
125821;125846;0;19125;VERDADERO;VERDADERO;-25;;;
125852;125846;0;19126;VERDADERO;VERDADERO;6;;;
125852;125866;0;19127;VERDADERO;VERDADERO;-14;;;
125852;125866;0;19128;VERDADERO;VERDADERO;-14;;;
125852;125886;0;19129;VERDADERO;VERDADERO;-34;;;
125852;125886;0;19130;VERDADERO;VERDADERO;-34;;;
125885;125886;0;19131;VERDADERO;VERDADERO;-1;;;
125885;125906;0;19132;VERDADERO;VERDADERO;-21;;;
125885;125906;0;19133;VERDADERO;VERDADERO;-21;;;
125885;125926;0;19134;VERDADERO;VERDADERO;-41;;;
125885;125926;0;19135;VERDADERO;VERDADERO;-41;;;
125885;125926;0;19136;VERDADERO;VERDADERO;-41;;;
125921;125946;0;19137;VERDADERO;VERDADERO;-25;;;
125921;125946;0;19138;VERDADERO;VERDADERO;-25;;;
125921;125946;0;19139;VERDADERO;VERDADERO;-25;;;
125921;125946;0;19140;VERDADERO;VERDADERO;-25;;;
125921;125966;0;19141;VERDADERO;VERDADERO;-45;;;
125952;125966;0;19142;VERDADERO;VERDADERO;-14;;;
125952;125966;0;19143;VERDADERO;VERDADERO;-14;;;
125952;125986;0;19144;VERDADERO;VERDADERO;-34;;;
125952;125986;0;19145;VERDADERO;VERDADERO;-34;;;
125952;125986;0;19146;VERDADERO;VERDADERO;-34;;;
125984;125986;0;19147;VERDADERO;VERDADERO;-2;;;
125984;125986;0;19148;VERDADERO;VERDADERO;-2;;;
125984;126006;0;19149;VERDADERO;VERDADERO;-22;;;
125984;126006;0;19150;VERDADERO;VERDADERO;-22;;;
125984;126006;0;19151;VERDADERO;VERDADERO;-22;;;
126016;126026;0;19152;VERDADERO;VERDADERO;-10;;;
126016;126026;0;19153;VERDADERO;VERDADERO;-10;;;
126016;126026;0;19154;VERDADERO;VERDADERO;-10;;;
126016;126026;0;19155;VERDADERO;VERDADERO;-10;;;
126016;126046;0;19156;VERDADERO;VERDADERO;-30;;;
126016;126046;0;19157;VERDADERO;VERDADERO;-30;;;
126050;126046;0;19158;VERDADERO;VERDADERO;4;;;
126050;126067;0;19159;VERDADERO;VERDADERO;-17;;;
126050;126067;0;19160;VERDADERO;VERDADERO;-17;;;
126050;126087;0;19161;VERDADERO;VERDADERO;-37;;;
126050;126087;0;19162;VERDADERO;VERDADERO;-37;;;
126085;126087;0;19163;VERDADERO;VERDADERO;-2;;;
126085;126107;0;19164;VERDADERO;VERDADERO;-22;;;
126085;126107;0;19165;VERDADERO;VERDADERO;-22;;;
126085;126127;0;19166;VERDADERO;VERDADERO;-42;;;
126085;126127;0;19167;VERDADERO;VERDADERO;-42;;;
126117;126127;0;19168;VERDADERO;VERDADERO;-10;;;
126117;126127;0;19169;VERDADERO;VERDADERO;-10;;;
126117;126147;0;19170;VERDADERO;VERDADERO;-30;;;
126117;126147;0;19171;VERDADERO;VERDADERO;-30;;;
126117;126147;0;19172;VERDADERO;VERDADERO;-30;;;
126117;126167;0;19173;VERDADERO;FALSO;-50;;;
126153;126167;0;19174;VERDADERO;VERDADERO;-14;;;
126153;126167;0;19175;VERDADERO;VERDADERO;-14;;;
126153;126167;0;19176;VERDADERO;VERDADERO;-14;;;
126153;126167;0;19177;VERDADERO;VERDADERO;-14;;;
126153;126187;0;19178;VERDADERO;VERDADERO;-34;;;
126185;126187;0;19179;VERDADERO;VERDADERO;-2;;;
126185;126187;0;19180;VERDADERO;VERDADERO;-2;;;
126185;126207;0;19181;VERDADERO;VERDADERO;-22;;;
126185;126207;0;19182;VERDADERO;VERDADERO;-22;;;
126185;126227;0;19183;VERDADERO;VERDADERO;-42;;;
126220;126227;0;19184;VERDADERO;VERDADERO;-7;;;
126220;126227;0;19185;VERDADERO;VERDADERO;-7;;;
126220;126247;0;19186;VERDADERO;VERDADERO;-27;;;
126220;126247;0;19187;VERDADERO;VERDADERO;-27;;;
126220;126247;0;19188;VERDADERO;VERDADERO;-27;;;
126220;126267;0;19189;VERDADERO;VERDADERO;-47;;;
126252;126267;0;19190;VERDADERO;VERDADERO;-15;;;
126252;126267;0;19191;VERDADERO;VERDADERO;-15;;;
126252;126267;0;19192;VERDADERO;VERDADERO;-15;;;
126252;126287;0;19193;VERDADERO;VERDADERO;-35;;;
126252;126287;0;19194;VERDADERO;VERDADERO;-35;;;
126285;126287;0;19195;VERDADERO;VERDADERO;-2;;;
126285;126307;0;19196;VERDADERO;VERDADERO;-22;;;
126285;126307;0;19197;VERDADERO;VERDADERO;-22;;;
126285;126307;0;19198;VERDADERO;VERDADERO;-22;;;
126285;126327;0;19199;VERDADERO;VERDADERO;-42;;;
126285;126327;0;19200;VERDADERO;VERDADERO;-42;;;
126321;126347;1;19201;VERDADERO;VERDADERO;-26;;;
126321;126347;0;19202;VERDADERO;VERDADERO;-26;;;
126321;126367;0,00E+00;19203;VERDADERO;VERDADERO;-46;;;
126321;126367;0;19204;VERDADERO;VERDADERO;-46;;;
126352;126367;0;19205;VERDADERO;VERDADERO;-15;;;
126352;126367;0;19206;VERDADERO;VERDADERO;-15;;;
126352;126367;0;19207;VERDADERO;VERDADERO;-15;;;
126352;126367;0;19208;VERDADERO;VERDADERO;-15;;;
126352;126387;0;19209;VERDADERO;VERDADERO;-35;;;
126352;126387;0;19210;VERDADERO;VERDADERO;-35;;;
126385;126387;0;19211;VERDADERO;VERDADERO;-2;;;
126385;126407;0;19212;VERDADERO;VERDADERO;-22;;;
126385;126407;0;19213;VERDADERO;VERDADERO;-22;;;
126385;126427;0;19214;VERDADERO;VERDADERO;-42;;;
126385;126427;0;19215;VERDADERO;VERDADERO;-42;;;
126420;126427;0;19216;VERDADERO;VERDADERO;-7;;;
126420;126447;0;19217;VERDADERO;VERDADERO;-27;;;
126420;126447;0;19218;VERDADERO;VERDADERO;-27;;;
126420;126467;0;19219;VERDADERO;VERDADERO;-47;;;
126420;126467;0;19220;VERDADERO;VERDADERO;-47;;;
126453;126467;0;19221;VERDADERO;VERDADERO;-14;;;
126453;126467;0;19222;VERDADERO;VERDADERO;-14;;;
126453;126467;0;19223;VERDADERO;VERDADERO;-14;;;
126453;126487;0;19224;VERDADERO;VERDADERO;-34;;;
126453;126487;0;19225;VERDADERO;VERDADERO;-34;;;
126485;126507;1;19226;VERDADERO;VERDADERO;-22;;;
126485;126507;0;19227;VERDADERO;VERDADERO;-22;;;
126485;126507;0;19228;VERDADERO;VERDADERO;-22;;;
126485;126507;0;19229;VERDADERO;VERDADERO;-22;;;
126485;126507;0;19230;VERDADERO;VERDADERO;-22;;;
126485;126527;0;19231;VERDADERO;VERDADERO;-42;;;
126521;126527;0;19232;VERDADERO;VERDADERO;-6;;;
126521;126547;0;19233;VERDADERO;VERDADERO;-26;;;
126521;126547;0;19234;VERDADERO;VERDADERO;-26;;;
126521;126547;0;19235;VERDADERO;VERDADERO;-26;;;
126521;126567;0;19236;VERDADERO;VERDADERO;-46;;;
126553;126567;0;19237;VERDADERO;VERDADERO;-14;;;
126553;126587;0;19238;VERDADERO;VERDADERO;-34;;;
126553;126587;0;19239;VERDADERO;VERDADERO;-34;;;
126553;126607;0;19240;VERDADERO;FALSO;-54;;;
126553;126607;0;19241;VERDADERO;FALSO;-54;;;
126585;126607;0;19242;VERDADERO;VERDADERO;-22;;;
126585;126607;0;19243;VERDADERO;VERDADERO;-22;;;
126585;126607;0;19244;VERDADERO;VERDADERO;-22;;;
126585;126607;0;19245;VERDADERO;VERDADERO;-22;;;
126585;126627;1;19246;VERDADERO;VERDADERO;-42;;;
126616;126627;0;19247;VERDADERO;VERDADERO;-11;;;
126616;126627;0;19248;VERDADERO;VERDADERO;-11;;;
126616;126647;1;19249;VERDADERO;VERDADERO;-31;;;
126616;126647;0;19250;VERDADERO;VERDADERO;-31;;;
126616;126647;0;19251;VERDADERO;VERDADERO;-31;;;
126649;126647;0;19252;VERDADERO;VERDADERO;2;;;
126649;126647;0;19253;VERDADERO;VERDADERO;2;;;
126649;126667;0;19254;VERDADERO;VERDADERO;-18;;;
126649;126667;0;19255;VERDADERO;VERDADERO;-18;;;
126649;126687;0;19256;VERDADERO;VERDADERO;-38;;;
126649;126687;0;19257;VERDADERO;VERDADERO;-38;;;
126685;126687;0;19258;VERDADERO;VERDADERO;-2;;;
126685;126707;0;19259;VERDADERO;VERDADERO;-22;;;
126685;126707;0;19260;VERDADERO;VERDADERO;-22;;;
126685;126727;0;19261;VERDADERO;VERDADERO;-42;;;
126685;126727;0;19262;VERDADERO;VERDADERO;-42;;;
126716;126727;0;19263;VERDADERO;VERDADERO;-11;;;
126716;126747;0;19264;VERDADERO;VERDADERO;-31;;;
126716;126747;0;19265;VERDADERO;VERDADERO;-31;;;
126716;126747;0;19266;VERDADERO;VERDADERO;-31;;;
126716;126747;0;19267;VERDADERO;VERDADERO;-31;;;
126749;126747;0;19268;VERDADERO;VERDADERO;2;;;
126749;126747;0;19269;VERDADERO;VERDADERO;2;;;
126749;126747;0;19270;VERDADERO;VERDADERO;2;;;
126749;126767;0;19271;VERDADERO;VERDADERO;-18;;;
126749;126767;0;19272;VERDADERO;VERDADERO;-18;;;
126749;126787;0;19273;VERDADERO;VERDADERO;-38;;;
126790;126787;0;19274;VERDADERO;VERDADERO;3;;;
126790;126787;0;19275;VERDADERO;VERDADERO;3;;;
126790;126807;1;19276;VERDADERO;VERDADERO;-17;;;
126790;126807;0;19277;VERDADERO;VERDADERO;-17;;;
126790;126827;1;19278;VERDADERO;VERDADERO;-37;;;
126817;126827;0;19279;VERDADERO;VERDADERO;-10;;;
126817;126847;0;19280;VERDADERO;VERDADERO;-30;;;
126817;126847;0;19281;VERDADERO;VERDADERO;-30;;;
126817;126847;0;19282;VERDADERO;VERDADERO;-30;;;
126817;126847;0;19283;VERDADERO;VERDADERO;-30;;;
126848;126847;0;19284;VERDADERO;VERDADERO;1;;;
126848;126867;0;19285;VERDADERO;VERDADERO;-19;;;
126848;126867;0;19286;VERDADERO;VERDADERO;-19;;;
126848;126887;0;19287;VERDADERO;VERDADERO;-39;;;
126848;126887;0;19288;VERDADERO;VERDADERO;-39;;;
126884;126887;0;19289;VERDADERO;VERDADERO;-3;;;
126884;126907;0;19290;VERDADERO;VERDADERO;-23;;;
126884;126907;0;19291;VERDADERO;VERDADERO;-23;;;
126884;126927;0;19292;VERDADERO;VERDADERO;-43;;;
126884;126927;0;19293;VERDADERO;VERDADERO;-43;;;
126884;126927;0;19294;VERDADERO;VERDADERO;-43;;;
126920;126947;0;19295;VERDADERO;VERDADERO;-27;;;
126920;126947;0;19296;VERDADERO;VERDADERO;-27;;;
126920;126947;0;19297;VERDADERO;VERDADERO;-27;;;
126920;126947;0;19298;VERDADERO;VERDADERO;-27;;;
126920;126947;0;19299;VERDADERO;VERDADERO;-27;;;
126953;126967;1;19300;VERDADERO;VERDADERO;-14;;;
126953;126967;0;19301;VERDADERO;VERDADERO;-14;;;
126953;126987;0;19302;VERDADERO;VERDADERO;-34;;;
126953;126987;0;19303;VERDADERO;VERDADERO;-34;;;
126953;126987;0;19304;VERDADERO;VERDADERO;-34;;;
126985;126987;0;19305;VERDADERO;VERDADERO;-2;;;
126985;126987;0;19306;VERDADERO;VERDADERO;-2;;;
126985;126987;0;19307;VERDADERO;VERDADERO;-2;;;
126985;127007;0;19308;VERDADERO;VERDADERO;-22;;;
126985;127007;0;19309;VERDADERO;VERDADERO;-22;;;
126985;127027;0;19310;VERDADERO;VERDADERO;-42;;;
127022;127027;0;19311;VERDADERO;VERDADERO;-5;;;
127022;127027;0;19312;VERDADERO;VERDADERO;-5;;;
127022;127047;0;19313;VERDADERO;VERDADERO;-25;;;
127022;127047;0;19314;VERDADERO;VERDADERO;-25;;;
127022;127047;0;19315;VERDADERO;VERDADERO;-25;;;
127053;127067;1;19316;VERDADERO;VERDADERO;-14;;;
127053;127067;0;19317;VERDADERO;VERDADERO;-14;;;
127053;127067;0;19318;VERDADERO;VERDADERO;-14;;;
127053;127087;0;19319;VERDADERO;VERDADERO;-34;;;
127053;127087;0;19320;VERDADERO;VERDADERO;-34;;;
127084;127087;0;19321;VERDADERO;VERDADERO;-3;;;
127084;127087;0;19322;VERDADERO;VERDADERO;-3;;;
127084;127107;0;19323;VERDADERO;VERDADERO;-23;;;
127084;127107;0;19324;VERDADERO;VERDADERO;-23;;;
127084;127107;0;19325;VERDADERO;VERDADERO;-23;;;
127084;127127;0;19326;VERDADERO;VERDADERO;-43;;;
127121;127127;0;19327;VERDADERO;VERDADERO;-6;;;
127121;127147;0;19328;VERDADERO;VERDADERO;-26;;;
127121;127147;0;19329;VERDADERO;VERDADERO;-26;;;
127121;127147;0;19330;VERDADERO;VERDADERO;-26;;;
127121;127167;0;19331;VERDADERO;VERDADERO;-46;;;
127153;127167;0;19332;VERDADERO;VERDADERO;-14;;;
127153;127187;0;19333;VERDADERO;VERDADERO;-34;;;
127153;127187;0;19334;VERDADERO;VERDADERO;-34;;;
127153;127187;0;19335;VERDADERO;VERDADERO;-34;;;
127153;127187;0;19336;VERDADERO;VERDADERO;-34;;;
127185;127187;0;19337;VERDADERO;VERDADERO;-2;;;
127185;127207;0;19338;VERDADERO;VERDADERO;-22;;;
127185;127207;0;19339;VERDADERO;VERDADERO;-22;;;
127185;127207;0;19340;VERDADERO;VERDADERO;-22;;;
127185;127227;0;19341;VERDADERO;VERDADERO;-42;;;
127185;127227;0;19342;VERDADERO;VERDADERO;-42;;;
127221;127227;0;19343;VERDADERO;VERDADERO;-6;;;
127221;127227;0;19344;VERDADERO;VERDADERO;-6;;;
127221;127227;0;19345;VERDADERO;VERDADERO;-6;;;
127221;127247;0;19346;VERDADERO;VERDADERO;-26;;;
127221;127247;0;19347;VERDADERO;VERDADERO;-26;;;
127252;127247;0;19348;VERDADERO;VERDADERO;5;;;
127252;127267;0;19349;VERDADERO;VERDADERO;-15;;;
127252;127267;0;19350;VERDADERO;VERDADERO;-15;;;
127252;127287;0;19351;VERDADERO;VERDADERO;-35;;;
127252;127287;0;19352;VERDADERO;VERDADERO;-35;;;
127284;127287;0;19353;VERDADERO;VERDADERO;-3;;;
127284;127307;0;19354;VERDADERO;VERDADERO;-23;;;
127284;127307;0;19355;VERDADERO;VERDADERO;-23;;;
127284;127307;0;19356;VERDADERO;VERDADERO;-23;;;
127284;127327;0;19357;VERDADERO;VERDADERO;-43;;;
127321;127327;0;19358;VERDADERO;VERDADERO;-6;;;
127321;127327;0;19359;VERDADERO;VERDADERO;-6;;;
127321;127327;0;19360;VERDADERO;VERDADERO;-6;;;
127321;127347;0;19361;VERDADERO;VERDADERO;-26;;;
127321;127347;0;19362;VERDADERO;VERDADERO;-26;;;
127353;127347;0;19363;VERDADERO;VERDADERO;6;;;
127353;127367;1;19364;VERDADERO;VERDADERO;-14;;;
127353;127367;0;19365;VERDADERO;VERDADERO;-14;;;
127353;127387;0;19366;VERDADERO;VERDADERO;-34;;;
127353;127387;0;19367;VERDADERO;VERDADERO;-34;;;
127353;127387;0;19368;VERDADERO;VERDADERO;-34;;;
127389;127387;0;19369;VERDADERO;VERDADERO;2;;;
127389;127387;0;19370;VERDADERO;VERDADERO;2;;;
127389;127407;0;19371;VERDADERO;VERDADERO;-18;;;
127389;127407;0;19372;VERDADERO;VERDADERO;-18;;;
127389;127427;0;19373;VERDADERO;VERDADERO;-38;;;
127421;127427;0;19374;VERDADERO;VERDADERO;-6;;;
127421;127427;0;19375;VERDADERO;VERDADERO;-6;;;
127421;127427;0;19376;VERDADERO;VERDADERO;-6;;;
127421;127427;0;19377;VERDADERO;VERDADERO;-6;;;
127421;127427;0;19378;VERDADERO;VERDADERO;-6;;;
127421;127427;0;19379;VERDADERO;VERDADERO;-6;;;
127452;127427;0;19380;VERDADERO;VERDADERO;25;;;
127452;127447;0;19381;VERDADERO;VERDADERO;5;;;
127452;127447;0;19382;VERDADERO;VERDADERO;5;;;
127452;127467;1;19383;VERDADERO;VERDADERO;-15;;;
127452;127467;0;19384;VERDADERO;VERDADERO;-15;;;
127489;127467;0;19385;VERDADERO;VERDADERO;22;;;
127489;127487;1;19386;VERDADERO;VERDADERO;2;;;
127489;127487;0;19387;VERDADERO;VERDADERO;2;;;
127489;127487;0;19388;VERDADERO;VERDADERO;2;;;
127489;127507;0;19389;VERDADERO;VERDADERO;-18;;;
127520;127507;0;19390;VERDADERO;VERDADERO;13;;;
127520;127507;0;19391;VERDADERO;VERDADERO;13;;;
127520;127527;0;19392;VERDADERO;VERDADERO;-7;;;
127520;127527;0;19393;VERDADERO;VERDADERO;-7;;;
127520;127547;0;19394;VERDADERO;VERDADERO;-27;;;
127554;127547;0;19395;VERDADERO;VERDADERO;7;;;
127554;127547;0;19396;VERDADERO;VERDADERO;7;;;
127554;127567;1;19397;VERDADERO;VERDADERO;-13;;;
127554;127567;0;19398;VERDADERO;VERDADERO;-13;;;
127554;127587;0;19399;VERDADERO;VERDADERO;-33;;;
127584;127587;0;19400;VERDADERO;VERDADERO;-3;;;
127584;127587;0;19401;VERDADERO;VERDADERO;-3;;;
127584;127607;0;19402;VERDADERO;VERDADERO;-23;;;
127584;127607;0;19403;VERDADERO;VERDADERO;-23;;;
127584;127607;0;19404;VERDADERO;VERDADERO;-23;;;
127616;127627;0;19405;VERDADERO;VERDADERO;-11;;;
127616;127627;0;19406;VERDADERO;VERDADERO;-11;;;
127616;127627;0;19407;VERDADERO;VERDADERO;-11;;;
127616;127647;0;19408;VERDADERO;VERDADERO;-31;;;
127616;127647;0;19409;VERDADERO;VERDADERO;-31;;;
127616;127647;0;19410;VERDADERO;VERDADERO;-31;;;
127653;127647;0;19411;VERDADERO;VERDADERO;6;;;
127653;127647;0;19412;VERDADERO;VERDADERO;6;;;
127653;127667;0;19413;VERDADERO;VERDADERO;-14;;;
127653;127667;0;19414;VERDADERO;VERDADERO;-14;;;
127653;127688;0;19415;VERDADERO;VERDADERO;-35;;;
127684;127688;0;19416;VERDADERO;VERDADERO;-4;;;
127684;127688;0;19417;VERDADERO;VERDADERO;-4;;;
127684;127708;0;19418;VERDADERO;VERDADERO;-24;;;
127684;127708;0;19419;VERDADERO;VERDADERO;-24;;;
127684;127708;0;19420;VERDADERO;VERDADERO;-24;;;
127716;127728;1;19421;VERDADERO;VERDADERO;-12;;;
127716;127728;0;19422;VERDADERO;VERDADERO;-12;;;
127716;127748;0;19423;VERDADERO;VERDADERO;-32;;;
127716;127748;0;19424;VERDADERO;VERDADERO;-32;;;
127716;127748;0;19425;VERDADERO;VERDADERO;-32;;;
127752;127748;0;19426;VERDADERO;VERDADERO;4;;;
127752;127748;0;19427;VERDADERO;VERDADERO;4;;;
127752;127748;0;19428;VERDADERO;VERDADERO;4;;;
127752;127768;0;19429;VERDADERO;VERDADERO;-16;;;
127752;127768;0;19430;VERDADERO;VERDADERO;-16;;;
127752;127768;0;19431;VERDADERO;VERDADERO;-16;;;
127784;127789;0;19432;VERDADERO;VERDADERO;-5;;;
127784;127789;0;19433;VERDADERO;VERDADERO;-5;;;
127784;127809;0;19434;VERDADERO;VERDADERO;-25;;;
127784;127809;0;19435;VERDADERO;VERDADERO;-25;;;
127817;127809;0;19436;VERDADERO;VERDADERO;8;;;
127817;127829;0;19437;VERDADERO;VERDADERO;-12;;;
127817;127829;0;19438;VERDADERO;VERDADERO;-12;;;
127817;127829;0;19439;VERDADERO;VERDADERO;-12;;;
127817;127849;0;19440;VERDADERO;VERDADERO;-32;;;
127817;127849;0;19441;VERDADERO;VERDADERO;-32;;;
127852;127869;0;19442;VERDADERO;VERDADERO;-17;;;
127852;127869;0;19443;VERDADERO;VERDADERO;-17;;;
127852;127869;0;19444;VERDADERO;VERDADERO;-17;;;
127852;127889;1;19445;VERDADERO;VERDADERO;-37;;;
127852;127889;0;19446;VERDADERO;VERDADERO;-37;;;
127885;127909;0;19447;VERDADERO;VERDADERO;-24;;;
127885;127909;0;19448;VERDADERO;VERDADERO;-24;;;
127885;127909;0;19449;VERDADERO;VERDADERO;-24;;;
127885;127909;0;19450;VERDADERO;VERDADERO;-24;;;
127885;127909;0;19451;VERDADERO;VERDADERO;-24;;;
127917;127909;0;19452;VERDADERO;VERDADERO;8;;;
127917;127929;0;19453;VERDADERO;VERDADERO;-12;;;
127917;127929;0;19454;VERDADERO;VERDADERO;-12;;;
127917;127929;0;19455;VERDADERO;VERDADERO;-12;;;
127917;127949;1;19456;VERDADERO;VERDADERO;-32;;;
127948;127949;0;19457;VERDADERO;VERDADERO;-1;;;
127948;127969;1;19458;VERDADERO;VERDADERO;-21;;;
127948;127969;0;19459;VERDADERO;VERDADERO;-21;;;
127948;127989;0;19460;VERDADERO;VERDADERO;-41;;;
127948;127989;0;19461;VERDADERO;VERDADERO;-41;;;
127980;127989;0;19462;VERDADERO;VERDADERO;-9;;;
127980;128009;0;19463;VERDADERO;VERDADERO;-29;;;
127980;128009;0;19464;VERDADERO;VERDADERO;-29;;;
127980;128009;0;19465;VERDADERO;VERDADERO;-29;;;
127980;128009;0;19466;VERDADERO;VERDADERO;-29;;;
127980;128009;0;19467;VERDADERO;VERDADERO;-29;;;
128019;128029;0;19468;VERDADERO;VERDADERO;-10;;;
128019;128029;0;19469;VERDADERO;VERDADERO;-10;;;
128019;128049;0;19470;VERDADERO;VERDADERO;-30;;;
128019;128049;0;19471;VERDADERO;VERDADERO;-30;;;
128019;128049;0;19472;VERDADERO;VERDADERO;-30;;;
128049;128069;0;19473;VERDADERO;VERDADERO;-20;;;
128049;128069;0;19474;VERDADERO;VERDADERO;-20;;;
128049;128089;0;19475;VERDADERO;VERDADERO;-40;;;
128049;128089;0;19476;VERDADERO;VERDADERO;-40;;;
128049;128089;0;19477;VERDADERO;VERDADERO;-40;;;
128080;128109;0;19478;VERDADERO;VERDADERO;-29;;;
128080;128109;0;19479;VERDADERO;VERDADERO;-29;;;
128080;128109;0;19480;VERDADERO;VERDADERO;-29;;;
128080;128109;0;19481;VERDADERO;VERDADERO;-29;;;
128080;128129;0;19482;VERDADERO;VERDADERO;-49;;;
128117;128129;0;19483;VERDADERO;VERDADERO;-12;;;
128117;128129;0;19484;VERDADERO;VERDADERO;-12;;;
128117;128149;0;19485;VERDADERO;VERDADERO;-32;;;
128117;128149;0;19486;VERDADERO;VERDADERO;-32;;;
128117;128149;0;19487;VERDADERO;VERDADERO;-32;;;
128117;128149;0;19488;VERDADERO;VERDADERO;-32;;;
128152;128149;0;19489;VERDADERO;VERDADERO;3;;;
128152;128169;0;19490;VERDADERO;VERDADERO;-17;;;
128152;128169;0;19491;VERDADERO;VERDADERO;-17;;;
128152;128169;0;19492;VERDADERO;VERDADERO;-17;;;
128152;128189;1;19493;VERDADERO;VERDADERO;-37;;;
128184;128189;0;19494;VERDADERO;VERDADERO;-5;;;
128184;128209;1;19495;VERDADERO;VERDADERO;-25;;;
128184;128209;0;19496;VERDADERO;VERDADERO;-25;;;
128184;128209;0;19497;VERDADERO;VERDADERO;-25;;;
128184;128229;1;19498;VERDADERO;VERDADERO;-45;;;
128216;128229;0;19499;VERDADERO;VERDADERO;-13;;;
128216;128229;0;19500;VERDADERO;VERDADERO;-13;;;
128216;128249;0;19501;VERDADERO;VERDADERO;-33;;;
128216;128249;0;19502;VERDADERO;VERDADERO;-33;;;
128216;128249;0;19503;VERDADERO;VERDADERO;-33;;;
128216;128249;0;19504;VERDADERO;VERDADERO;-33;;;
128253;128249;0;19505;VERDADERO;VERDADERO;4;;;
128253;128269;0;19506;VERDADERO;VERDADERO;-16;;;
128253;128269;0;19507;VERDADERO;VERDADERO;-16;;;
128253;128269;0;19508;VERDADERO;VERDADERO;-16;;;
128253;128289;0;19509;VERDADERO;VERDADERO;-36;;;
128253;128289;0;19510;VERDADERO;VERDADERO;-36;;;
128289;128309;0;19511;VERDADERO;VERDADERO;-20;;;
128289;128309;0;19512;VERDADERO;VERDADERO;-20;;;
128289;128309;0;19513;VERDADERO;VERDADERO;-20;;;
128289;128329;0;19514;VERDADERO;VERDADERO;-40;;;
128289;128329;0;19515;VERDADERO;VERDADERO;-40;;;
128320;128349;0;19516;VERDADERO;VERDADERO;-29;;;
128320;128349;0;19517;VERDADERO;VERDADERO;-29;;;
128320;128349;0;19518;VERDADERO;VERDADERO;-29;;;
128320;128349;0;19519;VERDADERO;VERDADERO;-29;;;
128320;128349;0;19520;VERDADERO;VERDADERO;-29;;;
128353;128369;1;19521;VERDADERO;VERDADERO;-16;;;
128353;128369;0;19522;VERDADERO;VERDADERO;-16;;;
128353;128369;0;19523;VERDADERO;VERDADERO;-16;;;
128353;128389;0;19524;VERDADERO;VERDADERO;-36;;;
128353;128389;0;19525;VERDADERO;VERDADERO;-36;;;
128389;128409;0;19526;VERDADERO;VERDADERO;-20;;;
128389;128409;0;19527;VERDADERO;VERDADERO;-20;;;
128389;128409;0;19528;VERDADERO;VERDADERO;-20;;;
128389;128429;0;19529;VERDADERO;VERDADERO;-40;;;
128389;128429;0;19530;VERDADERO;VERDADERO;-40;;;
128420;128449;0;19531;VERDADERO;VERDADERO;-29;;;
128420;128449;0;19532;VERDADERO;VERDADERO;-29;;;
128420;128449;0;19533;VERDADERO;VERDADERO;-29;;;
128420;128449;0;19534;VERDADERO;VERDADERO;-29;;;
128420;128469;0;19535;VERDADERO;VERDADERO;-49;;;
128453;128469;0;19536;VERDADERO;VERDADERO;-16;;;
128453;128469;0;19537;VERDADERO;VERDADERO;-16;;;
128453;128489;0;19538;VERDADERO;VERDADERO;-36;;;
128453;128489;0;19539;VERDADERO;VERDADERO;-36;;;
128453;128489;0;19540;VERDADERO;VERDADERO;-36;;;
128453;128489;0;19541;VERDADERO;VERDADERO;-36;;;
128488;128489;0;19542;VERDADERO;VERDADERO;-1;;;
128488;128509;0;19543;VERDADERO;VERDADERO;-21;;;
128488;128509;0;19544;VERDADERO;VERDADERO;-21;;;
128488;128529;0;19545;VERDADERO;VERDADERO;-41;;;
128488;128529;0;19546;VERDADERO;VERDADERO;-41;;;
128520;128529;0;19547;VERDADERO;VERDADERO;-9;;;
128520;128529;0;19548;VERDADERO;VERDADERO;-9;;;
128520;128529;0;19549;VERDADERO;VERDADERO;-9;;;
128520;128549;0;19550;VERDADERO;VERDADERO;-29;;;
128520;128549;0;19551;VERDADERO;VERDADERO;-29;;;
128553;128569;1;19552;VERDADERO;VERDADERO;-16;;;
128553;128569;0;19553;VERDADERO;VERDADERO;-16;;;
128553;128569;0;19554;VERDADERO;VERDADERO;-16;;;
128553;128589;0;19555;VERDADERO;VERDADERO;-36;;;
128553;128589;0;19556;VERDADERO;VERDADERO;-36;;;
128553;128589;0;19557;VERDADERO;VERDADERO;-36;;;
128589;128589;0;19558;VERDADERO;VERDADERO;0;;;
128589;128589;0;19559;VERDADERO;VERDADERO;0;;;
128589;128589;0;19560;VERDADERO;VERDADERO;0;;;
128589;128589;0;19561;VERDADERO;VERDADERO;0;;;
128589;128609;0;19562;VERDADERO;VERDADERO;-20;;;
128620;128609;0;19563;VERDADERO;VERDADERO;11;;;
128620;128629;1;19564;VERDADERO;VERDADERO;-9;;;
128620;128629;0;19565;VERDADERO;VERDADERO;-9;;;
128620;128629;0;19566;VERDADERO;VERDADERO;-9;;;
128620;128629;0;19567;VERDADERO;VERDADERO;-9;;;
128653;128629;0;19568;VERDADERO;VERDADERO;24;;;
128653;128649;0;19569;VERDADERO;VERDADERO;4;;;
128653;128649;0;19570;VERDADERO;VERDADERO;4;;;
128653;128669;0;19571;VERDADERO;VERDADERO;-16;;;
128653;128669;0;19572;VERDADERO;VERDADERO;-16;;;
128653;128669;0;19573;VERDADERO;VERDADERO;-16;;;
128689;128689;1;19574;VERDADERO;VERDADERO;0;;;
128689;128689;0;19575;VERDADERO;VERDADERO;0;;;
128689;128709;0;19576;VERDADERO;VERDADERO;-20;;;
128689;128709;0;19577;VERDADERO;VERDADERO;-20;;;
128689;128709;0;19578;VERDADERO;VERDADERO;-20;;;
128720;128729;0;19579;VERDADERO;VERDADERO;-9;;;
128720;128729;0;19580;VERDADERO;VERDADERO;-9;;;
128720;128749;0;19581;VERDADERO;VERDADERO;-29;;;
128720;128749;0;19582;VERDADERO;VERDADERO;-29;;;
128720;128749;0;19583;VERDADERO;VERDADERO;-29;;;
128753;128769;0;19584;VERDADERO;VERDADERO;-16;;;
128753;128769;0;19585;VERDADERO;VERDADERO;-16;;;
128753;128789;0;19586;VERDADERO;VERDADERO;-36;;;
128753;128789;0;19587;VERDADERO;VERDADERO;-36;;;
128753;128789;0;19588;VERDADERO;VERDADERO;-36;;;
128788;128789;0;19589;VERDADERO;VERDADERO;-1;;;
128788;128809;0;19590;VERDADERO;VERDADERO;-21;;;
128788;128809;0;19591;VERDADERO;VERDADERO;-21;;;
128788;128809;0;19592;VERDADERO;VERDADERO;-21;;;
128788;128829;0;19593;VERDADERO;VERDADERO;-41;;;
128788;128829;0;19594;VERDADERO;VERDADERO;-41;;;
128820;128829;0;19595;VERDADERO;VERDADERO;-9;;;
128820;128829;0;19596;VERDADERO;VERDADERO;-9;;;
128820;128849;0;19597;VERDADERO;VERDADERO;-29;;;
128820;128849;0;19598;VERDADERO;VERDADERO;-29;;;
128820;128849;0;19599;VERDADERO;VERDADERO;-29;;;
128857;128869;0;19600;VERDADERO;VERDADERO;-12;;;
128857;128869;0;19601;VERDADERO;VERDADERO;-12;;;
128857;128889;0;19602;VERDADERO;VERDADERO;-32;;;
128857;128889;0;19603;VERDADERO;VERDADERO;-32;;;
128857;128889;0;19604;VERDADERO;VERDADERO;-32;;;
128889;128909;0;19605;VERDADERO;VERDADERO;-20;;;
128889;128909;0;19606;VERDADERO;VERDADERO;-20;;;
128889;128929;0;19607;VERDADERO;VERDADERO;-40;;;
128889;128929;0;19608;VERDADERO;VERDADERO;-40;;;
128889;128929;0;19609;VERDADERO;VERDADERO;-40;;;
128921;128929;0;19610;VERDADERO;VERDADERO;-8;;;
128921;128929;0;19611;VERDADERO;VERDADERO;-8;;;
128921;128929;0;19612;VERDADERO;VERDADERO;-8;;;
128921;128949;0;19613;VERDADERO;VERDADERO;-28;;;
128921;128949;0;19614;VERDADERO;VERDADERO;-28;;;
128921;128949;0;19615;VERDADERO;VERDADERO;-28;;;
128953;128969;0;19616;VERDADERO;VERDADERO;-16;;;
128953;128969;0;19617;VERDADERO;VERDADERO;-16;;;
128953;128969;0;19618;VERDADERO;VERDADERO;-16;;;
128953;128969;0;19619;VERDADERO;VERDADERO;-16;;;
128984;128989;0;19620;VERDADERO;VERDADERO;-5;;;
128984;128989;0;19621;VERDADERO;VERDADERO;-5;;;
128984;128989;0;19622;VERDADERO;VERDADERO;-5;;;
128984;129009;0;19623;VERDADERO;VERDADERO;-25;;;
128984;129009;0;19624;VERDADERO;VERDADERO;-25;;;
128984;129029;0;19625;VERDADERO;VERDADERO;-45;;;
129020;129029;0;19626;VERDADERO;VERDADERO;-9;;;
129020;129029;0;19627;VERDADERO;VERDADERO;-9;;;
129020;129029;0;19628;VERDADERO;VERDADERO;-9;;;
129020;129049;1;19629;VERDADERO;VERDADERO;-29;;;
129020;129049;0;19630;VERDADERO;VERDADERO;-29;;;
129052;129049;0;19631;VERDADERO;VERDADERO;3;;;
129052;129069;0;19632;VERDADERO;VERDADERO;-17;;;
129052;129069;0;19633;VERDADERO;VERDADERO;-17;;;
129052;129069;0;19634;VERDADERO;VERDADERO;-17;;;
129052;129069;0;19635;VERDADERO;VERDADERO;-17;;;
129052;129069;0;19636;VERDADERO;VERDADERO;-17;;;
129085;129089;1;19637;VERDADERO;VERDADERO;-4;;;
129085;129089;0;19638;VERDADERO;VERDADERO;-4;;;
129085;129109;1;19639;VERDADERO;VERDADERO;-24;;;
129085;129109;0;19640;VERDADERO;VERDADERO;-24;;;
129120;129129;1;19641;VERDADERO;VERDADERO;-9;;;
129152;129169;0;19642;VERDADERO;VERDADERO;-17;;;
129152;129169;0;19643;VERDADERO;VERDADERO;-17;;;
129152;129169;0;19644;VERDADERO;VERDADERO;-17;;;
129152;129189;0;19645;VERDADERO;VERDADERO;-37;;;
129184;129189;0;19646;VERDADERO;VERDADERO;-5;;;
129184;129209;0;19647;VERDADERO;VERDADERO;-25;;;
129184;129209;0;19648;VERDADERO;VERDADERO;-25;;;
129184;129209;0;19649;VERDADERO;VERDADERO;-25;;;
129184;129229;0;19650;VERDADERO;VERDADERO;-45;;;
129217;129229;0;19651;VERDADERO;VERDADERO;-12;;;
129217;129229;0;19652;VERDADERO;VERDADERO;-12;;;
129217;129229;0;19653;VERDADERO;VERDADERO;-12;;;
129217;129229;0;19654;VERDADERO;VERDADERO;-12;;;
129217;129229;0;19655;VERDADERO;VERDADERO;-12;;;
129249;129249;0;19656;VERDADERO;VERDADERO;0;;;
129249;129249;0;19657;VERDADERO;VERDADERO;0;;;
129249;129269;0;19658;VERDADERO;VERDADERO;-20;;;
129249;129269;0;19659;VERDADERO;VERDADERO;-20;;;
129249;129269;0;19660;VERDADERO;VERDADERO;-20;;;
129249;129269;0;19661;VERDADERO;VERDADERO;-20;;;
129284;129269;0;19662;VERDADERO;VERDADERO;15;;;
129284;129269;0;19663;VERDADERO;VERDADERO;15;;;
129284;129269;0;19664;VERDADERO;VERDADERO;15;;;
129284;129269;0;19665;VERDADERO;VERDADERO;15;;;
129284;129289;0;19666;VERDADERO;VERDADERO;-5;;;
129316;129289;0;19667;VERDADERO;VERDADERO;27;;;
129316;129309;0;19668;VERDADERO;VERDADERO;7;;;
129316;129309;0;19669;VERDADERO;VERDADERO;7;;;
129316;129309;0;19670;VERDADERO;VERDADERO;7;;;
129316;129329;0;19671;VERDADERO;VERDADERO;-13;;;
129349;129329;0;19672;VERDADERO;VERDADERO;20;;;
129349;129349;0;19673;VERDADERO;VERDADERO;0;;;
129349;129349;0;19674;VERDADERO;VERDADERO;0;;;
129349;129349;0;19675;VERDADERO;VERDADERO;0;;;
129349;129369;0;19676;VERDADERO;VERDADERO;-20;;;
129349;129369;0;19677;VERDADERO;VERDADERO;-20;;;
129385;129389;0;19678;VERDADERO;VERDADERO;-4;;;
129385;129389;0;19679;VERDADERO;VERDADERO;-4;;;
129385;129389;0;19680;VERDADERO;VERDADERO;-4;;;
129385;129409;0;19681;VERDADERO;VERDADERO;-24;;;
129385;129409;0;19682;VERDADERO;VERDADERO;-24;;;
129416;129409;0;19683;VERDADERO;VERDADERO;7;;;
129416;129409;0;19684;VERDADERO;VERDADERO;7;;;
129416;129409;0;19685;VERDADERO;VERDADERO;7;;;
129416;129409;0;19686;VERDADERO;VERDADERO;7;;;
129416;129409;0;19687;VERDADERO;VERDADERO;7;;;
129449;129409;0;19688;VERDADERO;VERDADERO;40;;;
129449;129409;0;19689;VERDADERO;VERDADERO;40;;;
129449;129409;0;19690;VERDADERO;VERDADERO;40;;;
129449;129409;0;19691;VERDADERO;VERDADERO;40;;;
129449;129409;0;19692;VERDADERO;VERDADERO;40;;;
129449;129409;0;19693;VERDADERO;VERDADERO;40;;;
129481;129409;0;19694;FALSO;VERDADERO;72;;;
129481;129409;0;19695;FALSO;VERDADERO;72;;;
129481;129409;0;19696;FALSO;VERDADERO;72;;;
129481;129409;0;19697;FALSO;VERDADERO;72;;;
129481;129409;0;19698;FALSO;VERDADERO;72;;;
129513;129409;0;19699;FALSO;VERDADERO;104;;;
129513;129429;0;19700;FALSO;VERDADERO;84;;;
129513;129429;0;19701;FALSO;VERDADERO;84;;;
129513;129449;0;19702;FALSO;VERDADERO;64;;;
129513;129449;0;19703;FALSO;VERDADERO;64;;;
129513;129449;0;19704;FALSO;VERDADERO;64;;;
129548;129469;0;19705;FALSO;VERDADERO;79;;;
129548;129469;0;19706;FALSO;VERDADERO;79;;;
129548;129489;0;19707;FALSO;VERDADERO;59;;;
129548;129489;0;19708;FALSO;VERDADERO;59;;;
129548;129489;0;19709;FALSO;VERDADERO;59;;;
129580;129509;0;19710;FALSO;VERDADERO;71;;;
129580;129509;0;19711;FALSO;VERDADERO;71;;;
129580;129529;0;19712;FALSO;VERDADERO;51;;;
129580;129529;0;19713;FALSO;VERDADERO;51;;;
129580;129529;0;19714;FALSO;VERDADERO;51;;;
129612;129549;0;19715;FALSO;VERDADERO;63;;;
129612;129549;0;19716;FALSO;VERDADERO;63;;;
129612;129569;0;19717;VERDADERO;VERDADERO;43;;;
129612;129569;0;19718;VERDADERO;VERDADERO;43;;;
129612;129589;0;19719;VERDADERO;VERDADERO;23;;;
129649;129589;0;19720;FALSO;VERDADERO;60;;;
129649;129589;0;19721;FALSO;VERDADERO;60;;;
129649;129609;0;19722;VERDADERO;VERDADERO;40;;;
129649;129609;0;19723;VERDADERO;VERDADERO;40;;;
129649;129629;0;19724;VERDADERO;VERDADERO;20;;;
129677;129629;0;19725;VERDADERO;VERDADERO;48;;;
129677;129629;0;19726;VERDADERO;VERDADERO;48;;;
129677;129649;0;19727;VERDADERO;VERDADERO;28;;;
129677;129649;0;19728;VERDADERO;VERDADERO;28;;;
129677;129669;0;19729;VERDADERO;VERDADERO;8;;;
129713;129669;0;19730;VERDADERO;VERDADERO;44;;;
129713;129669;0;19731;VERDADERO;VERDADERO;44;;;
129713;129689;0;19732;VERDADERO;VERDADERO;24;;;
129713;129689;0;19733;VERDADERO;VERDADERO;24;;;
129713;129709;0;19734;VERDADERO;VERDADERO;4;;;
129745;129709;0;19735;VERDADERO;VERDADERO;36;;;
129745;129709;0;19736;VERDADERO;VERDADERO;36;;;
129745;129729;0;19737;VERDADERO;VERDADERO;16;;;
129745;129729;0;19738;VERDADERO;VERDADERO;16;;;
129745;129749;0;19739;VERDADERO;VERDADERO;-4;;;
129780;129749;0;19740;VERDADERO;VERDADERO;31;;;
129780;129749;0;19741;VERDADERO;VERDADERO;31;;;
129780;129769;0;19742;VERDADERO;VERDADERO;11;;;
129780;129769;0;19743;VERDADERO;VERDADERO;11;;;
129780;129789;0;19744;VERDADERO;VERDADERO;-9;;;
129812;129789;0;19745;VERDADERO;VERDADERO;23;;;
129812;129809;0;19746;VERDADERO;VERDADERO;3;;;
129812;129809;0;19747;VERDADERO;VERDADERO;3;;;
129812;129809;0;19748;VERDADERO;VERDADERO;3;;;
129812;129829;0;19749;VERDADERO;VERDADERO;-17;;;
129812;129829;0;19750;VERDADERO;VERDADERO;-17;;;
129848;129849;0;19751;VERDADERO;VERDADERO;-1;;;
129848;129849;0;19752;VERDADERO;VERDADERO;-1;;;
129848;129849;0;19753;VERDADERO;VERDADERO;-1;;;
129848;129869;0;19754;VERDADERO;VERDADERO;-21;;;
129848;129869;0;19755;VERDADERO;VERDADERO;-21;;;
129881;129869;0;19756;VERDADERO;VERDADERO;12;;;
129881;129889;0;19757;VERDADERO;VERDADERO;-8;;;
129881;129889;0;19758;VERDADERO;VERDADERO;-8;;;
129881;129909;0;19759;VERDADERO;VERDADERO;-28;;;
129881;129909;0;19760;VERDADERO;VERDADERO;-28;;;
129912;129909;0;19761;VERDADERO;VERDADERO;3;;;
129912;129909;0;19762;VERDADERO;VERDADERO;3;;;
129912;129929;0;19763;VERDADERO;VERDADERO;-17;;;
129912;129929;0;19764;VERDADERO;VERDADERO;-17;;;
129912;129929;0;19765;VERDADERO;VERDADERO;-17;;;
129912;129949;0;19766;VERDADERO;VERDADERO;-37;;;
129948;129949;0;19767;VERDADERO;VERDADERO;-1;;;
129948;129969;0;19768;VERDADERO;VERDADERO;-21;;;
129948;129969;0;19769;VERDADERO;VERDADERO;-21;;;
129948;129969;0;19770;VERDADERO;VERDADERO;-21;;;
129948;129989;0;19771;VERDADERO;VERDADERO;-41;;;
129980;129989;0;19772;VERDADERO;VERDADERO;-9;;;
129980;130009;0;19773;VERDADERO;VERDADERO;-29;;;
129980;130009;0;19774;VERDADERO;VERDADERO;-29;;;
129980;130009;0;19775;VERDADERO;VERDADERO;-29;;;
129980;130009;0;19776;VERDADERO;VERDADERO;-29;;;
130013;130009;0;19777;VERDADERO;VERDADERO;4;;;
130013;130009;0;19778;VERDADERO;VERDADERO;4;;;
130013;130009;0;19779;VERDADERO;VERDADERO;4;;;
130013;130009;0;19780;VERDADERO;VERDADERO;4;;;
130013;130009;0;19781;VERDADERO;VERDADERO;4;;;
130013;130009;0;19782;VERDADERO;VERDADERO;4;;;
130049;130009;0;19783;VERDADERO;VERDADERO;40;;;
130049;130029;0;19784;VERDADERO;VERDADERO;20;;;
130049;130029;0;19785;VERDADERO;VERDADERO;20;;;
130049;130029;0;19786;VERDADERO;VERDADERO;20;;;
130049;130050;0;19787;VERDADERO;VERDADERO;-1;;;
130081;130050;0;19788;VERDADERO;VERDADERO;31;;;
130081;130070;0;19789;VERDADERO;VERDADERO;11;;;
130081;130070;0;19790;VERDADERO;VERDADERO;11;;;
130081;130070;0;19791;VERDADERO;VERDADERO;11;;;
130081;130070;0;19792;VERDADERO;VERDADERO;11;;;
130112;130090;1;19793;VERDADERO;VERDADERO;22;;;
130112;130090;0;19794;VERDADERO;VERDADERO;22;;;
130112;130090;0;19795;VERDADERO;VERDADERO;22;;;
130112;130110;0;19796;VERDADERO;VERDADERO;2;;;
130112;130110;0;19797;VERDADERO;VERDADERO;2;;;
130112;130130;0;19798;VERDADERO;VERDADERO;-18;;;
130149;130130;0;19799;VERDADERO;VERDADERO;19;;;
130149;130130;0;19800;VERDADERO;VERDADERO;19;;;
130149;130150;0;19801;VERDADERO;VERDADERO;-1;;;
130149;130150;0;19802;VERDADERO;VERDADERO;-1;;;
130181;130170;0;19803;VERDADERO;VERDADERO;11;;;
130181;130170;0;19804;VERDADERO;VERDADERO;11;;;
130181;130170;0;19805;VERDADERO;VERDADERO;11;;;
130181;130190;0;19806;VERDADERO;VERDADERO;-9;;;
130181;130190;0;19807;VERDADERO;VERDADERO;-9;;;
130213;130210;1;19808;VERDADERO;VERDADERO;3;;;
130213;130210;0;19809;VERDADERO;VERDADERO;3;;;
130213;130210;0;19810;VERDADERO;VERDADERO;3;;;
130213;130230;1;19811;VERDADERO;VERDADERO;-17;;;
130213;130230;0;19812;VERDADERO;VERDADERO;-17;;;
130213;130230;0;19813;VERDADERO;VERDADERO;-17;;;
130249;130250;0;19814;VERDADERO;VERDADERO;-1;;;
130249;130250;0;19815;VERDADERO;VERDADERO;-1;;;
130249;130250;0;19816;VERDADERO;VERDADERO;-1;;;
130249;130250;0;19817;VERDADERO;VERDADERO;-1;;;
130249;130250;0;19818;VERDADERO;VERDADERO;-1;;;
130280;130250;0;19819;VERDADERO;VERDADERO;30;;;
130280;130270;0;19820;VERDADERO;VERDADERO;10;;;
130280;130270;0;19821;VERDADERO;VERDADERO;10;;;
130280;130290;0;19822;VERDADERO;VERDADERO;-10;;;
130280;130290;0;19823;VERDADERO;VERDADERO;-10;;;
130312;130290;0;19824;VERDADERO;VERDADERO;22;;;
130312;130310;0;19825;VERDADERO;VERDADERO;2;;;
130312;130310;0;19826;VERDADERO;VERDADERO;2;;;
130312;130330;0;19827;VERDADERO;VERDADERO;-18;;;
130312;130330;0;19828;VERDADERO;VERDADERO;-18;;;
130312;130330;0;19829;VERDADERO;VERDADERO;-18;;;
130348;130350;0;19830;VERDADERO;VERDADERO;-2;;;
130348;130350;0;19831;VERDADERO;VERDADERO;-2;;;
130348;130370;0;19832;VERDADERO;VERDADERO;-22;;;
130348;130370;0;19833;VERDADERO;VERDADERO;-22;;;
130348;130370;0;19834;VERDADERO;VERDADERO;-22;;;
130380;130370;0;19835;VERDADERO;VERDADERO;10;;;
130380;130370;0;19836;VERDADERO;VERDADERO;10;;;
130380;130370;0;19837;VERDADERO;VERDADERO;10;;;
130380;130390;0;19838;VERDADERO;VERDADERO;-10;;;
130380;130390;0;19839;VERDADERO;VERDADERO;-10;;;
130413;130390;0;19840;VERDADERO;VERDADERO;23;;;
130413;130410;0;19841;VERDADERO;VERDADERO;3;;;
130413;130410;0;19842;VERDADERO;VERDADERO;3;;;
130413;130430;0;19843;VERDADERO;VERDADERO;-17;;;
130413;130430;0;19844;VERDADERO;VERDADERO;-17;;;
130448;130430;0;19845;VERDADERO;VERDADERO;18;;;
130448;130430;0;19846;VERDADERO;VERDADERO;18;;;
130448;130430;0;19847;VERDADERO;VERDADERO;18;;;
130448;130430;0;19848;VERDADERO;VERDADERO;18;;;
130448;130430;0;19849;VERDADERO;VERDADERO;18;;;
130448;130450;1;19850;VERDADERO;VERDADERO;-2;;;
130480;130450;0;19851;VERDADERO;VERDADERO;30;;;
130480;130470;0;19852;VERDADERO;VERDADERO;10;;;
130480;130470;0;19853;VERDADERO;VERDADERO;10;;;
130480;130470;0;19854;VERDADERO;VERDADERO;10;;;
130480;130490;0;19855;VERDADERO;VERDADERO;-10;;;
130512;130490;0;19856;VERDADERO;VERDADERO;22;;;
130512;130490;0;19857;VERDADERO;VERDADERO;22;;;
130512;130490;0;19858;VERDADERO;VERDADERO;22;;;
130512;130490;0;19859;VERDADERO;VERDADERO;22;;;
130512;130510;0;19860;VERDADERO;VERDADERO;2;;;
130548;130510;0;19861;VERDADERO;VERDADERO;38;;;
130548;130510;0;19862;VERDADERO;VERDADERO;38;;;
130548;130530;0;19863;VERDADERO;VERDADERO;18;;;
130548;130530;0;19864;VERDADERO;VERDADERO;18;;;
130548;130550;0;19865;VERDADERO;VERDADERO;-2;;;
130580;130550;0;19866;VERDADERO;VERDADERO;30;;;
130580;130550;0;19867;VERDADERO;VERDADERO;30;;;
130580;130570;0;19868;VERDADERO;VERDADERO;10;;;
130580;130570;0;19869;VERDADERO;VERDADERO;10;;;
130580;130570;0;19870;VERDADERO;VERDADERO;10;;;
130580;130570;0;19871;VERDADERO;VERDADERO;10;;;
130616;130570;0;19872;VERDADERO;VERDADERO;46;;;
130616;130570;0;19873;VERDADERO;VERDADERO;46;;;
130616;130570;0;19874;VERDADERO;VERDADERO;46;;;
130616;130570;0;19875;VERDADERO;VERDADERO;46;;;
130616;130590;0;19876;VERDADERO;VERDADERO;26;;;
130649;130590;0;19877;FALSO;VERDADERO;59;;;
130649;130610;0;19878;VERDADERO;VERDADERO;39;;;
130649;130610;0;19879;VERDADERO;VERDADERO;39;;;
130649;130610;0;19880;VERDADERO;VERDADERO;39;;;
130649;130630;0;19881;VERDADERO;VERDADERO;19;;;
130649;130630;0;19882;VERDADERO;VERDADERO;19;;;
130681;130630;0;19883;FALSO;VERDADERO;51;;;
130681;130650;0;19884;VERDADERO;VERDADERO;31;;;
130681;130650;0;19885;VERDADERO;VERDADERO;31;;;
130681;130670;0;19886;VERDADERO;VERDADERO;11;;;
130681;130670;0;19887;VERDADERO;VERDADERO;11;;;
130717;130670;0;19888;VERDADERO;VERDADERO;47;;;
130717;130690;0;19889;VERDADERO;VERDADERO;27;;;
130717;130690;0;19890;VERDADERO;VERDADERO;27;;;
130717;130710;0;19891;VERDADERO;VERDADERO;7;;;
130717;130710;0;19892;VERDADERO;VERDADERO;7;;;
130748;130730;0;19893;VERDADERO;VERDADERO;18;;;
130748;130730;0;19894;VERDADERO;VERDADERO;18;;;
130748;130730;0;19895;VERDADERO;VERDADERO;18;;;
130748;130750;0;19896;VERDADERO;VERDADERO;-2;;;
130748;130750;0;19897;VERDADERO;VERDADERO;-2;;;
130781;130770;0;19898;VERDADERO;VERDADERO;11;;;
130781;130770;0;19899;VERDADERO;VERDADERO;11;;;
130781;130770;0;19900;VERDADERO;VERDADERO;11;;;
130781;130790;0;19901;VERDADERO;VERDADERO;-9;;;
130781;130790;0;19902;VERDADERO;VERDADERO;-9;;;
130781;130790;0;19903;VERDADERO;VERDADERO;-9;;;
130816;130810;0;19904;VERDADERO;VERDADERO;6;;;
130816;130810;0;19905;VERDADERO;VERDADERO;6;;;
130816;130830;0;19906;VERDADERO;VERDADERO;-14;;;
130816;130830;0;19907;VERDADERO;VERDADERO;-14;;;
130816;130850;0;19908;VERDADERO;VERDADERO;-34;;;
130849;130850;0;19909;VERDADERO;VERDADERO;-1;;;
130849;130850;0;19910;VERDADERO;VERDADERO;-1;;;
130849;130870;0;19911;VERDADERO;VERDADERO;-21;;;
130849;130870;0;19912;VERDADERO;VERDADERO;-21;;;
130849;130890;0;19913;VERDADERO;VERDADERO;-41;;;
130880;130890;0;19914;VERDADERO;VERDADERO;-10;;;
130880;130890;0;19915;VERDADERO;VERDADERO;-10;;;
130880;130890;0;19916;VERDADERO;VERDADERO;-10;;;
130880;130910;0;19917;VERDADERO;VERDADERO;-30;;;
130880;130910;0;19918;VERDADERO;VERDADERO;-30;;;
130880;130910;0;19919;VERDADERO;VERDADERO;-30;;;
130917;130930;1;19920;VERDADERO;VERDADERO;-13;;;
130917;130930;0;19921;VERDADERO;VERDADERO;-13;;;
130917;130930;0;19922;VERDADERO;VERDADERO;-13;;;
130917;130930;0;19923;VERDADERO;VERDADERO;-13;;;
130917;130930;0;19924;VERDADERO;VERDADERO;-13;;;
130949;130930;0;19925;VERDADERO;VERDADERO;19;;;
130949;130930;0;19926;VERDADERO;VERDADERO;19;;;
130949;130930;0;19927;VERDADERO;VERDADERO;19;;;
130949;130930;0;19928;VERDADERO;VERDADERO;19;;;
130949;130930;0;19929;VERDADERO;VERDADERO;19;;;
130981;130930;0;19930;FALSO;VERDADERO;51;;;
130981;130930;0;19931;FALSO;VERDADERO;51;;;
130981;130930;0;19932;FALSO;VERDADERO;51;;;
130981;130950;1;19933;VERDADERO;VERDADERO;31;;;
130981;130950;0;19934;VERDADERO;VERDADERO;31;;;
130981;130950;0;19935;VERDADERO;VERDADERO;31;;;
131017;130970;0;19936;VERDADERO;VERDADERO;47;;;
131017;130970;0;19937;VERDADERO;VERDADERO;47;;;
131017;130990;0;19938;VERDADERO;VERDADERO;27;;;
131017;130990;0;19939;VERDADERO;VERDADERO;27;;;
131017;130990;0;19940;VERDADERO;VERDADERO;27;;;
131048;130990;0;19941;FALSO;VERDADERO;58;;;
131048;131010;0;19942;VERDADERO;VERDADERO;38;;;
131048;131010;0;19943;VERDADERO;VERDADERO;38;;;
131048;131030;0;19944;VERDADERO;VERDADERO;18;;;
131048;131030;0;19945;VERDADERO;VERDADERO;18;;;
131080;131030;0;19946;FALSO;VERDADERO;50;;;
131080;131050;0;19947;VERDADERO;VERDADERO;30;;;
131080;131050;0;19948;VERDADERO;VERDADERO;30;;;
131080;131070;0;19949;VERDADERO;VERDADERO;10;;;
131080;131070;0;19950;VERDADERO;VERDADERO;10;;;
131080;131070;0;19951;VERDADERO;VERDADERO;10;;;
131116;131090;0;19952;VERDADERO;VERDADERO;26;;;
131116;131090;0;19953;VERDADERO;VERDADERO;26;;;
131116;131110;0;19954;VERDADERO;VERDADERO;6;;;
131116;131110;0;19955;VERDADERO;VERDADERO;6;;;
131116;131110;0;19956;VERDADERO;VERDADERO;6;;;
131148;131130;0;19957;VERDADERO;VERDADERO;18;;;
131148;131130;0;19958;VERDADERO;VERDADERO;18;;;
131148;131150;0;19959;VERDADERO;VERDADERO;-2;;;
131148;131150;0;19960;VERDADERO;VERDADERO;-2;;;
131148;131150;0;19961;VERDADERO;VERDADERO;-2;;;
131181;131170;0;19962;VERDADERO;VERDADERO;11;;;
131181;131170;0;19963;VERDADERO;VERDADERO;11;;;
131181;131190;0;19964;VERDADERO;VERDADERO;-9;;;
131181;131190;0;19965;VERDADERO;VERDADERO;-9;;;
131181;131190;0;19966;VERDADERO;VERDADERO;-9;;;
131217;131210;1;19967;VERDADERO;VERDADERO;7;;;
131217;131210;0;19968;VERDADERO;VERDADERO;7;;;
131217;131230;0;19969;VERDADERO;VERDADERO;-13;;;
131217;131230;0;19970;VERDADERO;VERDADERO;-13;;;
131217;131230;0;19971;VERDADERO;VERDADERO;-13;;;
131249;131250;0;19972;VERDADERO;VERDADERO;-1;;;
131249;131250;0;19973;VERDADERO;VERDADERO;-1;;;
131249;131270;0;19974;VERDADERO;VERDADERO;-21;;;
131249;131270;0;19975;VERDADERO;VERDADERO;-21;;;
131249;131290;0;19976;VERDADERO;VERDADERO;-41;;;
131281;131290;0;19977;VERDADERO;VERDADERO;-9;;;
131281;131290;0;19978;VERDADERO;VERDADERO;-9;;;
131281;131310;0;19979;VERDADERO;VERDADERO;-29;;;
131281;131310;0;19980;VERDADERO;VERDADERO;-29;;;
131281;131330;1;19981;VERDADERO;VERDADERO;-49;;;
131281;131330;0;19982;VERDADERO;VERDADERO;-49;;;
131316;131330;0;19983;VERDADERO;VERDADERO;-14;;;
131316;131350;0;19984;VERDADERO;VERDADERO;-34;;;
131316;131350;0;19985;VERDADERO;VERDADERO;-34;;;
131316;131350;0;19986;VERDADERO;VERDADERO;-34;;;
131316;131350;0;19987;VERDADERO;VERDADERO;-34;;;
131349;131350;0;19988;VERDADERO;VERDADERO;-1;;;
131349;131370;0;19989;VERDADERO;VERDADERO;-21;;;
131349;131370;0;19990;VERDADERO;VERDADERO;-21;;;
131349;131390;0;19991;VERDADERO;VERDADERO;-41;;;
131349;131390;0;19992;VERDADERO;VERDADERO;-41;;;
131381;131390;0;19993;VERDADERO;VERDADERO;-9;;;
131381;131390;0;19994;VERDADERO;VERDADERO;-9;;;
131381;131390;0;19995;VERDADERO;VERDADERO;-9;;;
131381;131410;0;19996;VERDADERO;VERDADERO;-29;;;
131381;131410;0;19997;VERDADERO;VERDADERO;-29;;;
131413;131410;0;19998;VERDADERO;VERDADERO;3;;;
131413;131431;0;19999;VERDADERO;VERDADERO;-18;;;
131413;131431;0;20000;VERDADERO;VERDADERO;-18;;;
131413;131451;0;20001;VERDADERO;VERDADERO;-38;;;
131413;131451;0;20002;VERDADERO;VERDADERO;-38;;;
131444;131451;0;20003;VERDADERO;VERDADERO;-7;;;
131444;131451;0;20004;VERDADERO;VERDADERO;-7;;;
131444;131471;0;20005;VERDADERO;VERDADERO;-27;;;
131444;131471;0;20006;VERDADERO;VERDADERO;-27;;;
131444;131491;1;20007;VERDADERO;VERDADERO;-47;;;
131444;131491;0;20008;VERDADERO;VERDADERO;-47;;;
131481;131491;0;20009;VERDADERO;VERDADERO;-10;;;
131481;131491;0;20010;VERDADERO;VERDADERO;-10;;;
131481;131491;0;20011;VERDADERO;VERDADERO;-10;;;
131481;131511;0;20012;VERDADERO;VERDADERO;-30;;;
131481;131511;0;20013;VERDADERO;VERDADERO;-30;;;
131512;131511;0;20014;VERDADERO;VERDADERO;1;;;
131512;131531;0;20015;VERDADERO;VERDADERO;-19;;;
131512;131531;0;20016;VERDADERO;VERDADERO;-19;;;
131512;131551;0;20017;VERDADERO;VERDADERO;-39;;;
131512;131551;0;20018;VERDADERO;VERDADERO;-39;;;
131544;131551;0;20019;VERDADERO;VERDADERO;-7;;;
131544;131551;0;20020;VERDADERO;VERDADERO;-7;;;
131544;131571;0;20021;VERDADERO;VERDADERO;-27;;;
131544;131571;0;20022;VERDADERO;VERDADERO;-27;;;
131544;131591;0;20023;VERDADERO;VERDADERO;-47;;;
131581;131591;0;20024;VERDADERO;VERDADERO;-10;;;
131581;131591;0;20025;VERDADERO;VERDADERO;-10;;;
131581;131591;0;20026;VERDADERO;VERDADERO;-10;;;
131581;131591;0;20027;VERDADERO;VERDADERO;-10;;;
131581;131611;0;20028;VERDADERO;VERDADERO;-30;;;
131613;131611;0;20029;VERDADERO;VERDADERO;2;;;
131613;131631;0;20030;VERDADERO;VERDADERO;-18;;;
131613;131631;0;20031;VERDADERO;VERDADERO;-18;;;
131613;131631;0;20032;VERDADERO;VERDADERO;-18;;;
131613;131651;0;20033;VERDADERO;VERDADERO;-38;;;
131645;131651;0;20034;VERDADERO;VERDADERO;-6;;;
131645;131651;0;20035;VERDADERO;VERDADERO;-6;;;
131645;131671;0;20036;VERDADERO;VERDADERO;-26;;;
131645;131671;0;20037;VERDADERO;VERDADERO;-26;;;
131645;131691;0;20038;VERDADERO;VERDADERO;-46;;;
131677;131691;0;20039;VERDADERO;VERDADERO;-14;;;
131677;131691;0;20040;VERDADERO;VERDADERO;-14;;;
131677;131691;0;20041;VERDADERO;VERDADERO;-14;;;
131677;131691;0;20042;VERDADERO;VERDADERO;-14;;;
131677;131691;0;20043;VERDADERO;VERDADERO;-14;;;
131709;131691;0;20044;VERDADERO;VERDADERO;18;;;
131709;131691;0;20045;VERDADERO;VERDADERO;18;;;
131709;131691;0;20046;VERDADERO;VERDADERO;18;;;
131709;131691;0;20047;VERDADERO;VERDADERO;18;;;
131709;131691;0;20048;VERDADERO;VERDADERO;18;;;
131709;131711;0;20049;VERDADERO;VERDADERO;-2;;;
131745;131711;0;20050;VERDADERO;VERDADERO;34;;;
131745;131731;0;20051;VERDADERO;VERDADERO;14;;;
131745;131731;0;20052;VERDADERO;VERDADERO;14;;;
131745;131731;0;20053;VERDADERO;VERDADERO;14;;;
131745;131751;0;20054;VERDADERO;VERDADERO;-6;;;
131776;131751;0;20055;VERDADERO;VERDADERO;25;;;
131776;131751;0;20056;VERDADERO;VERDADERO;25;;;
131776;131771;0;20057;VERDADERO;VERDADERO;5;;;
131776;131771;0;20058;VERDADERO;VERDADERO;5;;;
131776;131791;0;20059;VERDADERO;VERDADERO;-15;;;
131776;131791;0;20060;VERDADERO;VERDADERO;-15;;;
131813;131791;0;20061;VERDADERO;VERDADERO;22;;;
131813;131811;0;20062;VERDADERO;VERDADERO;2;;;
131813;131811;0;20063;VERDADERO;VERDADERO;2;;;
131813;131831;0;20064;VERDADERO;VERDADERO;-18;;;
131813;131831;0;20065;VERDADERO;VERDADERO;-18;;;
131844;131831;0;20066;VERDADERO;VERDADERO;13;;;
131844;131851;0;20067;VERDADERO;VERDADERO;-7;;;
131844;131851;0;20068;VERDADERO;VERDADERO;-7;;;
131844;131871;0;20069;VERDADERO;VERDADERO;-27;;;
131844;131871;0;20070;VERDADERO;VERDADERO;-27;;;
131880;131871;0;20071;VERDADERO;VERDADERO;9;;;
131880;131871;0;20072;VERDADERO;VERDADERO;9;;;
131880;131871;0;20073;VERDADERO;VERDADERO;9;;;
131880;131891;0;20074;VERDADERO;VERDADERO;-11;;;
131880;131891;0;20075;VERDADERO;VERDADERO;-11;;;
131880;131891;0;20076;VERDADERO;VERDADERO;-11;;;
131913;131911;0;20077;VERDADERO;VERDADERO;2;;;
131913;131911;0;20078;VERDADERO;VERDADERO;2;;;
131913;131931;0;20079;VERDADERO;VERDADERO;-18;;;
131913;131931;0;20080;VERDADERO;VERDADERO;-18;;;
131913;131931;0;20081;VERDADERO;VERDADERO;-18;;;
131948;131951;0;20082;VERDADERO;VERDADERO;-3;;;
131948;131951;0;20083;VERDADERO;VERDADERO;-3;;;
131948;131971;1;20084;VERDADERO;VERDADERO;-23;;;
131948;131971;0;20085;VERDADERO;VERDADERO;-23;;;
131948;131991;0;20086;VERDADERO;VERDADERO;-43;;;
131981;131991;0;20087;VERDADERO;VERDADERO;-10;;;
131981;131991;0;20088;VERDADERO;VERDADERO;-10;;;
131981;132011;0;20089;VERDADERO;VERDADERO;-30;;;
131981;132011;0;20090;VERDADERO;VERDADERO;-30;;;
131981;132031;1;20091;VERDADERO;FALSO;-50;;;
131981;132031;0;20092;VERDADERO;FALSO;-50;;;
132016;132031;0;20093;VERDADERO;VERDADERO;-15;;;
132016;132031;0;20094;VERDADERO;VERDADERO;-15;;;
132016;132051;0;20095;VERDADERO;VERDADERO;-35;;;
132016;132051;0;20096;VERDADERO;VERDADERO;-35;;;
132016;132051;0;20097;VERDADERO;VERDADERO;-35;;;
132049;132071;0;20098;VERDADERO;VERDADERO;-22;;;
132049;132071;0;20099;VERDADERO;VERDADERO;-22;;;
132049;132071;0;20100;VERDADERO;VERDADERO;-22;;;
132049;132071;0;20101;VERDADERO;VERDADERO;-22;;;
132049;132071;0;20102;VERDADERO;VERDADERO;-22;;;
132049;132071;0;20103;VERDADERO;VERDADERO;-22;;;
132085;132071;0;20104;VERDADERO;VERDADERO;14;;;
132085;132071;0;20105;VERDADERO;VERDADERO;14;;;
132085;132091;0;20106;VERDADERO;VERDADERO;-6;;;
132085;132091;0;20107;VERDADERO;VERDADERO;-6;;;
132085;132111;1;20108;VERDADERO;VERDADERO;-26;;;
132117;132111;0;20109;VERDADERO;VERDADERO;6;;;
132117;132111;0;20110;VERDADERO;VERDADERO;6;;;
132117;132131;0;20111;VERDADERO;VERDADERO;-14;;;
132117;132131;0;20112;VERDADERO;VERDADERO;-14;;;
132117;132151;0;20113;VERDADERO;VERDADERO;-34;;;
132149;132151;0;20114;VERDADERO;VERDADERO;-2;;;
132149;132151;0,00E+00;20115;VERDADERO;VERDADERO;-2;;;
132149;132171;0;20116;VERDADERO;VERDADERO;-22;;;
132149;132171;0;20117;VERDADERO;VERDADERO;-22;;;
132149;132191;1;20118;VERDADERO;VERDADERO;-42;;;
132149;132191;0;20119;VERDADERO;VERDADERO;-42;;;
132184;132191;0;20120;VERDADERO;VERDADERO;-7;;;
132184;132211;0;20121;VERDADERO;VERDADERO;-27;;;
132184;132211;0;20122;VERDADERO;VERDADERO;-27;;;
132184;132231;0;20123;VERDADERO;VERDADERO;-47;;;
132217;132231;0;20124;VERDADERO;VERDADERO;-14;;;
132217;132231;0;20125;VERDADERO;VERDADERO;-14;;;
132217;132231;0;20126;VERDADERO;VERDADERO;-14;;;
132217;132231;0;20127;VERDADERO;VERDADERO;-14;;;
132217;132231;0;20128;VERDADERO;VERDADERO;-14;;;
132248;132251;0;20129;VERDADERO;VERDADERO;-3;;;
132248;132251;0;20130;VERDADERO;VERDADERO;-3;;;
132248;132251;0;20131;VERDADERO;VERDADERO;-3;;;
132248;132271;0;20132;VERDADERO;VERDADERO;-23;;;
132248;132271;0;20133;VERDADERO;VERDADERO;-23;;;
132281;132271;0;20134;VERDADERO;VERDADERO;10;;;
132281;132271;0;20135;VERDADERO;VERDADERO;10;;;
132281;132271;0;20136;VERDADERO;VERDADERO;10;;;
132281;132271;0;20137;VERDADERO;VERDADERO;10;;;
132281;132271;0;20138;VERDADERO;VERDADERO;10;;;
132281;132271;0;20139;VERDADERO;VERDADERO;10;;;
132313;132271;0;20140;VERDADERO;VERDADERO;42;;;
132313;132271;0;20141;VERDADERO;VERDADERO;42;;;
132313;132271;0;20142;VERDADERO;VERDADERO;42;;;
132313;132271;0;20143;VERDADERO;VERDADERO;42;;;
132313;132291;0;20144;VERDADERO;VERDADERO;22;;;
132313;132291;0;20145;VERDADERO;VERDADERO;22;;;
132349;132311;0;20146;VERDADERO;VERDADERO;38;;;
132349;132311;0;20147;VERDADERO;VERDADERO;38;;;
132349;132311;0;20148;VERDADERO;VERDADERO;38;;;
132349;132331;0;20149;VERDADERO;VERDADERO;18;;;
132349;132331;0;20150;VERDADERO;VERDADERO;18;;;
132381;132351;1;20151;VERDADERO;VERDADERO;30;;;
132381;132351;0;20152;VERDADERO;VERDADERO;30;;;
132381;132351;0;20153;VERDADERO;VERDADERO;30;;;
132381;132371;0;20154;VERDADERO;VERDADERO;10;;;
132381;132371;0;20155;VERDADERO;VERDADERO;10;;;
132413;132391;0;20156;VERDADERO;VERDADERO;22;;;
132413;132391;0;20157;VERDADERO;VERDADERO;22;;;
132413;132411;0;20158;VERDADERO;VERDADERO;2;;;
132413;132411;0;20159;VERDADERO;VERDADERO;2;;;
132413;132411;0;20160;VERDADERO;VERDADERO;2;;;
132449;132431;0;20161;VERDADERO;VERDADERO;18;;;
132449;132431;0;20162;VERDADERO;VERDADERO;18;;;
132449;132451;0;20163;VERDADERO;VERDADERO;-2;;;
132449;132451;0;20164;VERDADERO;VERDADERO;-2;;;
132449;132451;0;20165;VERDADERO;VERDADERO;-2;;;
132481;132471;0;20166;VERDADERO;VERDADERO;10;;;
132481;132471;0;20167;VERDADERO;VERDADERO;10;;;
132481;132491;0;20168;VERDADERO;VERDADERO;-10;;;
132481;132491;0;20169;VERDADERO;VERDADERO;-10;;;
132481;132511;0;20170;VERDADERO;VERDADERO;-30;;;
132512;132511;0;20171;VERDADERO;VERDADERO;1;;;
132512;132511;0;20172;VERDADERO;VERDADERO;1;;;
132512;132531;0;20173;VERDADERO;VERDADERO;-19;;;
132512;132531;0;20174;VERDADERO;VERDADERO;-19;;;
132512;132551;1;20175;VERDADERO;VERDADERO;-39;;;
132544;132551;0;20176;VERDADERO;VERDADERO;-7;;;
132544;132551;0;20177;VERDADERO;VERDADERO;-7;;;
132544;132571;0;20178;VERDADERO;VERDADERO;-27;;;
132544;132571;0;20179;VERDADERO;VERDADERO;-27;;;
132544;132571;0;20180;VERDADERO;VERDADERO;-27;;;
132576;132571;0;20181;VERDADERO;VERDADERO;5;;;
132576;132571;0;20182;VERDADERO;VERDADERO;5;;;
132576;132571;0;20183;VERDADERO;VERDADERO;5;;;
132576;132571;0;20184;VERDADERO;VERDADERO;5;;;
132576;132571;0;20185;VERDADERO;VERDADERO;5;;;
132576;132591;0;20186;VERDADERO;VERDADERO;-15;;;
132612;132591;0;20187;VERDADERO;VERDADERO;21;;;
132612;132611;0;20188;VERDADERO;VERDADERO;1;;;
132612;132611;0;20189;VERDADERO;VERDADERO;1;;;
132612;132611;0;20190;VERDADERO;VERDADERO;1;;;
132612;132611;0;20191;VERDADERO;VERDADERO;1;;;
132644;132611;0;20192;VERDADERO;VERDADERO;33;;;
132644;132611;0;20193;VERDADERO;VERDADERO;33;;;
132644;132631;0;20194;VERDADERO;VERDADERO;13;;;
132644;132631;0;20195;VERDADERO;VERDADERO;13;;;
132644;132651;0;20196;VERDADERO;VERDADERO;-7;;;
132676;132651;0;20197;VERDADERO;VERDADERO;25;;;
132676;132651;0;20198;VERDADERO;VERDADERO;25;;;
132676;132671;0;20199;VERDADERO;VERDADERO;5;;;
132676;132671;0;20200;VERDADERO;VERDADERO;5;;;
132676;132691;1;20201;VERDADERO;VERDADERO;-15;;;
132676;132691;0;20202;VERDADERO;VERDADERO;-15;;;
132712;132691;0;20203;VERDADERO;VERDADERO;21;;;
132712;132711;0;20204;VERDADERO;VERDADERO;1;;;
132712;132711;0;20205;VERDADERO;VERDADERO;1;;;
132712;132731;0;20206;VERDADERO;VERDADERO;-19;;;
132712;132731;0;20207;VERDADERO;VERDADERO;-19;;;
132745;132731;0;20208;VERDADERO;VERDADERO;14;;;
132745;132751;0;20209;VERDADERO;VERDADERO;-6;;;
132745;132751;0;20210;VERDADERO;VERDADERO;-6;;;
132745;132771;0;20211;VERDADERO;VERDADERO;-26;;;
132777;132771;0;20212;VERDADERO;VERDADERO;6;;;
132777;132771;0;20213;VERDADERO;VERDADERO;6;;;
132777;132791;0;20214;VERDADERO;VERDADERO;-14;;;
132777;132791;0;20215;VERDADERO;VERDADERO;-14;;;
132777;132811;0;20216;VERDADERO;VERDADERO;-34;;;
132777;132811;0;20217;VERDADERO;VERDADERO;-34;;;
132812;132811;0;20218;VERDADERO;VERDADERO;1;;;
132812;132831;0;20219;VERDADERO;VERDADERO;-19;;;
132812;132831;0;20220;VERDADERO;VERDADERO;-19;;;
132812;132851;0;20221;VERDADERO;VERDADERO;-39;;;
132812;132851;0;20222;VERDADERO;VERDADERO;-39;;;
132845;132851;0;20223;VERDADERO;VERDADERO;-6;;;
132845;132871;0;20224;VERDADERO;VERDADERO;-26;;;
132845;132871;0;20225;VERDADERO;VERDADERO;-26;;;
132845;132891;0;20226;VERDADERO;VERDADERO;-46;;;
132845;132891;0;20227;VERDADERO;VERDADERO;-46;;;
132877;132891;0;20228;VERDADERO;VERDADERO;-14;;;
132877;132891;0;20229;VERDADERO;VERDADERO;-14;;;
132877;132911;0;20230;VERDADERO;VERDADERO;-34;;;
132877;132911;0;20231;VERDADERO;VERDADERO;-34;;;
132877;132911;0;20232;VERDADERO;VERDADERO;-34;;;
132877;132931;0;20233;VERDADERO;FALSO;-54;;;
132912;132931;0;20234;VERDADERO;VERDADERO;-19;;;
132912;132931;0;20235;VERDADERO;VERDADERO;-19;;;
132912;132931;0;20236;VERDADERO;VERDADERO;-19;;;
132912;132931;0;20237;VERDADERO;VERDADERO;-19;;;
132912;132951;0;20238;VERDADERO;VERDADERO;-39;;;
132945;132951;0;20239;VERDADERO;VERDADERO;-6;;;
132945;132971;0;20240;VERDADERO;VERDADERO;-26;;;
132945;132971;0;20241;VERDADERO;VERDADERO;-26;;;
132945;132971;0;20242;VERDADERO;VERDADERO;-26;;;
132945;132971;0;20243;VERDADERO;VERDADERO;-26;;;
132976;132971;0;20244;VERDADERO;VERDADERO;5;;;
132976;132971;0;20245;VERDADERO;VERDADERO;5;;;
132976;132971;0;20246;VERDADERO;VERDADERO;5;;;
132976;132991;0;20247;VERDADERO;VERDADERO;-15;;;
132976;132991;0;20248;VERDADERO;VERDADERO;-15;;;
132976;133011;0;20249;VERDADERO;VERDADERO;-35;;;
133013;133011;0;20250;VERDADERO;VERDADERO;2;;;
133013;133011;0;20251;VERDADERO;VERDADERO;2;;;
133013;133031;0;20252;VERDADERO;VERDADERO;-18;;;
133013;133031;0;20253;VERDADERO;VERDADERO;-18;;;
133013;133031;0;20254;VERDADERO;VERDADERO;-18;;;
133045;133031;0;20255;VERDADERO;VERDADERO;14;;;
133045;133031;0;20256;VERDADERO;VERDADERO;14;;;
133045;133031;0;20257;VERDADERO;VERDADERO;14;;;
133045;133051;0;20258;VERDADERO;VERDADERO;-6;;;
133045;133051;0;20259;VERDADERO;VERDADERO;-6;;;
133076;133051;0;20260;VERDADERO;VERDADERO;25;;;
133076;133071;0;20261;VERDADERO;VERDADERO;5;;;
133076;133071;0;20262;VERDADERO;VERDADERO;5;;;
133076;133091;1;20263;VERDADERO;VERDADERO;-15;;;
133076;133091;0;20264;VERDADERO;VERDADERO;-15;;;
133076;133091;0;20265;VERDADERO;VERDADERO;-15;;;
133112;133091;0;20266;VERDADERO;VERDADERO;21;;;
133112;133111;0;20267;VERDADERO;VERDADERO;1;;;
133112;133111;0;20268;VERDADERO;VERDADERO;1;;;
133112;133131;0;20269;VERDADERO;VERDADERO;-19;;;
133112;133131;0;20270;VERDADERO;VERDADERO;-19;;;
133145;133131;0;20271;VERDADERO;VERDADERO;14;;;
133145;133151;0;20272;VERDADERO;VERDADERO;-6;;;
133145;133151;0;20273;VERDADERO;VERDADERO;-6;;;
133145;133171;1;20274;VERDADERO;VERDADERO;-26;;;
133145;133171;0;20275;VERDADERO;VERDADERO;-26;;;
133176;133171;0;20276;VERDADERO;VERDADERO;5;;;
133176;133191;0;20277;VERDADERO;VERDADERO;-15;;;
133176;133191;0;20278;VERDADERO;VERDADERO;-15;;;
133176;133211;0;20279;VERDADERO;VERDADERO;-35;;;
133176;133211;0;20280;VERDADERO;VERDADERO;-35;;;
133209;133211;0;20281;VERDADERO;VERDADERO;-2;;;
133209;133231;0;20282;VERDADERO;VERDADERO;-22;;;
133209;133231;0;20283;VERDADERO;VERDADERO;-22;;;
133209;133251;1;20284;VERDADERO;VERDADERO;-42;;;
133209;133251;0;20285;VERDADERO;VERDADERO;-42;;;
133241;133251;0;20286;VERDADERO;VERDADERO;-10;;;
133241;133251;0;20287;VERDADERO;VERDADERO;-10;;;
133241;133271;0;20288;VERDADERO;VERDADERO;-30;;;
133241;133271;0;20289;VERDADERO;VERDADERO;-30;;;
133241;133271;0;20290;VERDADERO;VERDADERO;-30;;;
133241;133291;0;20291;VERDADERO;FALSO;-50;;;
133277;133291;0;20292;VERDADERO;VERDADERO;-14;;;
133277;133291;0;20293;VERDADERO;VERDADERO;-14;;;
133277;133291;0;20294;VERDADERO;VERDADERO;-14;;;
133277;133311;0;20295;VERDADERO;VERDADERO;-34;;;
133277;133311;0;20296;VERDADERO;VERDADERO;-34;;;
133309;133311;0;20297;VERDADERO;VERDADERO;-2;;;
133309;133331;0;20298;VERDADERO;VERDADERO;-22;;;
133309;133331;0;20299;VERDADERO;VERDADERO;-22;;;
133309;133351;0;20300;VERDADERO;VERDADERO;-42;;;
133309;133351;0;20301;VERDADERO;VERDADERO;-42;;;
133341;133351;0;20302;VERDADERO;VERDADERO;-10;;;
133341;133351;0;20303;VERDADERO;VERDADERO;-10;;;
133341;133371;0;20304;VERDADERO;VERDADERO;-30;;;
133341;133371;0;20305;VERDADERO;VERDADERO;-30;;;
133341;133371;0;20306;VERDADERO;VERDADERO;-30;;;
133341;133391;0;20307;VERDADERO;FALSO;-50;;;
133381;133391;0;20308;VERDADERO;VERDADERO;-10;;;
133381;133391;0;20309;VERDADERO;VERDADERO;-10;;;
133381;133391;0;20310;VERDADERO;VERDADERO;-10;;;
133381;133391;0;20311;VERDADERO;VERDADERO;-10;;;
133381;133411;0;20312;VERDADERO;VERDADERO;-30;;;
133409;133411;0;20313;VERDADERO;VERDADERO;-2;;;
133409;133431;0;20314;VERDADERO;VERDADERO;-22;;;
133409;133431;0;20315;VERDADERO;VERDADERO;-22;;;
133409;133451;0;20316;VERDADERO;VERDADERO;-42;;;
133440;133451;0;20317;VERDADERO;VERDADERO;-11;;;
133440;133451;0;20318;VERDADERO;VERDADERO;-11;;;
133440;133471;0;20319;VERDADERO;VERDADERO;-31;;;
133440;133471;0;20320;VERDADERO;VERDADERO;-31;;;
133440;133471;0;20321;VERDADERO;VERDADERO;-31;;;
133440;133491;0;20322;VERDADERO;FALSO;-51;;;
133477;133491;0;20323;VERDADERO;VERDADERO;-14;;;
133477;133491;0;20324;VERDADERO;VERDADERO;-14;;;
133477;133491;0;20325;VERDADERO;VERDADERO;-14;;;
133477;133491;0;20326;VERDADERO;VERDADERO;-14;;;
133477;133511;0;20327;VERDADERO;VERDADERO;-34;;;
133477;133511;0;20328;VERDADERO;VERDADERO;-34;;;
133512;133511;0;20329;VERDADERO;VERDADERO;1;;;
133512;133531;0;20330;VERDADERO;VERDADERO;-19;;;
133512;133531;0;20331;VERDADERO;VERDADERO;-19;;;
133512;133551;1;20332;VERDADERO;VERDADERO;-39;;;
133512;133551;0;20333;VERDADERO;VERDADERO;-39;;;
133544;133551;0;20334;VERDADERO;VERDADERO;-7;;;
133544;133571;0;20335;VERDADERO;VERDADERO;-27;;;
133544;133571;0;20336;VERDADERO;VERDADERO;-27;;;
133544;133571;0;20337;VERDADERO;VERDADERO;-27;;;
133544;133591;1;20338;VERDADERO;VERDADERO;-47;;;
133576;133591;0;20339;VERDADERO;VERDADERO;-15;;;
133576;133591;0;20340;VERDADERO;VERDADERO;-15;;;
133576;133591;0;20341;VERDADERO;VERDADERO;-15;;;
133576;133591;0;20342;VERDADERO;VERDADERO;-15;;;
133576;133611;0;20343;VERDADERO;VERDADERO;-35;;;
133576;133611;0;20344;VERDADERO;VERDADERO;-35;;;
133613;133611;0;20345;VERDADERO;VERDADERO;2;;;
133613;133631;0;20346;VERDADERO;VERDADERO;-18;;;
133613;133631;0;20347;VERDADERO;VERDADERO;-18;;;
133613;133651;0;20348;VERDADERO;VERDADERO;-38;;;
133613;133651;0;20349;VERDADERO;VERDADERO;-38;;;
133649;133651;0;20350;VERDADERO;VERDADERO;-2;;;
133649;133651;0;20351;VERDADERO;VERDADERO;-2;;;
133649;133671;0;20352;VERDADERO;VERDADERO;-22;;;
133649;133671;0;20353;VERDADERO;VERDADERO;-22;;;
133649;133671;0;20354;VERDADERO;VERDADERO;-22;;;
133680;133691;0;20355;VERDADERO;VERDADERO;-11;;;
133680;133691;0;20356;VERDADERO;VERDADERO;-11;;;
133680;133691;0;20357;VERDADERO;VERDADERO;-11;;;
133680;133691;0;20358;VERDADERO;VERDADERO;-11;;;
133680;133691;0;20359;VERDADERO;VERDADERO;-11;;;
133680;133711;0;20360;VERDADERO;VERDADERO;-31;;;
133717;133711;0;20361;VERDADERO;VERDADERO;6;;;
133717;133731;0;20362;VERDADERO;VERDADERO;-14;;;
133717;133731;0;20363;VERDADERO;VERDADERO;-14;;;
133717;133731;0;20364;VERDADERO;VERDADERO;-14;;;
133717;133751;0;20365;VERDADERO;VERDADERO;-34;;;
133748;133751;0;20366;VERDADERO;VERDADERO;-3;;;
133748;133771;0;20367;VERDADERO;VERDADERO;-23;;;
133748;133771;0;20368;VERDADERO;VERDADERO;-23;;;
133748;133771;0;20369;VERDADERO;VERDADERO;-23;;;
133748;133791;0;20370;VERDADERO;VERDADERO;-43;;;
133780;133791;0;20371;VERDADERO;VERDADERO;-11;;;
133780;133811;0;20372;VERDADERO;VERDADERO;-31;;;
133780;133811;0;20373;VERDADERO;VERDADERO;-31;;;
133780;133811;0;20374;VERDADERO;VERDADERO;-31;;;
133780;133831;1;20375;VERDADERO;FALSO;-51;;;
133780;133831;0;20376;VERDADERO;FALSO;-51;;;
133816;133831;0;20377;VERDADERO;VERDADERO;-15;;;
133816;133851;0;20378;VERDADERO;VERDADERO;-35;;;
133816;133851;0;20379;VERDADERO;VERDADERO;-35;;;
133816;133851;0;20380;VERDADERO;VERDADERO;-35;;;
133816;133851;0;20381;VERDADERO;VERDADERO;-35;;;
133849;133851;0;20382;VERDADERO;VERDADERO;-2;;;
133849;133871;0;20383;VERDADERO;VERDADERO;-22;;;
133849;133871;0;20384;VERDADERO;VERDADERO;-22;;;
133849;133871;0;20385;VERDADERO;VERDADERO;-22;;;
133881;133891;0;20386;VERDADERO;VERDADERO;-10;;;
133881;133891;0;20387;VERDADERO;VERDADERO;-10;;;
133881;133891;0;20388;VERDADERO;VERDADERO;-10;;;
133881;133891;0;20389;VERDADERO;VERDADERO;-10;;;
133881;133891;0;20390;VERDADERO;VERDADERO;-10;;;
133881;133911;0;20391;VERDADERO;VERDADERO;-30;;;
133913;133911;0;20392;VERDADERO;VERDADERO;2;;;
133913;133911;0;20393;VERDADERO;VERDADERO;2;;;
133913;133932;0;20394;VERDADERO;VERDADERO;-19;;;
133913;133932;0;20395;VERDADERO;VERDADERO;-19;;;
133944;133952;0;20396;VERDADERO;VERDADERO;-8;;;
133944;133952;0;20397;VERDADERO;VERDADERO;-8;;;
133944;133952;0;20398;VERDADERO;VERDADERO;-8;;;
133944;133972;1;20399;VERDADERO;VERDADERO;-28;;;
133944;133972;0;20400;VERDADERO;VERDADERO;-28;;;
133944;133992;0;20401;VERDADERO;VERDADERO;-48;;;
133981;133992;0;20402;VERDADERO;VERDADERO;-11;;;
133981;133992;0;20403;VERDADERO;VERDADERO;-11;;;
133981;133992;0;20404;VERDADERO;VERDADERO;-11;;;
133981;133992;0;20405;VERDADERO;VERDADERO;-11;;;
133981;134012;0;20406;VERDADERO;VERDADERO;-31;;;
134012;134012;0;20407;VERDADERO;VERDADERO;0;;;
134012;134032;0;20408;VERDADERO;VERDADERO;-20;;;
134012;134032;0;20409;VERDADERO;VERDADERO;-20;;;
134012;134032;0;20410;VERDADERO;VERDADERO;-20;;;
134012;134052;0;20411;VERDADERO;VERDADERO;-40;;;
134044;134052;0;20412;VERDADERO;VERDADERO;-8;;;
134044;134052;0;20413;VERDADERO;VERDADERO;-8;;;
134044;134072;0;20414;VERDADERO;VERDADERO;-28;;;
134044;134072;0;20415;VERDADERO;VERDADERO;-28;;;
134044;134072;0;20416;VERDADERO;VERDADERO;-28;;;
134044;134092;0;20417;VERDADERO;VERDADERO;-48;;;
134080;134092;0;20418;VERDADERO;VERDADERO;-12;;;
134080;134092;0;20419;VERDADERO;VERDADERO;-12;;;
134080;134092;0;20420;VERDADERO;VERDADERO;-12;;;
134080;134092;0;20421;VERDADERO;VERDADERO;-12;;;
134080;134112;1;20422;VERDADERO;VERDADERO;-32;;;
134113;134112;0;20423;VERDADERO;VERDADERO;1;;;
134113;134132;0;20424;VERDADERO;VERDADERO;-19;;;
134113;134132;0;20425;VERDADERO;VERDADERO;-19;;;
134113;134132;0;20426;VERDADERO;VERDADERO;-19;;;
134113;134152;0;20427;VERDADERO;VERDADERO;-39;;;
134145;134152;0;20428;VERDADERO;VERDADERO;-7;;;
134145;134152;0;20429;VERDADERO;VERDADERO;-7;;;
134145;134152;0;20430;VERDADERO;VERDADERO;-7;;;
134145;134152;0;20431;VERDADERO;VERDADERO;-7;;;
134145;134152;0;20432;VERDADERO;VERDADERO;-7;;;
134176;134172;0;20433;VERDADERO;VERDADERO;4;;;
134176;134172;0;20434;VERDADERO;VERDADERO;4;;;
134176;134172;0;20435;VERDADERO;VERDADERO;4;;;
134176;134192;0;20436;VERDADERO;VERDADERO;-16;;;
134176;134192;0;20437;VERDADERO;VERDADERO;-16;;;
134209;134212;1;20438;VERDADERO;VERDADERO;-3;;;
134209;134212;0;20439;VERDADERO;VERDADERO;-3;;;
134209;134212;0;20440;VERDADERO;VERDADERO;-3;;;
134209;134232;0;20441;VERDADERO;VERDADERO;-23;;;
134209;134232;0;20442;VERDADERO;VERDADERO;-23;;;
134209;134252;1;20443;VERDADERO;VERDADERO;-43;;;
134244;134252;0;20444;VERDADERO;VERDADERO;-8;;;
134244;134252;0;20445;VERDADERO;VERDADERO;-8;;;
134244;134272;0;20446;VERDADERO;VERDADERO;-28;;;
134244;134272;0;20447;VERDADERO;VERDADERO;-28;;;
134244;134272;0;20448;VERDADERO;VERDADERO;-28;;;
134277;134272;0;20449;VERDADERO;VERDADERO;5;;;
134277;134292;0;20450;VERDADERO;VERDADERO;-15;;;
134277;134292;0;20451;VERDADERO;VERDADERO;-15;;;
134277;134312;0;20452;VERDADERO;VERDADERO;-35;;;
134277;134312;0;20453;VERDADERO;VERDADERO;-35;;;
134308;134312;0;20454;VERDADERO;VERDADERO;-4;;;
134308;134332;0;20455;VERDADERO;VERDADERO;-24;;;
134308;134332;0;20456;VERDADERO;VERDADERO;-24;;;
134308;134352;0;20457;VERDADERO;VERDADERO;-44;;;
134308;134352;0;20458;VERDADERO;VERDADERO;-44;;;
134340;134352;0;20459;VERDADERO;VERDADERO;-12;;;
134340;134372;0;20460;VERDADERO;VERDADERO;-32;;;
134340;134372;0;20461;VERDADERO;VERDADERO;-32;;;
134340;134372;0;20462;VERDADERO;VERDADERO;-32;;;
134340;134372;0;20463;VERDADERO;VERDADERO;-32;;;
134373;134372;0;20464;VERDADERO;VERDADERO;1;;;
134373;134392;0;20465;VERDADERO;VERDADERO;-19;;;
134373;134392;0;20466;VERDADERO;VERDADERO;-19;;;
134373;134412;0;20467;VERDADERO;VERDADERO;-39;;;
134373;134412;0;20468;VERDADERO;VERDADERO;-39;;;
134408;134412;0;20469;VERDADERO;VERDADERO;-4;;;
134408;134432;0;20470;VERDADERO;VERDADERO;-24;;;
134408;134432;0;20471;VERDADERO;VERDADERO;-24;;;
134408;134432;0;20472;VERDADERO;VERDADERO;-24;;;
134408;134432;0;20473;VERDADERO;VERDADERO;-24;;;
134408;134432;0;20474;VERDADERO;VERDADERO;-24;;;
134440;134432;0;20475;VERDADERO;VERDADERO;8;;;
134440;134432;0;20476;VERDADERO;VERDADERO;8;;;
134440;134432;0;20477;VERDADERO;VERDADERO;8;;;
134440;134432;0;20478;VERDADERO;VERDADERO;8;;;
134440;134432;0;20479;VERDADERO;VERDADERO;8;;;
134472;134432;0;20480;VERDADERO;VERDADERO;40;;;
134472;134432;0;20481;VERDADERO;VERDADERO;40;;;
134472;134432;0;20482;VERDADERO;VERDADERO;40;;;
134472;134432;0;20483;VERDADERO;VERDADERO;40;;;
134472;134432;0;20484;VERDADERO;VERDADERO;40;;;
134472;134432;0;20485;VERDADERO;VERDADERO;40;;;
134472;134432;0;20486;VERDADERO;VERDADERO;40;;;
134513;134432;0;20487;FALSO;VERDADERO;81;;;
134513;134432;0;20488;FALSO;VERDADERO;81;;;
134513;134452;0;20489;FALSO;VERDADERO;61;;;
134513;134452;0;20490;FALSO;VERDADERO;61;;;
134540;134452;0;20491;FALSO;VERDADERO;88;;;
134540;134472;0;20492;FALSO;VERDADERO;68;;;
134540;134472;0;20493;FALSO;VERDADERO;68;;;
134540;134492;0;20494;VERDADERO;VERDADERO;48;;;
134572;134492;0;20495;FALSO;VERDADERO;80;;;
134572;134512;0;20496;FALSO;VERDADERO;60;;;
134572;134512;0;20497;FALSO;VERDADERO;60;;;
134572;134532;0;20498;VERDADERO;VERDADERO;40;;;
134572;134532;0;20499;VERDADERO;VERDADERO;40;;;
134572;134532;0;20500;VERDADERO;VERDADERO;40;;;
134608;134552;0;20501;FALSO;VERDADERO;56;;;
134608;134552;0;20502;FALSO;VERDADERO;56;;;
134608;134572;0;20503;VERDADERO;VERDADERO;36;;;
134608;134572;0;20504;VERDADERO;VERDADERO;36;;;
134608;134572;0;20505;VERDADERO;VERDADERO;36;;;
134608;134592;0;20506;VERDADERO;VERDADERO;16;;;
134645;134592;0;20507;FALSO;VERDADERO;53;;;
134645;134612;0;20508;VERDADERO;VERDADERO;33;;;
134645;134612;0;20509;VERDADERO;VERDADERO;33;;;
134645;134612;0;20510;VERDADERO;VERDADERO;33;;;
134645;134632;0;20511;VERDADERO;VERDADERO;13;;;
134677;134632;0;20512;VERDADERO;VERDADERO;45;;;
134677;134652;0;20513;VERDADERO;VERDADERO;25;;;
134677;134652;0;20514;VERDADERO;VERDADERO;25;;;
134677;134652;0;20515;VERDADERO;VERDADERO;25;;;
134709;134672;0;20516;VERDADERO;VERDADERO;37;;;
134709;134672;0;20517;VERDADERO;VERDADERO;37;;;
134709;134692;0;20518;VERDADERO;VERDADERO;17;;;
134709;134692;0;20519;VERDADERO;VERDADERO;17;;;
134709;134712;0;20520;VERDADERO;VERDADERO;-3;;;
134709;134712;0;20521;VERDADERO;VERDADERO;-3;;;
134745;134712;0;20522;VERDADERO;VERDADERO;33;;;
134745;134732;0;20523;VERDADERO;VERDADERO;13;;;
134745;134732;0;20524;VERDADERO;VERDADERO;13;;;
134745;134752;0;20525;VERDADERO;VERDADERO;-7;;;
134745;134752;0;20526;VERDADERO;VERDADERO;-7;;;
134777;134752;0;20527;VERDADERO;VERDADERO;25;;;
134777;134772;0;20528;VERDADERO;VERDADERO;5;;;
134777;134772;0;20529;VERDADERO;VERDADERO;5;;;
134777;134792;0;20530;VERDADERO;VERDADERO;-15;;;
134777;134792;0;20531;VERDADERO;VERDADERO;-15;;;
134808;134792;0;20532;VERDADERO;VERDADERO;16;;;
134808;134812;0;20533;VERDADERO;VERDADERO;-4;;;
134808;134812;0;20534;VERDADERO;VERDADERO;-4;;;
134808;134832;0;20535;VERDADERO;VERDADERO;-24;;;
134808;134832;0;20536;VERDADERO;VERDADERO;-24;;;
134808;134832;0;20537;VERDADERO;VERDADERO;-24;;;
134844;134853;0;20538;VERDADERO;VERDADERO;-9;;;
134844;134853;0;20539;VERDADERO;VERDADERO;-9;;;
134844;134873;0;20540;VERDADERO;VERDADERO;-29;;;
134844;134873;0;20541;VERDADERO;VERDADERO;-29;;;
134844;134873;0;20542;VERDADERO;VERDADERO;-29;;;
134876;134873;0;20543;VERDADERO;VERDADERO;3;;;
134876;134893;0;20544;VERDADERO;VERDADERO;-17;;;
134876;134893;0;20545;VERDADERO;VERDADERO;-17;;;
134876;134913;0;20546;VERDADERO;VERDADERO;-37;;;
134908;134913;0;20547;VERDADERO;VERDADERO;-5;;;
134908;134913;0;20548;VERDADERO;VERDADERO;-5;;;
134908;134913;0;20549;VERDADERO;VERDADERO;-5;;;
134908;134913;0;20550;VERDADERO;VERDADERO;-5;;;
134908;134913;0;20551;VERDADERO;VERDADERO;-5;;;
134908;134913;0;20552;VERDADERO;VERDADERO;-5;;;
134940;134933;1;20553;VERDADERO;VERDADERO;7;;;
134940;134933;0;20554;VERDADERO;VERDADERO;7;;;
134940;134953;0;20555;VERDADERO;VERDADERO;-13;;;
134940;134953;0;20556;VERDADERO;VERDADERO;-13;;;
134940;134953;0;20557;VERDADERO;VERDADERO;-13;;;
134973;134973;0;20558;VERDADERO;VERDADERO;0;;;
134973;134973;0;20559;VERDADERO;VERDADERO;0;;;
134973;134993;0;20560;VERDADERO;VERDADERO;-20;;;
134973;134993;0;20561;VERDADERO;VERDADERO;-20;;;
134973;134993;0;20562;VERDADERO;VERDADERO;-20;;;
135009;135013;0;20563;VERDADERO;VERDADERO;-4;;;
135009;135013;0;20564;VERDADERO;VERDADERO;-4;;;
135009;135033;0;20565;VERDADERO;VERDADERO;-24;;;
135009;135033;0;20566;VERDADERO;VERDADERO;-24;;;
135009;135033;0;20567;VERDADERO;VERDADERO;-24;;;
135041;135053;1;20568;VERDADERO;VERDADERO;-12;;;
135041;135053;0;20569;VERDADERO;VERDADERO;-12;;;
135041;135073;0;20570;VERDADERO;VERDADERO;-32;;;
135041;135073;0;20571;VERDADERO;VERDADERO;-32;;;
135041;135073;0;20572;VERDADERO;VERDADERO;-32;;;
135073;135093;1;20573;VERDADERO;VERDADERO;-20;;;
135073;135093;0;20574;VERDADERO;VERDADERO;-20;;;
135073;135113;0;20575;VERDADERO;VERDADERO;-40;;;
135073;135113;0;20576;VERDADERO;VERDADERO;-40;;;
135073;135113;0;20577;VERDADERO;VERDADERO;-40;;;
135073;135133;1;20578;VERDADERO;FALSO;-60;;;
135111;135133;0;20579;VERDADERO;VERDADERO;-22;;;
135111;135133;0;20580;VERDADERO;VERDADERO;-22;;;
135111;135133;0;20581;VERDADERO;VERDADERO;-22;;;
135111;135133;0;20582;VERDADERO;VERDADERO;-22;;;
135111;135133;0;20583;VERDADERO;VERDADERO;-22;;;
135141;135153;0;20584;VERDADERO;VERDADERO;-12;;;
135141;135153;0;20585;VERDADERO;VERDADERO;-12;;;
135141;135173;1;20586;VERDADERO;VERDADERO;-32;;;
135141;135173;0;20587;VERDADERO;VERDADERO;-32;;;
135141;135173;0;20588;VERDADERO;VERDADERO;-32;;;
135173;135173;0;20589;VERDADERO;VERDADERO;0;;;
135173;135173;0;20590;VERDADERO;VERDADERO;0;;;
135173;135173;0;20591;VERDADERO;VERDADERO;0;;;
135173;135193;1;20592;VERDADERO;VERDADERO;-20;;;
135173;135193;0;20593;VERDADERO;VERDADERO;-20;;;
135173;135193;0;20594;VERDADERO;VERDADERO;-20;;;
135208;135213;0;20595;VERDADERO;VERDADERO;-5;;;
135208;135213;0;20596;VERDADERO;VERDADERO;-5;;;
135208;135233;0;20597;VERDADERO;VERDADERO;-25;;;
135208;135233;0;20598;VERDADERO;VERDADERO;-25;;;
135208;135233;0;20599;VERDADERO;VERDADERO;-25;;;
135208;135253;0;20600;VERDADERO;VERDADERO;-45;;;
135249;135253;0;20601;VERDADERO;VERDADERO;-4;;;
135249;135273;0;20602;VERDADERO;VERDADERO;-24;;;
135249;135273;0;20603;VERDADERO;VERDADERO;-24;;;
135249;135273;0;20604;VERDADERO;VERDADERO;-24;;;
135277;135293;1;20605;VERDADERO;VERDADERO;-16;;;
135277;135293;0;20606;VERDADERO;VERDADERO;-16;;;
135277;135313;0;20607;VERDADERO;VERDADERO;-36;;;
135277;135313;0;20608;VERDADERO;VERDADERO;-36;;;
135277;135313;0;20609;VERDADERO;VERDADERO;-36;;;
135309;135333;0;20610;VERDADERO;VERDADERO;-24;;;
135309;135333;0;20611;VERDADERO;VERDADERO;-24;;;
135309;135333;0;20612;VERDADERO;VERDADERO;-24;;;
135309;135333;0;20613;VERDADERO;VERDADERO;-24;;;
135309;135353;0;20614;VERDADERO;VERDADERO;-44;;;
135341;135353;0;20615;VERDADERO;VERDADERO;-12;;;
135341;135373;0;20616;VERDADERO;VERDADERO;-32;;;
135341;135373;0;20617;VERDADERO;VERDADERO;-32;;;
135341;135373;0;20618;VERDADERO;VERDADERO;-32;;;
135341;135373;0;20619;VERDADERO;VERDADERO;-32;;;
135374;135373;0;20620;VERDADERO;VERDADERO;1;;;
135374;135393;0;20621;VERDADERO;VERDADERO;-19;;;
135374;135393;0;20622;VERDADERO;VERDADERO;-19;;;
135374;135393;0;20623;VERDADERO;VERDADERO;-19;;;
135374;135413;0;20624;VERDADERO;VERDADERO;-39;;;
135374;135413;0;20625;VERDADERO;VERDADERO;-39;;;
135409;135413;0;20626;VERDADERO;VERDADERO;-4;;;
135409;135413;0;20627;VERDADERO;VERDADERO;-4;;;
135409;135413;0;20628;VERDADERO;VERDADERO;-4;;;
135409;135413;0;20629;VERDADERO;VERDADERO;-4;;;
135409;135413;0;20630;VERDADERO;VERDADERO;-4;;;
135441;135413;0;20631;VERDADERO;VERDADERO;28;;;
135441;135433;0;20632;VERDADERO;VERDADERO;8;;;
135441;135433;0;20633;VERDADERO;VERDADERO;8;;;
135441;135433;0;20634;VERDADERO;VERDADERO;8;;;
135441;135454;0;20635;VERDADERO;VERDADERO;-13;;;
135473;135454;0;20636;VERDADERO;VERDADERO;19;;;
135473;135474;0;20637;VERDADERO;VERDADERO;-1;;;
135473;135474;0;20638;VERDADERO;VERDADERO;-1;;;
135473;135474;0;20639;VERDADERO;VERDADERO;-1;;;
135473;135494;0;20640;VERDADERO;VERDADERO;-21;;;
135506;135494;0;20641;VERDADERO;VERDADERO;12;;;
135506;135514;0;20642;VERDADERO;VERDADERO;-8;;;
135506;135514;0;20643;VERDADERO;VERDADERO;-8;;;
135506;135514;0;20644;VERDADERO;VERDADERO;-8;;;
135506;135534;0;20645;VERDADERO;VERDADERO;-28;;;
135537;135534;0;20646;VERDADERO;VERDADERO;3;;;
135537;135534;0;20647;VERDADERO;VERDADERO;3;;;
135537;135554;0;20648;VERDADERO;VERDADERO;-17;;;
135537;135554;0;20649;VERDADERO;VERDADERO;-17;;;
135537;135554;0;20650;VERDADERO;VERDADERO;-17;;;
135537;135574;0;20651;VERDADERO;VERDADERO;-37;;;
135573;135574;0;20652;VERDADERO;VERDADERO;-1;;;
135573;135594;0;20653;VERDADERO;VERDADERO;-21;;;
135573;135594;0;20654;VERDADERO;VERDADERO;-21;;;
135573;135594;0;20655;VERDADERO;VERDADERO;-21;;;
135573;135614;0;20656;VERDADERO;VERDADERO;-41;;;
135608;135614;0;20657;VERDADERO;VERDADERO;-6;;;
135608;135614;0;20658;VERDADERO;VERDADERO;-6;;;
135608;135634;0;20659;VERDADERO;VERDADERO;-26;;;
135608;135634;0;20660;VERDADERO;VERDADERO;-26;;;
135608;135634;0;20661;VERDADERO;VERDADERO;-26;;;
135640;135634;0;20662;VERDADERO;VERDADERO;6;;;
135640;135634;0;20663;VERDADERO;VERDADERO;6;;;
135640;135654;0;20664;VERDADERO;VERDADERO;-14;;;
135640;135654;0;20665;VERDADERO;VERDADERO;-14;;;
135640;135654;0;20666;VERDADERO;VERDADERO;-14;;;
135640;135674;0;20667;VERDADERO;VERDADERO;-34;;;
135677;135674;0;20668;VERDADERO;VERDADERO;3;;;
135677;135694;1;20669;VERDADERO;VERDADERO;-17;;;
135677;135694;0;20670;VERDADERO;VERDADERO;-17;;;
135677;135694;0;20671;VERDADERO;VERDADERO;-17;;;
135677;135714;0;20672;VERDADERO;VERDADERO;-37;;;
135709;135714;0;20673;VERDADERO;VERDADERO;-5;;;
135709;135734;0;20674;VERDADERO;VERDADERO;-25;;;
135709;135734;0;20675;VERDADERO;VERDADERO;-25;;;
135709;135734;0;20676;VERDADERO;VERDADERO;-25;;;
135709;135734;0;20677;VERDADERO;VERDADERO;-25;;;
135741;135754;0;20678;VERDADERO;VERDADERO;-13;;;
135741;135754;0;20679;VERDADERO;VERDADERO;-13;;;
135741;135754;0;20680;VERDADERO;VERDADERO;-13;;;
135741;135774;0;20681;VERDADERO;VERDADERO;-33;;;
135741;135774;0;20682;VERDADERO;VERDADERO;-33;;;
135773;135794;0;20683;VERDADERO;VERDADERO;-21;;;
135773;135794;0;20684;VERDADERO;VERDADERO;-21;;;
135773;135794;0;20685;VERDADERO;VERDADERO;-21;;;
135773;135794;0;20686;VERDADERO;VERDADERO;-21;;;
135773;135794;0;20687;VERDADERO;VERDADERO;-21;;;
135804;135794;0;20688;VERDADERO;VERDADERO;10;;;
135804;135814;0;20689;VERDADERO;VERDADERO;-10;;;
135804;135814;0;20690;VERDADERO;VERDADERO;-10;;;
135804;135834;1;20691;VERDADERO;VERDADERO;-30;;;
135804;135834;0;20692;VERDADERO;VERDADERO;-30;;;
135804;135834;0;20693;VERDADERO;VERDADERO;-30;;;
135840;135834;0;20694;VERDADERO;VERDADERO;6;;;
135840;135834;0;20695;VERDADERO;VERDADERO;6;;;
135840;135834;0;20696;VERDADERO;VERDADERO;6;;;
135840;135854;0;20697;VERDADERO;VERDADERO;-14;;;
135840;135854;0;20698;VERDADERO;VERDADERO;-14;;;
135873;135874;0;20699;VERDADERO;VERDADERO;-1;;;
135873;135874;0;20700;VERDADERO;VERDADERO;-1;;;
135873;135874;0;20701;VERDADERO;VERDADERO;-1;;;
135873;135894;0;20702;VERDADERO;VERDADERO;-21;;;
135873;135894;0;20703;VERDADERO;VERDADERO;-21;;;
135904;135894;0;20704;VERDADERO;VERDADERO;10;;;
135904;135894;0;20705;VERDADERO;VERDADERO;10;;;
135904;135914;0;20706;VERDADERO;VERDADERO;-10;;;
135904;135914;0;20707;VERDADERO;VERDADERO;-10;;;
135904;135914;0;20708;VERDADERO;VERDADERO;-10;;;
135904;135934;0;20709;VERDADERO;VERDADERO;-30;;;
135937;135934;0;20710;VERDADERO;VERDADERO;3;;;
135937;135954;0;20711;VERDADERO;VERDADERO;-17;;;
135937;135954;0;20712;VERDADERO;VERDADERO;-17;;;
135937;135954;0;20713;VERDADERO;VERDADERO;-17;;;
135969;135974;0;20714;VERDADERO;VERDADERO;-5;;;
135969;135974;0;20715;VERDADERO;VERDADERO;-5;;;
135969;135994;0;20716;VERDADERO;VERDADERO;-25;;;
135969;135994;0;20717;VERDADERO;VERDADERO;-25;;;
135969;135994;0;20718;VERDADERO;VERDADERO;-25;;;
135969;136014;0;20719;VERDADERO;VERDADERO;-45;;;
136004;136014;0;20720;VERDADERO;VERDADERO;-10;;;
136004;136014;0;20721;VERDADERO;VERDADERO;-10;;;
136004;136014;0;20722;VERDADERO;VERDADERO;-10;;;
136004;136014;0;20723;VERDADERO;VERDADERO;-10;;;
136004;136014;0;20724;VERDADERO;VERDADERO;-10;;;
136037;136014;0;20725;VERDADERO;VERDADERO;23;;;
136037;136034;0;20726;VERDADERO;VERDADERO;3;;;
136037;136034;0;20727;VERDADERO;VERDADERO;3;;;
136037;136034;0;20728;VERDADERO;VERDADERO;3;;;
136037;136054;0;20729;VERDADERO;VERDADERO;-17;;;
136037;136054;0;20730;VERDADERO;VERDADERO;-17;;;
136072;136054;0;20731;VERDADERO;VERDADERO;18;;;
136072;136054;0;20732;VERDADERO;VERDADERO;18;;;
136072;136074;1;20733;VERDADERO;VERDADERO;-2;;;
136072;136074;0;20734;VERDADERO;VERDADERO;-2;;;
136072;136074;0;20735;VERDADERO;VERDADERO;-2;;;
136104;136094;0;20736;VERDADERO;VERDADERO;10;;;
136104;136094;0;20737;VERDADERO;VERDADERO;10;;;
136104;136114;0;20738;VERDADERO;VERDADERO;-10;;;
136104;136114;0;20739;VERDADERO;VERDADERO;-10;;;
136104;136114;0;20740;VERDADERO;VERDADERO;-10;;;
136104;136134;0;20741;VERDADERO;VERDADERO;-30;;;
136145;136134;0;20742;VERDADERO;VERDADERO;11;;;
136145;136154;0;20743;VERDADERO;VERDADERO;-9;;;
136145;136154;0;20744;VERDADERO;VERDADERO;-9;;;
136145;136154;0;20745;VERDADERO;VERDADERO;-9;;;
136145;136174;1;20746;VERDADERO;VERDADERO;-29;;;
136173;136174;0;20747;VERDADERO;VERDADERO;-1;;;
136173;136194;0;20748;VERDADERO;VERDADERO;-21;;;
136173;136194;0;20749;VERDADERO;VERDADERO;-21;;;
136173;136214;0;20750;VERDADERO;VERDADERO;-41;;;
136204;136214;0;20751;VERDADERO;VERDADERO;-10;;;
136204;136214;0;20752;VERDADERO;VERDADERO;-10;;;
136204;136214;0;20753;VERDADERO;VERDADERO;-10;;;
136204;136234;0;20754;VERDADERO;VERDADERO;-30;;;
136204;136234;0;20755;VERDADERO;VERDADERO;-30;;;
136204;136234;0;20756;VERDADERO;VERDADERO;-30;;;
136241;136254;0;20757;VERDADERO;VERDADERO;-13;;;
136241;136254;0;20758;VERDADERO;VERDADERO;-13;;;
136241;136274;0;20759;VERDADERO;VERDADERO;-33;;;
136241;136274;0;20760;VERDADERO;VERDADERO;-33;;;
136241;136274;0;20761;VERDADERO;VERDADERO;-33;;;
136241;136294;0;20762;VERDADERO;FALSO;-53;;;
136280;136294;0;20763;VERDADERO;VERDADERO;-14;;;
136280;136314;0;20764;VERDADERO;VERDADERO;-34;;;
136280;136314;0;20765;VERDADERO;VERDADERO;-34;;;
136280;136314;0;20766;VERDADERO;VERDADERO;-34;;;
136280;136314;0;20767;VERDADERO;VERDADERO;-34;;;
136309;136314;0;20768;VERDADERO;VERDADERO;-5;;;
136309;136314;0;20769;VERDADERO;VERDADERO;-5;;;
136309;136334;1;20770;VERDADERO;VERDADERO;-25;;;
136309;136334;0;20771;VERDADERO;VERDADERO;-25;;;
136309;136354;0;20772;VERDADERO;VERDADERO;-45;;;
136341;136354;0;20773;VERDADERO;VERDADERO;-13;;;
136341;136354;0;20774;VERDADERO;VERDADERO;-13;;;
136341;136354;0;20775;VERDADERO;VERDADERO;-13;;;
136341;136354;0;20776;VERDADERO;VERDADERO;-13;;;
136341;136354;0;20777;VERDADERO;VERDADERO;-13;;;
136373;136374;1;20778;VERDADERO;VERDADERO;-1;;;
136373;136374;0;20779;VERDADERO;VERDADERO;-1;;;
136373;136394;0;20780;VERDADERO;VERDADERO;-21;;;
136373;136394;0;20781;VERDADERO;VERDADERO;-21;;;
136373;136394;0;20782;VERDADERO;VERDADERO;-21;;;
136406;136414;0;20783;VERDADERO;VERDADERO;-8;;;
136406;136414;0;20784;VERDADERO;VERDADERO;-8;;;
136406;136414;0;20785;VERDADERO;VERDADERO;-8;;;
136406;136434;1;20786;VERDADERO;VERDADERO;-28;;;
136406;136434;0;20787;VERDADERO;VERDADERO;-28;;;
136406;136454;0;20788;VERDADERO;VERDADERO;-48;;;
136441;136454;0;20789;VERDADERO;VERDADERO;-13;;;
136441;136454;0;20790;VERDADERO;VERDADERO;-13;;;
136441;136454;0;20791;VERDADERO;VERDADERO;-13;;;
136441;136454;0;20792;VERDADERO;VERDADERO;-13;;;
136441;136454;0;20793;VERDADERO;VERDADERO;-13;;;
136473;136474;0;20794;VERDADERO;VERDADERO;-1;;;
136473;136474;0;20795;VERDADERO;VERDADERO;-1;;;
136473;136494;0;20796;VERDADERO;VERDADERO;-21;;;
136473;136494;0;20797;VERDADERO;VERDADERO;-21;;;
136504;136514;0;20798;VERDADERO;VERDADERO;-10;;;
136504;136514;0;20799;VERDADERO;VERDADERO;-10;;;
136504;136514;0;20800;VERDADERO;VERDADERO;-10;;;
136504;136534;0;20801;VERDADERO;VERDADERO;-30;;;
136504;136534;0;20802;VERDADERO;VERDADERO;-30;;;
136504;136554;0;20803;VERDADERO;FALSO;-50;;;
136538;136554;0;20804;VERDADERO;VERDADERO;-16;;;
136538;136554;0;20805;VERDADERO;VERDADERO;-16;;;
136538;136574;0;20806;VERDADERO;VERDADERO;-36;;;
136538;136574;0;20807;VERDADERO;VERDADERO;-36;;;
136568;136574;0;20808;VERDADERO;VERDADERO;-6;;;
136568;136594;0;20809;VERDADERO;VERDADERO;-26;;;
136568;136594;0;20810;VERDADERO;VERDADERO;-26;;;
136568;136594;0;20811;VERDADERO;VERDADERO;-26;;;
136568;136614;0;20812;VERDADERO;VERDADERO;-46;;;
136568;136614;0;20813;VERDADERO;VERDADERO;-46;;;
136604;136614;0;20814;VERDADERO;VERDADERO;-10;;;
136604;136614;0;20815;VERDADERO;VERDADERO;-10;;;
136604;136614;0;20816;VERDADERO;VERDADERO;-10;;;
136604;136614;0;20817;VERDADERO;VERDADERO;-10;;;
136604;136614;0;20818;VERDADERO;VERDADERO;-10;;;
136637;136634;1;20819;VERDADERO;VERDADERO;3;;;
136637;136634;0;20820;VERDADERO;VERDADERO;3;;;
136637;136654;0;20821;VERDADERO;VERDADERO;-17;;;
136637;136654;0;20822;VERDADERO;VERDADERO;-17;;;
136637;136654;0;20823;VERDADERO;VERDADERO;-17;;;
136637;136674;0;20824;VERDADERO;VERDADERO;-37;;;
136673;136674;0;20825;VERDADERO;VERDADERO;-1;;;
136673;136694;0;20826;VERDADERO;VERDADERO;-21;;;
136673;136694;0;20827;VERDADERO;VERDADERO;-21;;;
136673;136694;0;20828;VERDADERO;VERDADERO;-21;;;
136673;136714;1;20829;VERDADERO;VERDADERO;-41;;;
136706;136714;0;20830;VERDADERO;VERDADERO;-8;;;
136706;136714;0;20831;VERDADERO;VERDADERO;-8;;;
136706;136714;0;20832;VERDADERO;VERDADERO;-8;;;
136706;136734;1;20833;VERDADERO;VERDADERO;-28;;;
136706;136734;0;20834;VERDADERO;VERDADERO;-28;;;
136740;136734;0;20835;VERDADERO;VERDADERO;6;;;
136740;136755;0;20836;VERDADERO;VERDADERO;-15;;;
136740;136755;0;20837;VERDADERO;VERDADERO;-15;;;
136740;136775;0;20838;VERDADERO;VERDADERO;-35;;;
136740;136775;0;20839;VERDADERO;VERDADERO;-35;;;
136740;136775;0;20840;VERDADERO;VERDADERO;-35;;;
136772;136775;0;20841;VERDADERO;VERDADERO;-3;;;
136772;136775;0;20842;VERDADERO;VERDADERO;-3;;;
136772;136775;0;20843;VERDADERO;VERDADERO;-3;;;
136772;136775;0;20844;VERDADERO;VERDADERO;-3;;;
136772;136795;0;20845;VERDADERO;VERDADERO;-23;;;
136808;136795;0;20846;VERDADERO;VERDADERO;13;;;
136808;136815;0;20847;VERDADERO;VERDADERO;-7;;;
136808;136815;0;20848;VERDADERO;VERDADERO;-7;;;
136808;136815;0;20849;VERDADERO;VERDADERO;-7;;;
136808;136815;0;20850;VERDADERO;VERDADERO;-7;;;
136808;136815;0;20851;VERDADERO;VERDADERO;-7;;;
136841;136835;1;20852;VERDADERO;VERDADERO;6;;;
136841;136835;0;20853;VERDADERO;VERDADERO;6;;;
136841;136835;0;20854;VERDADERO;VERDADERO;6;;;
136841;136855;0;20855;VERDADERO;VERDADERO;-14;;;
136841;136855;0;20856;VERDADERO;VERDADERO;-14;;;
136877;136875;0;20857;VERDADERO;VERDADERO;2;;;
136877;136875;0;20858;VERDADERO;VERDADERO;2;;;
136877;136895;1;20859;VERDADERO;VERDADERO;-18;;;
136877;136895;0;20860;VERDADERO;VERDADERO;-18;;;
136877;136895;0;20861;VERDADERO;VERDADERO;-18;;;
136909;136915;0;20862;VERDADERO;VERDADERO;-6;;;
136909;136915;0;20863;VERDADERO;VERDADERO;-6;;;
136909;136935;0;20864;VERDADERO;VERDADERO;-26;;;
136909;136935;0;20865;VERDADERO;VERDADERO;-26;;;
136909;136935;0;20866;VERDADERO;VERDADERO;-26;;;
136941;136955;0;20867;VERDADERO;VERDADERO;-14;;;
136941;136955;0;20868;VERDADERO;VERDADERO;-14;;;
136941;136975;0;20869;VERDADERO;VERDADERO;-34;;;
136941;136975;0;20870;VERDADERO;VERDADERO;-34;;;
136941;136975;0;20871;VERDADERO;VERDADERO;-34;;;
136941;136975;0;20872;VERDADERO;VERDADERO;-34;;;
136976;136975;0;20873;VERDADERO;VERDADERO;1;;;
136976;136975;0;20874;VERDADERO;VERDADERO;1;;;
136976;136975;0;20875;VERDADERO;VERDADERO;1;;;
136976;136975;0;20876;VERDADERO;VERDADERO;1;;;
137005;136995;0;20877;VERDADERO;VERDADERO;10;;;
137005;136995;0;20878;VERDADERO;VERDADERO;10;;;
137005;136995;0;20879;VERDADERO;VERDADERO;10;;;
137005;137015;0;20880;VERDADERO;VERDADERO;-10;;;
137005;137015;0;20881;VERDADERO;VERDADERO;-10;;;
137005;137035;0;20882;VERDADERO;VERDADERO;-30;;;
137041;137035;0;20883;VERDADERO;VERDADERO;6;;;
137041;137055;0;20884;VERDADERO;VERDADERO;-14;;;
137041;137055;0;20885;VERDADERO;VERDADERO;-14;;;
137041;137055;0;20886;VERDADERO;VERDADERO;-14;;;
137041;137075;0;20887;VERDADERO;VERDADERO;-34;;;
137072;137075;0;20888;VERDADERO;VERDADERO;-3;;;
137072;137095;0;20889;VERDADERO;VERDADERO;-23;;;
137072;137095;0;20890;VERDADERO;VERDADERO;-23;;;
137072;137095;0;20891;VERDADERO;VERDADERO;-23;;;
137072;137115;1;20892;VERDADERO;VERDADERO;-43;;;
137109;137115;0;20893;VERDADERO;VERDADERO;-6;;;
137109;137135;1;20894;VERDADERO;VERDADERO;-26;;;
137109;137135;0;20895;VERDADERO;VERDADERO;-26;;;
137109;137135;0;20896;VERDADERO;VERDADERO;-26;;;
137109;137135;0;20897;VERDADERO;VERDADERO;-26;;;
137136;137135;0;20898;VERDADERO;VERDADERO;1;;;
137136;137135;0;20899;VERDADERO;VERDADERO;1;;;
137136;137155;0;20900;VERDADERO;VERDADERO;-19;;;
137136;137155;0;20901;VERDADERO;VERDADERO;-19;;;
137136;137175;0;20902;VERDADERO;VERDADERO;-39;;;
137169;137175;0;20903;VERDADERO;VERDADERO;-6;;;
137169;137195;0;20904;VERDADERO;VERDADERO;-26;;;
137169;137195;0;20905;VERDADERO;VERDADERO;-26;;;
137169;137195;0;20906;VERDADERO;VERDADERO;-26;;;
137169;137215;1;20907;VERDADERO;VERDADERO;-46;;;
137201;137215;0;20908;VERDADERO;VERDADERO;-14;;;
137201;137235;0;20909;VERDADERO;VERDADERO;-34;;;
137201;137235;0;20910;VERDADERO;VERDADERO;-34;;;
137201;137235;0;20911;VERDADERO;VERDADERO;-34;;;
137201;137235;0;20912;VERDADERO;VERDADERO;-34;;;
137232;137235;0;20913;VERDADERO;VERDADERO;-3;;;
137232;137235;0;20914;VERDADERO;VERDADERO;-3;;;
137232;137255;0;20915;VERDADERO;VERDADERO;-23;;;
137232;137255;0;20916;VERDADERO;VERDADERO;-23;;;
137232;137275;0;20917;VERDADERO;VERDADERO;-43;;;
137269;137275;0;20918;VERDADERO;VERDADERO;-6;;;
137269;137275;0;20919;VERDADERO;VERDADERO;-6;;;
137269;137295;1;20920;VERDADERO;VERDADERO;-26;;;
137269;137295;0;20921;VERDADERO;VERDADERO;-26;;;
137269;137295;0;20922;VERDADERO;VERDADERO;-26;;;
137269;137295;0;20923;VERDADERO;VERDADERO;-26;;;
137301;137295;0;20924;VERDADERO;VERDADERO;6;;;
137301;137295;0;20925;VERDADERO;VERDADERO;6;;;
137301;137295;0;20926;VERDADERO;VERDADERO;6;;;
137301;137315;0;20927;VERDADERO;VERDADERO;-14;;;
137301;137315;0;20928;VERDADERO;VERDADERO;-14;;;
137334;137315;0;20929;VERDADERO;VERDADERO;19;;;
137334;137335;0;20930;VERDADERO;VERDADERO;-1;;;
137334;137335;0;20931;VERDADERO;VERDADERO;-1;;;
137334;137355;0;20932;VERDADERO;VERDADERO;-21;;;
137334;137355;0;20933;VERDADERO;VERDADERO;-21;;;
137369;137355;0;20934;VERDADERO;VERDADERO;14;;;
137369;137355;0;20935;VERDADERO;VERDADERO;14;;;
137369;137375;0;20936;VERDADERO;VERDADERO;-6;;;
137369;137375;0;20937;VERDADERO;VERDADERO;-6;;;
137369;137395;0;20938;VERDADERO;VERDADERO;-26;;;
137401;137395;0;20939;VERDADERO;VERDADERO;6;;;
137401;137395;0;20940;VERDADERO;VERDADERO;6;;;
137401;137415;0;20941;VERDADERO;VERDADERO;-14;;;
137401;137415;0;20942;VERDADERO;VERDADERO;-14;;;
137401;137435;0;20943;VERDADERO;VERDADERO;-34;;;
137401;137435;0;20944;VERDADERO;VERDADERO;-34;;;
137437;137455;0;20945;VERDADERO;VERDADERO;-18;;;
137437;137455;0;20946;VERDADERO;VERDADERO;-18;;;
137437;137455;0;20947;VERDADERO;VERDADERO;-18;;;
137437;137475;0;20948;VERDADERO;VERDADERO;-38;;;
137437;137475;0;20949;VERDADERO;VERDADERO;-38;;;
137469;137495;0;20950;VERDADERO;VERDADERO;-26;;;
137469;137495;0;20951;VERDADERO;VERDADERO;-26;;;
137469;137495;0;20952;VERDADERO;VERDADERO;-26;;;
137469;137515;1;20953;VERDADERO;VERDADERO;-46;;;
137469;137515;0;20954;VERDADERO;VERDADERO;-46;;;
137469;137515;0;20955;VERDADERO;VERDADERO;-46;;;
137505;137515;0;20956;VERDADERO;VERDADERO;-10;;;
137505;137535;0;20957;VERDADERO;VERDADERO;-30;;;
137505;137535;0;20958;VERDADERO;VERDADERO;-30;;;
137505;137555;1;20959;VERDADERO;FALSO;-50;;;
137538;137555;0;20960;VERDADERO;VERDADERO;-17;;;
137538;137555;0;20961;VERDADERO;VERDADERO;-17;;;
137538;137555;0;20962;VERDADERO;VERDADERO;-17;;;
137538;137555;0;20963;VERDADERO;VERDADERO;-17;;;
137538;137575;0;20964;VERDADERO;VERDADERO;-37;;;
137569;137575;0;20965;VERDADERO;VERDADERO;-6;;;
137569;137575;0;20966;VERDADERO;VERDADERO;-6;;;
137569;137595;0;20967;VERDADERO;VERDADERO;-26;;;
137569;137595;0;20968;VERDADERO;VERDADERO;-26;;;
137569;137615;1;20969;VERDADERO;VERDADERO;-46;;;
137569;137615;0;20970;VERDADERO;VERDADERO;-46;;;
137605;137615;0;20971;VERDADERO;VERDADERO;-10;;;
137605;137635;1;20972;VERDADERO;VERDADERO;-30;;;
137605;137635;0;20973;VERDADERO;VERDADERO;-30;;;
137605;137655;0;20974;VERDADERO;FALSO;-50;;;
137605;137655;0;20975;VERDADERO;FALSO;-50;;;
137637;137655;0;20976;VERDADERO;VERDADERO;-18;;;
137637;137655;0;20977;VERDADERO;VERDADERO;-18;;;
137637;137655;0;20978;VERDADERO;VERDADERO;-18;;;
137637;137655;0;20979;VERDADERO;VERDADERO;-18;;;
137637;137675;0;20980;VERDADERO;VERDADERO;-38;;;
137637;137675;0;20981;VERDADERO;VERDADERO;-38;;;
137672;137695;0;20982;VERDADERO;VERDADERO;-23;;;
137672;137695;0;20983;VERDADERO;VERDADERO;-23;;;
137672;137695;0;20984;VERDADERO;VERDADERO;-23;;;
137672;137695;0;20985;VERDADERO;VERDADERO;-23;;;
137672;137695;0;20986;VERDADERO;VERDADERO;-23;;;
137672;137715;0;20987;VERDADERO;VERDADERO;-43;;;
137709;137715;0;20988;VERDADERO;VERDADERO;-6;;;
137709;137715;0;20989;VERDADERO;VERDADERO;-6;;;
137709;137735;0;20990;VERDADERO;VERDADERO;-26;;;
137709;137735;0;20991;VERDADERO;VERDADERO;-26;;;
137709;137755;0;20992;VERDADERO;VERDADERO;-46;;;
137741;137755;0;20993;VERDADERO;VERDADERO;-14;;;
137741;137755;0;20994;VERDADERO;VERDADERO;-14;;;
137741;137775;0;20995;VERDADERO;VERDADERO;-34;;;
137741;137775;0;20996;VERDADERO;VERDADERO;-34;;;
137741;137775;0;20997;VERDADERO;VERDADERO;-34;;;
137773;137795;0;20998;VERDADERO;VERDADERO;-22;;;
137773;137795;0;20999;VERDADERO;VERDADERO;-22;;;
137773;137795;0;21000;VERDADERO;VERDADERO;-22;;;
137773;137795;0;21001;VERDADERO;VERDADERO;-22;;;
137773;137795;0;21002;VERDADERO;VERDADERO;-22;;;
137804;137815;0;21003;VERDADERO;VERDADERO;-11;;;
137804;137815;0;21004;VERDADERO;VERDADERO;-11;;;
137804;137815;0;21005;VERDADERO;VERDADERO;-11;;;
137804;137835;0;21006;VERDADERO;VERDADERO;-31;;;
137804;137835;0;21007;VERDADERO;VERDADERO;-31;;;
137837;137855;1;21008;VERDADERO;VERDADERO;-18;;;
137837;137855;0;21009;VERDADERO;VERDADERO;-18;;;
137837;137855;0;21010;VERDADERO;VERDADERO;-18;;;
137837;137875;0;21011;VERDADERO;VERDADERO;-38;;;
137837;137875;0;21012;VERDADERO;VERDADERO;-38;;;
137837;137895;0;21013;VERDADERO;FALSO;-58;;;
137873;137895;0;21014;VERDADERO;VERDADERO;-22;;;
137873;137895;0;21015;VERDADERO;VERDADERO;-22;;;
137873;137895;0;21016;VERDADERO;VERDADERO;-22;;;
137873;137895;0;21017;VERDADERO;VERDADERO;-22;;;
137873;137895;0;21018;VERDADERO;VERDADERO;-22;;;
137905;137915;0;21019;VERDADERO;VERDADERO;-10;;;
137905;137915;0;21020;VERDADERO;VERDADERO;-10;;;
137905;137915;0;21021;VERDADERO;VERDADERO;-10;;;
137905;137935;0;21022;VERDADERO;VERDADERO;-30;;;
137905;137935;0;21023;VERDADERO;VERDADERO;-30;;;
137936;137935;0;21024;VERDADERO;VERDADERO;1;;;
137936;137935;0;21025;VERDADERO;VERDADERO;1;;;
137936;137955;0;21026;VERDADERO;VERDADERO;-19;;;
137936;137955;0;21027;VERDADERO;VERDADERO;-19;;;
137936;137955;0;21028;VERDADERO;VERDADERO;-19;;;
137936;137975;1;21029;VERDADERO;VERDADERO;-39;;;
137973;137975;0;21030;VERDADERO;VERDADERO;-2;;;
137973;137995;0;21031;VERDADERO;VERDADERO;-22;;;
137973;137995;0;21032;VERDADERO;VERDADERO;-22;;;
137973;137995;0;21033;VERDADERO;VERDADERO;-22;;;
137973;138015;0;21034;VERDADERO;VERDADERO;-42;;;
138004;138015;0;21035;VERDADERO;VERDADERO;-11;;;
138004;138035;0;21036;VERDADERO;VERDADERO;-31;;;
138004;138035;0;21037;VERDADERO;VERDADERO;-31;;;
138004;138035;0;21038;VERDADERO;VERDADERO;-31;;;
138004;138035;0;21039;VERDADERO;VERDADERO;-31;;;
138037;138035;0;21040;VERDADERO;VERDADERO;2;;;
138037;138055;0;21041;VERDADERO;VERDADERO;-18;;;
138037;138055;0;21042;VERDADERO;VERDADERO;-18;;;
138037;138055;0;21043;VERDADERO;VERDADERO;-18;;;
138037;138075;0;21044;VERDADERO;VERDADERO;-38;;;
138069;138075;0;21045;VERDADERO;VERDADERO;-6;;;
138069;138095;0;21046;VERDADERO;VERDADERO;-26;;;
138069;138095;0;21047;VERDADERO;VERDADERO;-26;;;
138069;138095;0;21048;VERDADERO;VERDADERO;-26;;;
138069;138095;0;21049;VERDADERO;VERDADERO;-26;;;
138101;138095;0;21050;VERDADERO;VERDADERO;6;;;
138101;138095;0;21051;VERDADERO;VERDADERO;6;;;
138101;138095;0;21052;VERDADERO;VERDADERO;6;;;
138101;138095;0;21053;VERDADERO;VERDADERO;6;;;
138101;138095;0;21054;VERDADERO;VERDADERO;6;;;
138101;138095;0;21055;VERDADERO;VERDADERO;6;;;
138137;138095;0;21056;VERDADERO;VERDADERO;42;;;
138137;138095;0;21057;VERDADERO;VERDADERO;42;;;
138137;138095;0;21058;VERDADERO;VERDADERO;42;;;
138137;138095;0;21059;VERDADERO;VERDADERO;42;;;
138137;138095;0;21060;VERDADERO;VERDADERO;42;;;
138168;138095;0;21061;FALSO;VERDADERO;73;;;
138168;138095;0;21062;FALSO;VERDADERO;73;;;
138168;138115;0;21063;FALSO;VERDADERO;53;;;
138168;138115;0;21064;FALSO;VERDADERO;53;;;
138168;138135;0;21065;VERDADERO;VERDADERO;33;;;
138168;138135;0;21066;VERDADERO;VERDADERO;33;;;
138205;138135;0;21067;FALSO;VERDADERO;70;;;
138205;138135;0;21068;FALSO;VERDADERO;70;;;
138205;138135;0;21069;FALSO;VERDADERO;70;;;
138205;138155;1;21070;FALSO;VERDADERO;50;;;
138205;138155;0;21071;FALSO;VERDADERO;50;;;
138236;138175;0;21072;FALSO;VERDADERO;61;;;
138236;138175;0;21073;FALSO;VERDADERO;61;;;
138236;138175;0;21074;FALSO;VERDADERO;61;;;
138236;138195;1;21075;VERDADERO;VERDADERO;41;;;
138236;138195;0;21076;VERDADERO;VERDADERO;41;;;
138236;138215;0;21077;VERDADERO;VERDADERO;21;;;
138272;138215;0;21078;FALSO;VERDADERO;57;;;
138272;138215;0;21079;FALSO;VERDADERO;57;;;
138272;138235;0;21080;VERDADERO;VERDADERO;37;;;
138272;138235;0;21081;VERDADERO;VERDADERO;37;;;
138272;138255;0;21082;VERDADERO;VERDADERO;17;;;
138304;138255;0;21083;VERDADERO;VERDADERO;49;;;
138304;138255;0;21084;VERDADERO;VERDADERO;49;;;
138304;138275;1;21085;VERDADERO;VERDADERO;29;;;
138304;138275;0;21086;VERDADERO;VERDADERO;29;;;
138304;138295;0;21087;VERDADERO;VERDADERO;9;;;
138341;138295;0;21088;VERDADERO;VERDADERO;46;;;
138341;138295;0;21089;VERDADERO;VERDADERO;46;;;
138341;138315;0;21090;VERDADERO;VERDADERO;26;;;
138341;138315;0;21091;VERDADERO;VERDADERO;26;;;
138341;138335;0;21092;VERDADERO;VERDADERO;6;;;
138372;138335;0;21093;VERDADERO;VERDADERO;37;;;
138372;138335;0;21094;VERDADERO;VERDADERO;37;;;
138372;138355;0;21095;VERDADERO;VERDADERO;17;;;
138372;138355;0;21096;VERDADERO;VERDADERO;17;;;
138372;138375;0;21097;VERDADERO;VERDADERO;-3;;;
138372;138375;0;21098;VERDADERO;VERDADERO;-3;;;
138409;138375;0;21099;VERDADERO;VERDADERO;34;;;
138409;138395;0;21100;VERDADERO;VERDADERO;14;;;
138409;138395;0;21101;VERDADERO;VERDADERO;14;;;
138409;138415;1;21102;VERDADERO;VERDADERO;-6;;;
138409;138415;0;21103;VERDADERO;VERDADERO;-6;;;
138441;138415;0;21104;VERDADERO;VERDADERO;26;;;
138441;138435;0;21105;VERDADERO;VERDADERO;6;;;
138441;138435;0;21106;VERDADERO;VERDADERO;6;;;
138441;138455;0;21107;VERDADERO;VERDADERO;-14;;;
138441;138455;0;21108;VERDADERO;VERDADERO;-14;;;
138473;138475;0;21109;VERDADERO;VERDADERO;-2;;;
138473;138475;0;21110;VERDADERO;VERDADERO;-2;;;
138473;138475;0;21111;VERDADERO;VERDADERO;-2;;;
138473;138495;0;21112;VERDADERO;VERDADERO;-22;;;
138473;138495;0;21113;VERDADERO;VERDADERO;-22;;;
138504;138515;0;21114;VERDADERO;VERDADERO;-11;;;
138504;138515;0;21115;VERDADERO;VERDADERO;-11;;;
138504;138515;0;21116;VERDADERO;VERDADERO;-11;;;
138504;138535;0;21117;VERDADERO;VERDADERO;-31;;;
138504;138535;0;21118;VERDADERO;VERDADERO;-31;;;
138536;138555;0;21119;VERDADERO;VERDADERO;-19;;;
138536;138555;0;21120;VERDADERO;VERDADERO;-19;;;
138536;138555;0;21121;VERDADERO;VERDADERO;-19;;;
138536;138555;0;21122;VERDADERO;VERDADERO;-19;;;
138536;138575;0;21123;VERDADERO;VERDADERO;-39;;;
138536;138575;0;21124;VERDADERO;VERDADERO;-39;;;
138573;138595;0;21125;VERDADERO;VERDADERO;-22;;;
138573;138595;0;21126;VERDADERO;VERDADERO;-22;;;
138573;138595;0;21127;VERDADERO;VERDADERO;-22;;;
138573;138595;0;21128;VERDADERO;VERDADERO;-22;;;
138573;138595;0;21129;VERDADERO;VERDADERO;-22;;;
138604;138595;0;21130;VERDADERO;VERDADERO;9;;;
138604;138615;0;21131;VERDADERO;VERDADERO;-11;;;
138604;138615;0;21132;VERDADERO;VERDADERO;-11;;;
138604;138635;1;21133;VERDADERO;VERDADERO;-31;;;
138604;138635;0;21134;VERDADERO;VERDADERO;-31;;;
138637;138635;0;21135;VERDADERO;VERDADERO;2;;;
138637;138655;0;21136;VERDADERO;VERDADERO;-18;;;
138637;138655;0;21137;VERDADERO;VERDADERO;-18;;;
138673;138675;1;21138;VERDADERO;VERDADERO;-2;;;
138704;138695;0;21139;VERDADERO;VERDADERO;9;;;
138704;138715;0;21140;VERDADERO;VERDADERO;-11;;;
138704;138715;0;21141;VERDADERO;VERDADERO;-11;;;
138704;138735;0;21142;VERDADERO;VERDADERO;-31;;;
138704;138735;0;21143;VERDADERO;VERDADERO;-31;;;
138737;138735;0;21144;VERDADERO;VERDADERO;2;;;
138737;138755;0;21145;VERDADERO;VERDADERO;-18;;;
138737;138755;0;21146;VERDADERO;VERDADERO;-18;;;
138737;138755;0;21147;VERDADERO;VERDADERO;-18;;;
138737;138775;0;21148;VERDADERO;VERDADERO;-38;;;
138768;138775;0;21149;VERDADERO;VERDADERO;-7;;;
138768;138795;0;21150;VERDADERO;VERDADERO;-27;;;
138768;138795;0;21151;VERDADERO;VERDADERO;-27;;;
138768;138795;0;21152;VERDADERO;VERDADERO;-27;;;
138768;138795;0;21153;VERDADERO;VERDADERO;-27;;;
138768;138795;0;21154;VERDADERO;VERDADERO;-27;;;
138801;138795;0;21155;VERDADERO;VERDADERO;6;;;
138801;138815;0;21156;VERDADERO;VERDADERO;-14;;;
138801;138815;0;21157;VERDADERO;VERDADERO;-14;;;
138801;138835;0;21158;VERDADERO;VERDADERO;-34;;;
138801;138835;0;21159;VERDADERO;VERDADERO;-34;;;
138837;138835;0;21160;VERDADERO;VERDADERO;2;;;
138837;138855;0;21161;VERDADERO;VERDADERO;-18;;;
138837;138855;0;21162;VERDADERO;VERDADERO;-18;;;
138837;138855;0;21163;VERDADERO;VERDADERO;-18;;;
138837;138875;0;21164;VERDADERO;VERDADERO;-38;;;
138868;138875;0;21165;VERDADERO;VERDADERO;-7;;;
138868;138875;0;21166;VERDADERO;VERDADERO;-7;;;
138868;138895;0;21167;VERDADERO;VERDADERO;-27;;;
138868;138895;0;21168;VERDADERO;VERDADERO;-27;;;
138868;138895;0;21169;VERDADERO;VERDADERO;-27;;;
138901;138895;0;21170;VERDADERO;VERDADERO;6;;;
138901;138915;0;21171;VERDADERO;VERDADERO;-14;;;
138901;138915;0;21172;VERDADERO;VERDADERO;-14;;;
138901;138935;0;21173;VERDADERO;VERDADERO;-34;;;
138901;138935;0;21174;VERDADERO;VERDADERO;-34;;;
138933;138935;0;21175;VERDADERO;VERDADERO;-2;;;
138933;138955;0;21176;VERDADERO;VERDADERO;-22;;;
138933;138955;0;21177;VERDADERO;VERDADERO;-22;;;
138933;138975;0;21178;VERDADERO;VERDADERO;-42;;;
138933;138975;0;21179;VERDADERO;VERDADERO;-42;;;
138965;138995;0;21180;VERDADERO;VERDADERO;-30;;;
138965;138995;0;21181;VERDADERO;VERDADERO;-30;;;
138965;138995;0;21182;VERDADERO;VERDADERO;-30;;;
138965;138995;0;21183;VERDADERO;VERDADERO;-30;;;
138965;138995;0;21184;VERDADERO;VERDADERO;-30;;;
138965;139015;0;21185;VERDADERO;FALSO;-50;;;
139000;139015;0;21186;VERDADERO;VERDADERO;-15;;;
139000;139035;0;21187;VERDADERO;VERDADERO;-35;;;
139000;139035;0;21188;VERDADERO;VERDADERO;-35;;;
139000;139035;0;21189;VERDADERO;VERDADERO;-35;;;
139000;139035;0;21190;VERDADERO;VERDADERO;-35;;;
139032;139035;0;21191;VERDADERO;VERDADERO;-3;;;
139032;139055;0;21192;VERDADERO;VERDADERO;-23;;;
139032;139055;0;21193;VERDADERO;VERDADERO;-23;;;
139032;139055;0;21194;VERDADERO;VERDADERO;-23;;;
139032;139075;0;21195;VERDADERO;VERDADERO;-43;;;
139032;139075;0;21196;VERDADERO;VERDADERO;-43;;;
139068;139075;0;21197;VERDADERO;VERDADERO;-7;;;
139068;139075;0;21198;VERDADERO;VERDADERO;-7;;;
139068;139075;0;21199;VERDADERO;VERDADERO;-7;;;
139068;139095;0;21200;VERDADERO;VERDADERO;-27;;;
139068;139095;0;21201;VERDADERO;VERDADERO;-27;;;
139101;139116;0;21202;VERDADERO;VERDADERO;-15;;;
139101;139116;0;21203;VERDADERO;VERDADERO;-15;;;
139101;139116;0;21204;VERDADERO;VERDADERO;-15;;;
139101;139136;0;21205;VERDADERO;VERDADERO;-35;;;
139101;139136;0;21206;VERDADERO;VERDADERO;-35;;;
139101;139136;0;21207;VERDADERO;VERDADERO;-35;;;
139101;139156;0;21208;VERDADERO;FALSO;-55;;;
139143;139156;0;21209;VERDADERO;VERDADERO;-13;;;
139143;139176;0;21210;VERDADERO;VERDADERO;-33;;;
139143;139176;0;21211;VERDADERO;VERDADERO;-33;;;
139170;139176;0;21212;VERDADERO;VERDADERO;-6;;;
139170;139176;0;21213;VERDADERO;VERDADERO;-6;;;
139170;139176;0;21214;VERDADERO;VERDADERO;-6;;;
139170;139196;1;21215;VERDADERO;VERDADERO;-26;;;
139170;139196;0;21216;VERDADERO;VERDADERO;-26;;;
139200;139196;0;21217;VERDADERO;VERDADERO;4;;;
139200;139216;0;21218;VERDADERO;VERDADERO;-16;;;
139200;139216;0;21219;VERDADERO;VERDADERO;-16;;;
139200;139216;0;21220;VERDADERO;VERDADERO;-16;;;
139200;139236;0;21221;VERDADERO;VERDADERO;-36;;;
139200;139236;0;21222;VERDADERO;VERDADERO;-36;;;
139236;139256;0;21223;VERDADERO;VERDADERO;-20;;;
139236;139256;0;21224;VERDADERO;VERDADERO;-20;;;
139236;139256;0;21225;VERDADERO;VERDADERO;-20;;;
139236;139276;0;21226;VERDADERO;VERDADERO;-40;;;
139236;139276;0;21227;VERDADERO;VERDADERO;-40;;;
139236;139276;0;21228;VERDADERO;VERDADERO;-40;;;
139272;139276;0;21229;VERDADERO;VERDADERO;-4;;;
139272;139276;0;21230;VERDADERO;VERDADERO;-4;;;
139272;139296;0;21231;VERDADERO;VERDADERO;-24;;;
139272;139296;0;21232;VERDADERO;VERDADERO;-24;;;
139272;139296;0;21233;VERDADERO;VERDADERO;-24;;;
139304;139316;0;21234;VERDADERO;VERDADERO;-12;;;
139304;139316;0;21235;VERDADERO;VERDADERO;-12;;;
139304;139336;0;21236;VERDADERO;VERDADERO;-32;;;
139304;139336;0;21237;VERDADERO;VERDADERO;-32;;;
139304;139336;0;21238;VERDADERO;VERDADERO;-32;;;
139337;139356;1;21239;VERDADERO;VERDADERO;-19;;;
139337;139356;0;21240;VERDADERO;VERDADERO;-19;;;
139337;139356;0;21241;VERDADERO;VERDADERO;-19;;;
139337;139376;0;21242;VERDADERO;VERDADERO;-39;;;
139337;139376;0;21243;VERDADERO;VERDADERO;-39;;;
139337;139376;0;21244;VERDADERO;VERDADERO;-39;;;
139373;139376;0;21245;VERDADERO;VERDADERO;-3;;;
139373;139396;0;21246;VERDADERO;VERDADERO;-23;;;
139373;139396;0;21247;VERDADERO;VERDADERO;-23;;;
139373;139396;0;21248;VERDADERO;VERDADERO;-23;;;
139373;139416;0;21249;VERDADERO;VERDADERO;-43;;;
139373;139416;0;21250;VERDADERO;VERDADERO;-43;;;
139409;139416;0;21251;VERDADERO;VERDADERO;-7;;;
139409;139436;0;21252;VERDADERO;VERDADERO;-27;;;
139409;139436;0;21253;VERDADERO;VERDADERO;-27;;;
139409;139456;0;21254;VERDADERO;VERDADERO;-47;;;
139441;139456;0;21255;VERDADERO;VERDADERO;-15;;;
139441;139456;0;21256;VERDADERO;VERDADERO;-15;;;
139441;139476;0;21257;VERDADERO;VERDADERO;-35;;;
139441;139476;0;21258;VERDADERO;VERDADERO;-35;;;
139441;139476;0;21259;VERDADERO;VERDADERO;-35;;;
139441;139476;0;21260;VERDADERO;VERDADERO;-35;;;
139473;139476;0;21261;VERDADERO;VERDADERO;-3;;;
139473;139496;0;21262;VERDADERO;VERDADERO;-23;;;
139473;139496;0;21263;VERDADERO;VERDADERO;-23;;;
139473;139516;0;21264;VERDADERO;VERDADERO;-43;;;
139473;139516;0;21265;VERDADERO;VERDADERO;-43;;;
139508;139516;0;21266;VERDADERO;VERDADERO;-8;;;
139508;139516;0;21267;VERDADERO;VERDADERO;-8;;;
139508;139516;0;21268;VERDADERO;VERDADERO;-8;;;
139508;139536;1;21269;VERDADERO;VERDADERO;-28;;;
139508;139536;0;21270;VERDADERO;VERDADERO;-28;;;
139508;139536;0;21271;VERDADERO;VERDADERO;-28;;;
139541;139556;1;21272;VERDADERO;VERDADERO;-15;;;
139541;139556;0;21273;VERDADERO;VERDADERO;-15;;;
139541;139576;0;21274;VERDADERO;VERDADERO;-35;;;
139541;139576;0;21275;VERDADERO;VERDADERO;-35;;;
139541;139576;0;21276;VERDADERO;VERDADERO;-35;;;
139578;139576;0;21277;VERDADERO;VERDADERO;2;;;
139578;139596;0;21278;VERDADERO;VERDADERO;-18;;;
139578;139596;0;21279;VERDADERO;VERDADERO;-18;;;
139578;139616;0;21280;VERDADERO;VERDADERO;-38;;;
139578;139616;0;21281;VERDADERO;VERDADERO;-38;;;
139609;139616;0;21282;VERDADERO;VERDADERO;-7;;;
139609;139616;0;21283;VERDADERO;VERDADERO;-7;;;
139609;139616;0;21284;VERDADERO;VERDADERO;-7;;;
139609;139616;0;21285;VERDADERO;VERDADERO;-7;;;
139609;139636;0;21286;VERDADERO;VERDADERO;-27;;;
139641;139636;0;21287;VERDADERO;VERDADERO;5;;;
139641;139656;0;21288;VERDADERO;VERDADERO;-15;;;
139641;139656;0;21289;VERDADERO;VERDADERO;-15;;;
139641;139656;0;21290;VERDADERO;VERDADERO;-15;;;
139641;139676;0;21291;VERDADERO;VERDADERO;-35;;;
139641;139676;0;21292;VERDADERO;VERDADERO;-35;;;
139677;139676;0;21293;VERDADERO;VERDADERO;1;;;
139677;139696;1;21294;VERDADERO;VERDADERO;-19;;;
139677;139696;0;21295;VERDADERO;VERDADERO;-19;;;
139677;139696;0;21296;VERDADERO;VERDADERO;-19;;;
139677;139716;0;21297;VERDADERO;VERDADERO;-39;;;
139708;139716;0;21298;VERDADERO;VERDADERO;-8;;;
139708;139716;0;21299;VERDADERO;VERDADERO;-8;;;
139708;139716;0;21300;VERDADERO;VERDADERO;-8;;;
139708;139716;0;21301;VERDADERO;VERDADERO;-8;;;
139708;139716;0;21302;VERDADERO;VERDADERO;-8;;;
139740;139716;0;21303;VERDADERO;VERDADERO;24;;;
139740;139716;0;21304;VERDADERO;VERDADERO;24;;;
139740;139736;0;21305;VERDADERO;VERDADERO;4;;;
139740;139736;0;21306;VERDADERO;VERDADERO;4;;;
139740;139756;0;21307;VERDADERO;VERDADERO;-16;;;
139740;139756;0;21308;VERDADERO;VERDADERO;-16;;;
139777;139756;0;21309;VERDADERO;VERDADERO;21;;;
139777;139776;0;21310;VERDADERO;VERDADERO;1;;;
139777;139776;0;21311;VERDADERO;VERDADERO;1;;;
139777;139796;0;21312;VERDADERO;VERDADERO;-19;;;
139777;139796;0;21313;VERDADERO;VERDADERO;-19;;;
139809;139796;0;21314;VERDADERO;VERDADERO;13;;;
139809;139816;0;21315;VERDADERO;VERDADERO;-7;;;
139809;139816;0;21316;VERDADERO;VERDADERO;-7;;;
139809;139836;1;21317;VERDADERO;VERDADERO;-27;;;
139809;139836;0;21318;VERDADERO;VERDADERO;-27;;;
139841;139836;0;21319;VERDADERO;VERDADERO;5;;;
139841;139856;0;21320;VERDADERO;VERDADERO;-15;;;
139841;139856;0;21321;VERDADERO;VERDADERO;-15;;;
139841;139876;1;21322;VERDADERO;VERDADERO;-35;;;
139841;139876;0;21323;VERDADERO;VERDADERO;-35;;;
139841;139876;0;21324;VERDADERO;VERDADERO;-35;;;
139877;139896;0;21325;VERDADERO;VERDADERO;-19;;;
139877;139896;0;21326;VERDADERO;VERDADERO;-19;;;
139877;139896;0;21327;VERDADERO;VERDADERO;-19;;;
139877;139896;0;21328;VERDADERO;VERDADERO;-19;;;
139877;139896;0;21329;VERDADERO;VERDADERO;-19;;;
139908;139916;1;21330;VERDADERO;VERDADERO;-8;;;
139908;139916;0;21331;VERDADERO;VERDADERO;-8;;;
139908;139936;1;21332;VERDADERO;VERDADERO;-28;;;
139908;139936;0;21333;VERDADERO;VERDADERO;-28;;;
139908;139936;0;21334;VERDADERO;VERDADERO;-28;;;
139941;139936;0;21335;VERDADERO;VERDADERO;5;;;
139941;139936;0;21336;VERDADERO;VERDADERO;5;;;
139941;139956;0;21337;VERDADERO;VERDADERO;-15;;;
139941;139956;0;21338;VERDADERO;VERDADERO;-15;;;
139941;139956;0;21339;VERDADERO;VERDADERO;-15;;;
139972;139976;0;21340;VERDADERO;VERDADERO;-4;;;
139972;139976;0;21341;VERDADERO;VERDADERO;-4;;;
139972;139996;1;21342;VERDADERO;VERDADERO;-24;;;
139972;139996;0;21343;VERDADERO;VERDADERO;-24;;;
139972;139996;0;21344;VERDADERO;VERDADERO;-24;;;
140005;140016;1;21345;VERDADERO;VERDADERO;-11;;;
140005;140016;0;21346;VERDADERO;VERDADERO;-11;;;
140005;140016;0;21347;VERDADERO;VERDADERO;-11;;;
140005;140036;0;21348;VERDADERO;VERDADERO;-31;;;
140005;140036;0;21349;VERDADERO;VERDADERO;-31;;;
140037;140036;0;21350;VERDADERO;VERDADERO;1;;;
140037;140036;0;21351;VERDADERO;VERDADERO;1;;;
140037;140036;0;21352;VERDADERO;VERDADERO;1;;;
140037;140036;0;21353;VERDADERO;VERDADERO;1;;;
140037;140056;0;21354;VERDADERO;VERDADERO;-19;;;
140069;140056;0;21355;VERDADERO;VERDADERO;13;;;
140069;140076;0;21356;VERDADERO;VERDADERO;-7;;;
140069;140076;0;21357;VERDADERO;VERDADERO;-7;;;
140069;140076;0;21358;VERDADERO;VERDADERO;-7;;;
140069;140096;0;21359;VERDADERO;VERDADERO;-27;;;
140069;140096;0;21360;VERDADERO;VERDADERO;-27;;;
140105;140096;0;21361;VERDADERO;VERDADERO;9;;;
140105;140116;0;21362;VERDADERO;VERDADERO;-11;;;
140105;140116;0;21363;VERDADERO;VERDADERO;-11;;;
140105;140136;0;21364;VERDADERO;VERDADERO;-31;;;
140105;140136;0;21365;VERDADERO;VERDADERO;-31;;;
140137;140136;0;21366;VERDADERO;VERDADERO;1;;;
140137;140156;0;21367;VERDADERO;VERDADERO;-19;;;
140137;140156;0;21368;VERDADERO;VERDADERO;-19;;;
140137;140156;0;21369;VERDADERO;VERDADERO;-19;;;
140137;140176;0;21370;VERDADERO;VERDADERO;-39;;;
140169;140176;0;21371;VERDADERO;VERDADERO;-7;;;
140169;140196;1;21372;VERDADERO;VERDADERO;-27;;;
140169;140196;0;21373;VERDADERO;VERDADERO;-27;;;
140169;140196;0;21374;VERDADERO;VERDADERO;-27;;;
140169;140196;0;21375;VERDADERO;VERDADERO;-27;;;
140201;140196;0;21376;VERDADERO;VERDADERO;5;;;
140201;140216;0;21377;VERDADERO;VERDADERO;-15;;;
140201;140216;0;21378;VERDADERO;VERDADERO;-15;;;
140201;140216;0;21379;VERDADERO;VERDADERO;-15;;;
140201;140236;0;21380;VERDADERO;VERDADERO;-35;;;
140232;140236;0;21381;VERDADERO;VERDADERO;-4;;;
140232;140256;0;21382;VERDADERO;VERDADERO;-24;;;
140232;140256;0;21383;VERDADERO;VERDADERO;-24;;;
140232;140256;0;21384;VERDADERO;VERDADERO;-24;;;
140232;140256;0;21385;VERDADERO;VERDADERO;-24;;;
140232;140256;0;21386;VERDADERO;VERDADERO;-24;;;
140268;140276;0;21387;VERDADERO;VERDADERO;-8;;;
140268;140276;0;21388;VERDADERO;VERDADERO;-8;;;
140268;140296;1;21389;VERDADERO;VERDADERO;-28;;;
140268;140296;0;21390;VERDADERO;VERDADERO;-28;;;
140268;140296;0;21391;VERDADERO;VERDADERO;-28;;;
140300;140296;0;21392;VERDADERO;VERDADERO;4;;;
140300;140296;0;21393;VERDADERO;VERDADERO;4;;;
140300;140296;0;21394;VERDADERO;VERDADERO;4;;;
140300;140296;0;21395;VERDADERO;VERDADERO;4;;;
140300;140296;0;21396;VERDADERO;VERDADERO;4;;;
140332;140316;1;21397;VERDADERO;VERDADERO;16;;;
140332;140316;0,00E+00;21398;VERDADERO;VERDADERO;16;;;
140332;140316;0;21399;VERDADERO;VERDADERO;16;;;
140332;140336;1;21400;VERDADERO;VERDADERO;-4;;;
140332;140336;0;21401;VERDADERO;VERDADERO;-4;;;
140332;140356;0;21402;VERDADERO;VERDADERO;-24;;;
140369;140356;0;21403;VERDADERO;VERDADERO;13;;;
140369;140356;0;21404;VERDADERO;VERDADERO;13;;;
140369;140356;0;21405;VERDADERO;VERDADERO;13;;;
140369;140376;0;21406;VERDADERO;VERDADERO;-7;;;
140397;140376;0;21407;VERDADERO;VERDADERO;21;;;
140397;140376;0;21408;VERDADERO;VERDADERO;21;;;
140397;140396;0;21409;VERDADERO;VERDADERO;1;;;
140397;140396;0;21410;VERDADERO;VERDADERO;1;;;
140397;140416;1;21411;VERDADERO;VERDADERO;-19;;;
140397;140416;0;21412;VERDADERO;VERDADERO;-19;;;
140433;140416;0;21413;VERDADERO;VERDADERO;17;;;
140433;140416;0;21414;VERDADERO;VERDADERO;17;;;
140433;140436;1;21415;VERDADERO;VERDADERO;-3;;;
140433;140436;0;21416;VERDADERO;VERDADERO;-3;;;
140433;140456;0;21417;VERDADERO;VERDADERO;-23;;;
140465;140456;0;21418;VERDADERO;VERDADERO;9;;;
140465;140456;0;21419;VERDADERO;VERDADERO;9;;;
140465;140476;0;21420;VERDADERO;VERDADERO;-11;;;
140465;140476;0;21421;VERDADERO;VERDADERO;-11;;;
140465;140476;0;21422;VERDADERO;VERDADERO;-11;;;
140501;140496;0;21423;VERDADERO;VERDADERO;5;;;
140501;140496;0;21424;VERDADERO;VERDADERO;5;;;
140501;140496;0;21425;VERDADERO;VERDADERO;5;;;
140501;140516;1;21426;VERDADERO;VERDADERO;-15;;;
140501;140516;0;21427;VERDADERO;VERDADERO;-15;;;
140532;140536;0;21428;VERDADERO;VERDADERO;-4;;;
140532;140536;0;21429;VERDADERO;VERDADERO;-4;;;
140532;140536;0;21430;VERDADERO;VERDADERO;-4;;;
140532;140556;0;21431;VERDADERO;VERDADERO;-24;;;
140532;140556;0;21432;VERDADERO;VERDADERO;-24;;;
140532;140576;0;21433;VERDADERO;VERDADERO;-44;;;
140573;140576;0;21434;VERDADERO;VERDADERO;-3;;;
140573;140576;0;21435;VERDADERO;VERDADERO;-3;;;
140573;140596;0;21436;VERDADERO;VERDADERO;-23;;;
140573;140596;0;21437;VERDADERO;VERDADERO;-23;;;
140573;140596;0;21438;VERDADERO;VERDADERO;-23;;;
140600;140616;0;21439;VERDADERO;VERDADERO;-16;;;
140600;140616;0;21440;VERDADERO;VERDADERO;-16;;;
140600;140616;0;21441;VERDADERO;VERDADERO;-16;;;
140600;140636;0;21442;VERDADERO;VERDADERO;-36;;;
140600;140636;0;21443;VERDADERO;VERDADERO;-36;;;
140633;140636;0;21444;VERDADERO;VERDADERO;-3;;;
140633;140636;0;21445;VERDADERO;VERDADERO;-3;;;
140633;140636;0;21446;VERDADERO;VERDADERO;-3;;;
140633;140636;0;21447;VERDADERO;VERDADERO;-3;;;
140633;140656;0;21448;VERDADERO;VERDADERO;-23;;;
140633;140656;0;21449;VERDADERO;VERDADERO;-23;;;
140668;140676;0;21450;VERDADERO;VERDADERO;-8;;;
140668;140676;0;21451;VERDADERO;VERDADERO;-8;;;
140668;140676;0;21452;VERDADERO;VERDADERO;-8;;;
140668;140696;1;21453;VERDADERO;VERDADERO;-28;;;
140668;140696;0;21454;VERDADERO;VERDADERO;-28;;;
140668;140696;0;21455;VERDADERO;VERDADERO;-28;;;
140705;140716;0;21456;VERDADERO;VERDADERO;-11;;;
140705;140716;0;21457;VERDADERO;VERDADERO;-11;;;
140705;140736;1;21458;VERDADERO;VERDADERO;-31;;;
140705;140736;0;21459;VERDADERO;VERDADERO;-31;;;
140732;140736;0;21460;VERDADERO;VERDADERO;-4;;;
140732;140756;0;21461;VERDADERO;VERDADERO;-24;;;
140732;140756;0;21462;VERDADERO;VERDADERO;-24;;;
140732;140756;0;21463;VERDADERO;VERDADERO;-24;;;
140732;140756;0;21464;VERDADERO;VERDADERO;-24;;;
140732;140776;0;21465;VERDADERO;VERDADERO;-44;;;
140768;140776;0;21466;VERDADERO;VERDADERO;-8;;;
140768;140796;0;21467;VERDADERO;VERDADERO;-28;;;
140768;140796;0;21468;VERDADERO;VERDADERO;-28;;;
140768;140796;0;21469;VERDADERO;VERDADERO;-28;;;
140768;140816;0;21470;VERDADERO;VERDADERO;-48;;;
140800;140816;0;21471;VERDADERO;VERDADERO;-16;;;
140800;140816;0;21472;VERDADERO;VERDADERO;-16;;;
140800;140836;0;21473;VERDADERO;VERDADERO;-36;;;
140800;140836;0;21474;VERDADERO;VERDADERO;-36;;;
140800;140836;0;21475;VERDADERO;VERDADERO;-36;;;
140833;140856;0;21476;VERDADERO;VERDADERO;-23;;;
140833;140856;0;21477;VERDADERO;VERDADERO;-23;;;
140833;140856;0;21478;VERDADERO;VERDADERO;-23;;;
140833;140856;0;21479;VERDADERO;VERDADERO;-23;;;
140833;140856;0;21480;VERDADERO;VERDADERO;-23;;;
140865;140856;0;21481;VERDADERO;VERDADERO;9;;;
140865;140856;0;21482;VERDADERO;VERDADERO;9;;;
140865;140856;0;21483;VERDADERO;VERDADERO;9;;;
140865;140876;0;21484;VERDADERO;VERDADERO;-11;;;
140865;140876;0;21485;VERDADERO;VERDADERO;-11;;;
140896;140876;0;21486;VERDADERO;VERDADERO;20;;;
140896;140896;0;21487;VERDADERO;VERDADERO;0;;;
140896;140896;0;21488;VERDADERO;VERDADERO;0;;;
140896;140916;0;21489;VERDADERO;VERDADERO;-20;;;
140896;140916;0;21490;VERDADERO;VERDADERO;-20;;;
140932;140916;0;21491;VERDADERO;VERDADERO;16;;;
140932;140916;0;21492;VERDADERO;VERDADERO;16;;;
140932;140916;0;21493;VERDADERO;VERDADERO;16;;;
140932;140936;0;21494;VERDADERO;VERDADERO;-4;;;
140932;140936;0;21495;VERDADERO;VERDADERO;-4;;;
140932;140956;0;21496;VERDADERO;VERDADERO;-24;;;
140968;140956;0;21497;VERDADERO;VERDADERO;12;;;
140968;140956;0;21498;VERDADERO;VERDADERO;12;;;
140968;140976;0;21499;VERDADERO;VERDADERO;-8;;;
140968;140976;0;21500;VERDADERO;VERDADERO;-8;;;
140968;140976;0;21501;VERDADERO;VERDADERO;-8;;;
141001;140996;0;21502;VERDADERO;VERDADERO;5;;;
141001;140996;0;21503;VERDADERO;VERDADERO;5;;;
141001;140996;0;21504;VERDADERO;VERDADERO;5;;;
141001;141016;0;21505;VERDADERO;VERDADERO;-15;;;
141001;141016;0;21506;VERDADERO;VERDADERO;-15;;;
141032;141036;0;21507;VERDADERO;VERDADERO;-4;;;
141032;141036;0;21508;VERDADERO;VERDADERO;-4;;;
141032;141036;0;21509;VERDADERO;VERDADERO;-4;;;
141032;141036;0;21510;VERDADERO;VERDADERO;-4;;;
141032;141036;0;21511;VERDADERO;VERDADERO;-4;;;
141032;141036;0;21512;VERDADERO;VERDADERO;-4;;;
141068;141036;0;21513;VERDADERO;VERDADERO;32;;;
141068;141036;0;21514;VERDADERO;VERDADERO;32;;;
141068;141036;0;21515;VERDADERO;VERDADERO;32;;;
141068;141036;0;21516;VERDADERO;VERDADERO;32;;;
141068;141036;0;21517;VERDADERO;VERDADERO;32;;;
141068;141036;0;21518;VERDADERO;VERDADERO;32;;;
141100;141036;0;21519;FALSO;VERDADERO;64;;;
141100;141036;0;21520;FALSO;VERDADERO;64;;;
141100;141036;0;21521;FALSO;VERDADERO;64;;;
141100;141036;0;21522;FALSO;VERDADERO;64;;;
141100;141036;0;21523;FALSO;VERDADERO;64;;;
141100;141036;0;21524;FALSO;VERDADERO;64;;;
141138;141036;0;21525;FALSO;VERDADERO;102;;;
141138;141036;0,00E+00;21526;FALSO;VERDADERO;102;;;
141138;141036;0;21527;FALSO;VERDADERO;102;;;
141138;141036;0;21528;FALSO;VERDADERO;102;;;
141138;141036;0;21529;FALSO;VERDADERO;102;;;
141169;141036;0;21530;FALSO;VERDADERO;133;;;
141169;141036;0;21531;FALSO;VERDADERO;133;;;
141169;141036;0;21532;FALSO;VERDADERO;133;;;
141169;141036;0;21533;FALSO;VERDADERO;133;;;
141169;141036;0;21534;FALSO;VERDADERO;133;;;
141169;141036;0;21535;FALSO;VERDADERO;133;;;
141205;141036;0;21536;FALSO;VERDADERO;169;;;
141205;141036;0;21537;FALSO;VERDADERO;169;;;
141205;141036;0;21538;FALSO;VERDADERO;169;;;
141205;141036;0;21539;FALSO;VERDADERO;169;;;
141205;141036;0;21540;FALSO;VERDADERO;169;;;
141236;141036;0;21541;FALSO;VERDADERO;200;;;
141236;141036;0;21542;FALSO;VERDADERO;200;;;
141236;141036;0;21543;FALSO;VERDADERO;200;;;
141236;141036;0;21544;FALSO;VERDADERO;200;;;
141236;141036;0;21545;FALSO;VERDADERO;200;;;
141236;141036;0;21546;FALSO;VERDADERO;200;;;
141270;141036;0;21547;FALSO;VERDADERO;234;;;
141270;141036;0;21548;FALSO;VERDADERO;234;;;
141270;141036;0;21549;FALSO;VERDADERO;234;;;
141270;141036;0;21550;FALSO;VERDADERO;234;;;
141270;141036;0;21551;FALSO;VERDADERO;234;;;
141300;141036;0;21552;FALSO;VERDADERO;264;;;
141300;141036;0;21553;FALSO;VERDADERO;264;;;
141300;141036;0;21554;FALSO;VERDADERO;264;;;
141300;141036;0;21555;FALSO;VERDADERO;264;;;
141300;141036;0;21556;FALSO;VERDADERO;264;;;
141333;141036;0;21557;FALSO;VERDADERO;297;;;
141333;141036;0;21558;FALSO;VERDADERO;297;;;
141333;141036;0;21559;FALSO;VERDADERO;297;;;
141333;141036;0;21560;FALSO;VERDADERO;297;;;
141333;141036;0;21561;FALSO;VERDADERO;297;;;
141364;141036;0;21562;FALSO;VERDADERO;328;;;
141364;141036;0;21563;FALSO;VERDADERO;328;;;
141364;141036;0;21564;FALSO;VERDADERO;328;;;
141364;141036;0;21565;FALSO;VERDADERO;328;;;
141364;141036;0;21566;FALSO;VERDADERO;328;;;
141364;141036;0;21567;FALSO;VERDADERO;328;;;
141397;141036;0;21568;FALSO;VERDADERO;361;;;
141397;141036;0,00E+00;21569;FALSO;VERDADERO;361;;;
141397;141036;0;21570;FALSO;VERDADERO;361;;;
141397;141036;0;21571;FALSO;VERDADERO;361;;;
141397;141036;0;21572;FALSO;VERDADERO;361;;;
141397;141036;0;21573;FALSO;VERDADERO;361;;;
141397;141036;0;21574;FALSO;VERDADERO;361;;;
141441;141036;0;21575;FALSO;VERDADERO;405;;;
141441;141036;0;21576;FALSO;VERDADERO;405;;;
141441;141036;0;21577;FALSO;VERDADERO;405;;;
141441;141036;0;21578;FALSO;VERDADERO;405;;;
141466;141036;0;21579;FALSO;VERDADERO;430;;;
141466;141036;0;21580;FALSO;VERDADERO;430;;;
141466;141036;0;21581;FALSO;VERDADERO;430;;;
141466;141036;0;21582;FALSO;VERDADERO;430;;;
141466;141036;0;21583;FALSO;VERDADERO;430;;;
141496;141036;0;21584;FALSO;VERDADERO;460;;;
141496;141036;0;21585;FALSO;VERDADERO;460;;;
141496;141036;0;21586;FALSO;VERDADERO;460;;;
141496;141036;0;21587;FALSO;VERDADERO;460;;;
141496;141036;0;21588;FALSO;VERDADERO;460;;;
141496;141036;0;21589;FALSO;VERDADERO;460;;;
141533;141036;0;21590;FALSO;VERDADERO;497;;;
141533;141036;0;21591;FALSO;VERDADERO;497;;;
141533;141036;0;21592;FALSO;VERDADERO;497;;;
141533;141036;0;21593;FALSO;VERDADERO;497;;;
141533;141036;0;21594;FALSO;VERDADERO;497;;;
141533;141036;0;21595;FALSO;VERDADERO;497;;;
141569;141036;0;21596;FALSO;VERDADERO;533;;;
141569;141036;0;21597;FALSO;VERDADERO;533;;;
141569;141036;0;21598;FALSO;VERDADERO;533;;;
141569;141036;0;21599;FALSO;VERDADERO;533;;;
141569;141036;0;21600;FALSO;VERDADERO;533;;;
141602;141036;0;21601;FALSO;VERDADERO;566;;;
141602;141036;0;21602;FALSO;VERDADERO;566;;;
141602;141036;0;21603;FALSO;VERDADERO;566;;;
141602;141036;0;21604;FALSO;VERDADERO;566;;;
141602;141036;0;21605;FALSO;VERDADERO;566;;;
141602;141036;0;21606;FALSO;VERDADERO;566;;;
141602;141036;0;21607;FALSO;VERDADERO;566;;;
141638;141036;0;21608;FALSO;VERDADERO;602;;;
141638;141036;0;21609;FALSO;VERDADERO;602;;;
141638;141036;0;21610;FALSO;VERDADERO;602;;;
141638;141036;0;21611;FALSO;VERDADERO;602;;;
141669;141036;0;21612;FALSO;VERDADERO;633;;;
141669;141036;0;21613;FALSO;VERDADERO;633;;;
141669;141036;0;21614;FALSO;VERDADERO;633;;;
141669;141036;0;21615;FALSO;VERDADERO;633;;;
141669;141036;0;21616;FALSO;VERDADERO;633;;;
141669;141036;0;21617;FALSO;VERDADERO;633;;;
141704;141036;0;21618;FALSO;VERDADERO;668;;;
141704;141036;0;21619;FALSO;VERDADERO;668;;;
141704;141036;0;21620;FALSO;VERDADERO;668;;;
141704;141036;0;21621;FALSO;VERDADERO;668;;;
141704;141036;0;21622;FALSO;VERDADERO;668;;;
141704;141036;0;21623;FALSO;VERDADERO;668;;;
141740;141036;0;21624;FALSO;VERDADERO;704;;;
141740;141036;0;21625;FALSO;VERDADERO;704;;;
141740;141036;0;21626;FALSO;VERDADERO;704;;;
141740;141036;0;21627;FALSO;VERDADERO;704;;;
141740;141036;0;21628;FALSO;VERDADERO;704;;;
141740;141036;0;21629;FALSO;VERDADERO;704;;;
141772;141036;0;21630;FALSO;VERDADERO;736;;;
141772;141036;0;21631;FALSO;VERDADERO;736;;;
141772;141036;0;21632;FALSO;VERDADERO;736;;;
141772;141036;0;21633;FALSO;VERDADERO;736;;;
141772;141036;0;21634;FALSO;VERDADERO;736;;;
141805;141036;0;21635;FALSO;VERDADERO;769;;;
141805;141036;0;21636;FALSO;VERDADERO;769;;;
141805;141036;0;21637;FALSO;VERDADERO;769;;;
141805;141036;0;21638;FALSO;VERDADERO;769;;;
141805;141036;0;21639;FALSO;VERDADERO;769;;;
141837;141036;0;21640;FALSO;VERDADERO;801;;;
141837;141036;0;21641;FALSO;VERDADERO;801;;;
141837;141036;0;21642;FALSO;VERDADERO;801;;;
141837;141036;0;21643;FALSO;VERDADERO;801;;;
141837;141036;0;21644;FALSO;VERDADERO;801;;;
141837;141036;0;21645;FALSO;VERDADERO;801;;;
141837;141036;0;21646;FALSO;VERDADERO;801;;;
141876;141036;0;21647;FALSO;VERDADERO;840;;;
141876;141036;0;21648;FALSO;VERDADERO;840;;;
141876;141036;0;21649;FALSO;VERDADERO;840;;;
141876;141036;0;21650;FALSO;VERDADERO;840;;;
141903;141036;0;21651;FALSO;VERDADERO;867;;;
141903;141036;0;21652;FALSO;VERDADERO;867;;;
141903;141036;0;21653;FALSO;VERDADERO;867;;;
141903;141036;0;21654;FALSO;VERDADERO;867;;;
141903;141036;0;21655;FALSO;VERDADERO;867;;;
141903;141036;0;21656;FALSO;VERDADERO;867;;;
141936;141036;0;21657;FALSO;VERDADERO;900;;;
141936;141036;0;21658;FALSO;VERDADERO;900;;;
141936;141036;0;21659;FALSO;VERDADERO;900;;;
141936;141036;0;21660;FALSO;VERDADERO;900;;;
141936;141036;0;21661;FALSO;VERDADERO;900;;;
141968;141036;0;21662;FALSO;VERDADERO;932;;;
141968;141036;0;21663;FALSO;VERDADERO;932;;;
141968;141036;0;21664;FALSO;VERDADERO;932;;;
141968;141036;0;21665;FALSO;VERDADERO;932;;;
141968;141036;0;21666;FALSO;VERDADERO;932;;;
141968;141036;0;21667;FALSO;VERDADERO;932;;;
141968;141036;0;21668;FALSO;VERDADERO;932;;;
142009;141036;0;21669;FALSO;VERDADERO;973;;;
142009;141036;0;21670;FALSO;VERDADERO;973;;;
142009;141036;0;21671;FALSO;VERDADERO;973;;;
142009;141036;0;21672;FALSO;VERDADERO;973;;;
142036;141036;0;21673;FALSO;VERDADERO;1000;;;
142036;141036;0;21674;FALSO;VERDADERO;1000;;;
142036;141036;0;21675;FALSO;VERDADERO;1000;;;
142036;141036;0;21676;FALSO;VERDADERO;1000;;;
142036;141036;0;21677;FALSO;VERDADERO;1000;;;
142064;141036;0;21678;FALSO;VERDADERO;1028;;;
142064;141036;0;21679;FALSO;VERDADERO;1028;;;
142064;141036;0;21680;FALSO;VERDADERO;1028;;;
142064;141036;0;21681;FALSO;VERDADERO;1028;;;
142064;141036;0;21682;FALSO;VERDADERO;1028;;;
142064;141036;0;21683;FALSO;VERDADERO;1028;;;
142100;141036;0;21684;FALSO;VERDADERO;1064;;;
142100;141036;0;21685;FALSO;VERDADERO;1064;;;
142100;141036;0;21686;FALSO;VERDADERO;1064;;;
142100;141036;0;21687;FALSO;VERDADERO;1064;;;
142100;141036;0;21688;FALSO;VERDADERO;1064;;;
142100;141036;0;21689;FALSO;VERDADERO;1064;;;
142140;141036;0;21690;FALSO;VERDADERO;1104;;;
142140;141036;0;21691;FALSO;VERDADERO;1104;;;
142140;141036;0;21692;FALSO;VERDADERO;1104;;;
142140;141036;0;21693;FALSO;VERDADERO;1104;;;
142140;141036;0;21694;FALSO;VERDADERO;1104;;;
142165;141036;0;21695;FALSO;VERDADERO;1129;;;
142165;141036;0;21696;FALSO;VERDADERO;1129;;;
142165;141036;0;21697;FALSO;VERDADERO;1129;;;
142165;141036;0;21698;FALSO;VERDADERO;1129;;;
142165;141036;0;21699;FALSO;VERDADERO;1129;;;
142201;141036;0;21700;FALSO;VERDADERO;1165;;;
142201;141036;0;21701;FALSO;VERDADERO;1165;;;
142201;141036;0;21702;FALSO;VERDADERO;1165;;;
142201;141036;0;21703;FALSO;VERDADERO;1165;;;
142201;141036;0;21704;FALSO;VERDADERO;1165;;;
142201;141036;0;21705;FALSO;VERDADERO;1165;;;
142233;141036;0;21706;FALSO;VERDADERO;1197;;;
142233;141036;0;21707;FALSO;VERDADERO;1197;;;
142233;141036;0;21708;FALSO;VERDADERO;1197;;;
142233;141036;0;21709;FALSO;VERDADERO;1197;;;
142233;141036;0;21710;FALSO;VERDADERO;1197;;;
142233;141036;0;21711;FALSO;VERDADERO;1197;;;
142270;141036;0;21712;FALSO;VERDADERO;1234;;;
142270;141036;0;21713;FALSO;VERDADERO;1234;;;
142270;141036;0;21714;FALSO;VERDADERO;1234;;;
142270;141036;0;21715;FALSO;VERDADERO;1234;;;
142297;141036;0;21716;FALSO;VERDADERO;1261;;;
142297;141036;0;21717;FALSO;VERDADERO;1261;;;
142297;141036;0;21718;FALSO;VERDADERO;1261;;;
142297;141036;0;21719;FALSO;VERDADERO;1261;;;
142297;141036;0;21720;FALSO;VERDADERO;1261;;;
142297;141036;0;21721;FALSO;VERDADERO;1261;;;
142329;141036;0;21722;FALSO;VERDADERO;1293;;;
142329;141036;0;21723;FALSO;VERDADERO;1293;;;
142329;141036;0;21724;FALSO;VERDADERO;1293;;;
142329;141036;0;21725;FALSO;VERDADERO;1293;;;
142329;141036;0;21726;FALSO;VERDADERO;1293;;;
142361;141036;0;21727;FALSO;VERDADERO;1325;;;
142361;141036;0;21728;FALSO;VERDADERO;1325;;;
142361;141036;0;21729;FALSO;VERDADERO;1325;;;
142361;141036;0;21730;FALSO;VERDADERO;1325;;;
142361;141036;0;21731;FALSO;VERDADERO;1325;;;
142393;141036;0;21732;FALSO;VERDADERO;1357;;;
142393;141036;0;21733;FALSO;VERDADERO;1357;;;
142393;141036;0;21734;FALSO;VERDADERO;1357;;;
142393;141036;0;21735;FALSO;VERDADERO;1357;;;
142393;141036;0;21736;FALSO;VERDADERO;1357;;;
142393;141056;0;21737;FALSO;VERDADERO;1337;;;
142428;141056;0;21738;FALSO;VERDADERO;1372;;;
142428;141076;0;21739;FALSO;VERDADERO;1352;;;
142428;141076;0;21740;FALSO;VERDADERO;1352;;;
142428;141076;0;21741;FALSO;VERDADERO;1352;;;
142428;141096;0;21742;FALSO;VERDADERO;1332;;;
142461;141096;0;21743;FALSO;VERDADERO;1365;;;
142461;141116;0;21744;FALSO;VERDADERO;1345;;;
142461;141116;0;21745;FALSO;VERDADERO;1345;;;
142461;141136;0;21746;FALSO;VERDADERO;1325;;;
142461;141136;0;21747;FALSO;VERDADERO;1325;;;
142494;141136;0;21748;FALSO;VERDADERO;1358;;;
142494;141156;0;21749;FALSO;VERDADERO;1338;;;
142494;141156;0;21750;FALSO;VERDADERO;1338;;;
142494;141176;0;21751;FALSO;VERDADERO;1318;;;
142494;141176;0;21752;FALSO;VERDADERO;1318;;;
142494;141176;0;21753;FALSO;VERDADERO;1318;;;
142528;141196;0;21754;FALSO;VERDADERO;1332;;;
142528;141196;0;21755;FALSO;VERDADERO;1332;;;
142528;141216;0;21756;FALSO;VERDADERO;1312;;;
142528;141216;0;21757;FALSO;VERDADERO;1312;;;
142528;141216;0;21758;FALSO;VERDADERO;1312;;;
142560;141236;1;21759;FALSO;VERDADERO;1324;;;
142560;141236;0;21760;FALSO;VERDADERO;1324;;;
142560;141256;0;21761;FALSO;VERDADERO;1304;;;
142560;141256;0;21762;FALSO;VERDADERO;1304;;;
142560;141256;0;21763;FALSO;VERDADERO;1304;;;
142596;141276;0;21764;FALSO;VERDADERO;1320;;;
142596;141276;0;21765;FALSO;VERDADERO;1320;;;
142596;141296;0;21766;FALSO;VERDADERO;1300;;;
142596;141296;0;21767;FALSO;VERDADERO;1300;;;
142596;141296;0;21768;FALSO;VERDADERO;1300;;;
142628;141316;0;21769;FALSO;VERDADERO;1312;;;
142628;141316;0;21770;FALSO;VERDADERO;1312;;;
142628;141336;0;21771;FALSO;VERDADERO;1292;;;
142628;141336;0;21772;FALSO;VERDADERO;1292;;;
142628;141356;0;21773;FALSO;VERDADERO;1272;;;
142628;141356;0;21774;FALSO;VERDADERO;1272;;;
142665;141356;0;21775;FALSO;VERDADERO;1309;;;
142665;141376;0;21776;FALSO;VERDADERO;1289;;;
142665;141376;0;21777;FALSO;VERDADERO;1289;;;
142665;141396;0;21778;FALSO;VERDADERO;1269;;;
142665;141396;0;21779;FALSO;VERDADERO;1269;;;
142665;141396;0;21780;FALSO;VERDADERO;1269;;;
142702;141416;0;21781;FALSO;VERDADERO;1286;;;
142702;141416;0;21782;FALSO;VERDADERO;1286;;;
142702;141436;0;21783;FALSO;VERDADERO;1266;;;
142702;141436;0;21784;FALSO;VERDADERO;1266;;;
142729;141456;0;21785;FALSO;VERDADERO;1273;;;
142729;141456;0;21786;FALSO;VERDADERO;1273;;;
142729;141456;0;21787;FALSO;VERDADERO;1273;;;
142729;141476;1;21788;FALSO;VERDADERO;1253;;;
142729;141476;0;21789;FALSO;VERDADERO;1253;;;
142764;141496;0;21790;FALSO;VERDADERO;1268;;;
142764;141496;0;21791;FALSO;VERDADERO;1268;;;
142764;141496;0;21792;FALSO;VERDADERO;1268;;;
142764;141516;0;21793;FALSO;VERDADERO;1248;;;
142764;141516;0;21794;FALSO;VERDADERO;1248;;;
142797;141536;0;21795;FALSO;VERDADERO;1261;;;
142797;141536;0;21796;FALSO;VERDADERO;1261;;;
142797;141536;0;21797;FALSO;VERDADERO;1261;;;
142797;141556;0;21798;FALSO;VERDADERO;1241;;;
142797;141556;0;21799;FALSO;VERDADERO;1241;;;
142797;141576;1;21800;FALSO;VERDADERO;1221;;;
142832;141576;0;21801;FALSO;VERDADERO;1256;;;
142832;141596;0;21802;FALSO;VERDADERO;1236;;;
142832;141596;0;21803;FALSO;VERDADERO;1236;;;
142832;141596;0;21804;FALSO;VERDADERO;1236;;;
142832;141616;0;21805;FALSO;VERDADERO;1216;;;
142865;141616;0;21806;FALSO;VERDADERO;1249;;;
142865;141636;0;21807;FALSO;VERDADERO;1229;;;
142865;141636;0;21808;FALSO;VERDADERO;1229;;;
142865;141636;0;21809;FALSO;VERDADERO;1229;;;
142865;141656;0;21810;FALSO;VERDADERO;1209;;;
142900;141656;0;21811;FALSO;VERDADERO;1244;;;
142900;141676;0;21812;FALSO;VERDADERO;1224;;;
142900;141676;0;21813;FALSO;VERDADERO;1224;;;
142900;141676;0;21814;FALSO;VERDADERO;1224;;;
142900;141696;0;21815;FALSO;VERDADERO;1204;;;
142933;141696;0;21816;FALSO;VERDADERO;1237;;;
142933;141716;1;21817;FALSO;VERDADERO;1217;;;
142933;141716;0;21818;FALSO;VERDADERO;1217;;;
142933;141716;0;21819;FALSO;VERDADERO;1217;;;
142933;141736;1;21820;FALSO;VERDADERO;1197;;;
142964;141736;0;21821;FALSO;VERDADERO;1228;;;
142964;141756;0;21822;FALSO;VERDADERO;1208;;;
142964;141756;0;21823;FALSO;VERDADERO;1208;;;
142964;141756;0;21824;FALSO;VERDADERO;1208;;;
142964;141776;0;21825;FALSO;VERDADERO;1188;;;
142996;141776;0;21826;FALSO;VERDADERO;1220;;;
142996;141796;0;21827;FALSO;VERDADERO;1200;;;
142996;141796;0;21828;FALSO;VERDADERO;1200;;;
142996;141816;0;21829;FALSO;VERDADERO;1180;;;
142996;141816;0;21830;FALSO;VERDADERO;1180;;;
143028;141816;0;21831;FALSO;VERDADERO;1212;;;
143028;141836;0;21832;FALSO;VERDADERO;1192;;;
143028;141836;0;21833;FALSO;VERDADERO;1192;;;
143028;141856;1;21834;FALSO;VERDADERO;1172;;;
143028;141856;0;21835;FALSO;VERDADERO;1172;;;
143060;141856;0;21836;FALSO;VERDADERO;1204;;;
143060;141876;0;21837;FALSO;VERDADERO;1184;;;
143060;141876;0;21838;FALSO;VERDADERO;1184;;;
143060;141896;0;21839;FALSO;VERDADERO;1164;;;
143060;141896;0;21840;FALSO;VERDADERO;1164;;;
143093;141896;0;21841;FALSO;VERDADERO;1197;;;
143093;141916;1;21842;FALSO;VERDADERO;1177;;;
143093;141916;0;21843;FALSO;VERDADERO;1177;;;
143093;141936;0;21844;FALSO;VERDADERO;1157;;;
143093;141936;0;21845;FALSO;VERDADERO;1157;;;
143093;141936;0;21846;FALSO;VERDADERO;1157;;;
143128;141956;0;21847;FALSO;VERDADERO;1172;;;
143128;141956;0;21848;FALSO;VERDADERO;1172;;;
143128;142497;0;21849;FALSO;VERDADERO;631;;;
143128;142497;0;21850;FALSO;VERDADERO;631;;;
143128;142497;0;21851;FALSO;VERDADERO;631;;;
143161;142517;0;21852;FALSO;VERDADERO;644;;;
143161;142517;0;21853;FALSO;VERDADERO;644;;;
143161;142537;0;21854;FALSO;VERDADERO;624;;;
143161;142537;0;21855;FALSO;VERDADERO;624;;;
143161;142557;0;21856;FALSO;VERDADERO;604;;;
143192;142557;0;21857;FALSO;VERDADERO;635;;;
143192;142557;0;21858;FALSO;VERDADERO;635;;;
143192;142577;0;21859;FALSO;VERDADERO;615;;;
143192;142577;0;21860;FALSO;VERDADERO;615;;;
143192;142597;0;21861;FALSO;VERDADERO;595;;;
143192;142597;0;21862;FALSO;VERDADERO;595;;;
143232;142597;0;21863;FALSO;VERDADERO;635;;;
143232;142617;0;21864;FALSO;VERDADERO;615;;;
143232;142617;0;21865;FALSO;VERDADERO;615;;;
143232;142637;0;21866;FALSO;VERDADERO;595;;;
143261;142637;0;21867;FALSO;VERDADERO;624;;;
143261;142637;0;21868;FALSO;VERDADERO;624;;;
143261;142657;0;21869;FALSO;VERDADERO;604;;;
143261;142657;0;21870;FALSO;VERDADERO;604;;;
143261;142677;0;21871;FALSO;VERDADERO;584;;;
143293;142677;0;21872;FALSO;VERDADERO;616;;;
143293;142677;0;21873;FALSO;VERDADERO;616;;;
143293;142697;0;21874;FALSO;VERDADERO;596;;;
143293;142697;0;21875;FALSO;VERDADERO;596;;;
143293;142717;0;21876;FALSO;VERDADERO;576;;;
143293;142717;0;21877;FALSO;VERDADERO;576;;;
143328;142717;0;21878;FALSO;VERDADERO;611;;;
143328;142737;0;21879;FALSO;VERDADERO;591;;;
143328;142737;0;21880;FALSO;VERDADERO;591;;;
143328;142757;0;21881;FALSO;VERDADERO;571;;;
143328;142757;0;21882;FALSO;VERDADERO;571;;;
143328;142757;0;21883;FALSO;VERDADERO;571;;;
143364;142777;0;21884;FALSO;VERDADERO;587;;;
143364;142777;0;21885;FALSO;VERDADERO;587;;;
143364;142797;0;21886;FALSO;VERDADERO;567;;;
143364;142797;0;21887;FALSO;VERDADERO;567;;;
143364;142797;0;21888;FALSO;VERDADERO;567;;;
143396;142817;0;21889;FALSO;VERDADERO;579;;;
143396;142817;0;21890;FALSO;VERDADERO;579;;;
143396;142837;1;21891;FALSO;VERDADERO;559;;;
143396;142837;0;21892;FALSO;VERDADERO;559;;;
143396;142837;0;21893;FALSO;VERDADERO;559;;;
143428;142857;0;21894;FALSO;VERDADERO;571;;;
143428;142857;0;21895;FALSO;VERDADERO;571;;;
143428;142877;0;21896;FALSO;VERDADERO;551;;;
143428;142877;0;21897;FALSO;VERDADERO;551;;;
143428;142877;0;21898;FALSO;VERDADERO;551;;;
143464;142897;0;21899;FALSO;VERDADERO;567;;;
143464;142897;0;21900;FALSO;VERDADERO;567;;;
143464;142917;0;21901;FALSO;VERDADERO;547;;;
143464;142917;0;21902;FALSO;VERDADERO;547;;;
143464;142917;0;21903;FALSO;VERDADERO;547;;;
143496;142937;0;21904;FALSO;VERDADERO;559;;;
143496;142937;0;21905;FALSO;VERDADERO;559;;;
143496;142957;0;21906;FALSO;VERDADERO;539;;;
143496;142957;0;21907;FALSO;VERDADERO;539;;;
143496;142957;0;21908;FALSO;VERDADERO;539;;;
143496;142977;0;21909;FALSO;VERDADERO;519;;;
143532;142977;0;21910;FALSO;VERDADERO;555;;;
143532;142997;0;21911;FALSO;VERDADERO;535;;;
143532;142997;0;21912;FALSO;VERDADERO;535;;;
143532;142997;0;21913;FALSO;VERDADERO;535;;;
143532;143017;0;21914;FALSO;VERDADERO;515;;;
143532;143017;0;21915;FALSO;VERDADERO;515;;;
143568;143037;0;21916;FALSO;VERDADERO;531;;;
143568;143037;0;21917;FALSO;VERDADERO;531;;;
143568;143037;0;21918;FALSO;VERDADERO;531;;;
143568;143057;0;21919;FALSO;VERDADERO;511;;;
143568;143057;0;21920;FALSO;VERDADERO;511;;;
143601;143077;0;21921;FALSO;VERDADERO;524;;;
143601;143077;0;21922;FALSO;VERDADERO;524;;;
143601;143077;0;21923;FALSO;VERDADERO;524;;;
143601;143097;1;21924;FALSO;VERDADERO;504;;;
143601;143097;0;21925;FALSO;VERDADERO;504;;;
143633;143117;0;21926;FALSO;VERDADERO;516;;;
143633;143117;0;21927;FALSO;VERDADERO;516;;;
143633;143117;0;21928;FALSO;VERDADERO;516;;;
143633;143137;0;21929;FALSO;VERDADERO;496;;;
143633;143137;0;21930;FALSO;VERDADERO;496;;;
143669;143157;0;21931;FALSO;VERDADERO;512;;;
143669;143157;0;21932;FALSO;VERDADERO;512;;;
143669;143157;0;21933;FALSO;VERDADERO;512;;;
143669;143177;0;21934;FALSO;VERDADERO;492;;;
143669;143177;0;21935;FALSO;VERDADERO;492;;;
143700;143197;0;21936;FALSO;VERDADERO;503;;;
143700;143197;0;21937;FALSO;VERDADERO;503;;;
143700;143197;0;21938;FALSO;VERDADERO;503;;;
143700;143217;0;21939;FALSO;VERDADERO;483;;;
143700;143217;0;21940;FALSO;VERDADERO;483;;;
143733;143238;0;21941;FALSO;VERDADERO;495;;;
143733;143238;0;21942;FALSO;VERDADERO;495;;;
143733;143238;0;21943;FALSO;VERDADERO;495;;;
143733;143258;1;21944;FALSO;VERDADERO;475;;;
143733;143258;0;21945;FALSO;VERDADERO;475;;;
143764;143278;0;21946;FALSO;VERDADERO;486;;;
143764;143278;0;21947;FALSO;VERDADERO;486;;;
143764;143278;0;21948;FALSO;VERDADERO;486;;;
143764;143298;0;21949;FALSO;VERDADERO;466;;;
143764;143298;0;21950;FALSO;VERDADERO;466;;;
143796;143318;0;21951;FALSO;VERDADERO;478;;;
143796;143318;0;21952;FALSO;VERDADERO;478;;;
143796;143338;0;21953;FALSO;VERDADERO;458;;;
143796;143338;0;21954;FALSO;VERDADERO;458;;;
143796;143338;0;21955;FALSO;VERDADERO;458;;;
143796;143358;0;21956;FALSO;VERDADERO;438;;;
143833;143358;0;21957;FALSO;VERDADERO;475;;;
143833;143378;0;21958;FALSO;VERDADERO;455;;;
143833;143378;0;21959;FALSO;VERDADERO;455;;;
143833;143378;0;21960;FALSO;VERDADERO;455;;;
143833;143398;0;21961;FALSO;VERDADERO;435;;;
143864;143398;0;21962;FALSO;VERDADERO;466;;;
143864;143418;0;21963;FALSO;VERDADERO;446;;;
143864;143418;0;21964;FALSO;VERDADERO;446;;;
143864;143418;0;21965;FALSO;VERDADERO;446;;;
143864;143438;0;21966;FALSO;VERDADERO;426;;;
143897;143438;0;21967;FALSO;VERDADERO;459;;;
143897;143458;0;21968;FALSO;VERDADERO;439;;;
143897;143458;0;21969;FALSO;VERDADERO;439;;;
143897;143458;0;21970;FALSO;VERDADERO;439;;;
143897;143478;0;21971;FALSO;VERDADERO;419;;;
143933;143478;0;21972;FALSO;VERDADERO;455;;;
143933;143498;1;21973;FALSO;VERDADERO;435;;;
143933;143498;0;21974;FALSO;VERDADERO;435;;;
143933;143498;0;21975;FALSO;VERDADERO;435;;;
143933;143518;1;21976;FALSO;VERDADERO;415;;;
143964;143518;0;21977;FALSO;VERDADERO;446;;;
143964;143538;0;21978;FALSO;VERDADERO;426;;;
143964;143538;0;21979;FALSO;VERDADERO;426;;;
143964;143558;1;21980;FALSO;VERDADERO;406;;;
143964;143558;0;21981;FALSO;VERDADERO;406;;;
143964;143558;0;21982;FALSO;VERDADERO;406;;;
143996;143578;0;21983;FALSO;VERDADERO;418;;;
143996;143578;0;21984;FALSO;VERDADERO;418;;;
143996;143598;0;21985;FALSO;VERDADERO;398;;;
143996;143598;0;21986;FALSO;VERDADERO;398;;;
144029;143598;0;21987;FALSO;VERDADERO;431;;;
144029;143618;0;21988;FALSO;VERDADERO;411;;;
144029;143618;0;21989;FALSO;VERDADERO;411;;;
144029;143638;0;21990;FALSO;VERDADERO;391;;;
144029;143638;0;21991;FALSO;VERDADERO;391;;;
144060;143638;0;21992;FALSO;VERDADERO;422;;;
144060;143658;0;21993;FALSO;VERDADERO;402;;;
144060;143658;0;21994;FALSO;VERDADERO;402;;;
144060;143678;0;21995;FALSO;VERDADERO;382;;;
144060;143678;0;21996;FALSO;VERDADERO;382;;;
144060;143678;0;21997;FALSO;VERDADERO;382;;;
144097;143698;0;21998;FALSO;VERDADERO;399;;;
144097;143698;0;21999;FALSO;VERDADERO;399;;;
144097;143718;0;22000;FALSO;VERDADERO;379;;;
144097;143718;0;22001;FALSO;VERDADERO;379;;;
144097;143718;0;22002;FALSO;VERDADERO;379;;;
144129;143738;0;22003;FALSO;VERDADERO;391;;;
144129;143738;0;22004;FALSO;VERDADERO;391;;;
144129;143758;0;22005;FALSO;VERDADERO;371;;;
144129;143758;0;22006;FALSO;VERDADERO;371;;;
144129;143758;0;22007;FALSO;VERDADERO;371;;;
144160;143778;1;22008;FALSO;VERDADERO;382;;;
144160;143778;0;22009;FALSO;VERDADERO;382;;;
144160;143798;0;22010;FALSO;VERDADERO;362;;;
144160;143798;0;22011;FALSO;VERDADERO;362;;;
144160;143798;0;22012;FALSO;VERDADERO;362;;;
144160;143818;0;22013;FALSO;VERDADERO;342;;;
144196;143818;0;22014;FALSO;VERDADERO;378;;;
144196;143838;0;22015;FALSO;VERDADERO;358;;;
144196;143838;0;22016;FALSO;VERDADERO;358;;;
144196;143858;0;22017;FALSO;VERDADERO;338;;;
144196;143858;0;22018;FALSO;VERDADERO;338;;;
144232;143858;0;22019;FALSO;VERDADERO;374;;;
144232;143878;0;22020;FALSO;VERDADERO;354;;;
144232;143878;0;22021;FALSO;VERDADERO;354;;;
144232;143898;0;22022;FALSO;VERDADERO;334;;;
144232;143898;0;22023;FALSO;VERDADERO;334;;;
144232;143898;0;22024;FALSO;VERDADERO;334;;;
144271;143918;0;22025;FALSO;VERDADERO;353;;;
144271;143918;0;22026;FALSO;VERDADERO;353;;;
144271;143938;0;22027;FALSO;VERDADERO;333;;;
144271;143938;0;22028;FALSO;VERDADERO;333;;;
144296;143938;0;22029;FALSO;VERDADERO;358;;;
144296;143958;0;22030;FALSO;VERDADERO;338;;;
144296;143958;0;22031;FALSO;VERDADERO;338;;;
144296;143978;0;22032;FALSO;VERDADERO;318;;;
144296;143978;0;22033;FALSO;VERDADERO;318;;;
144296;143978;0;22034;FALSO;VERDADERO;318;;;
144333;143998;0;22035;FALSO;VERDADERO;335;;;
144333;143998;0;22036;FALSO;VERDADERO;335;;;
144333;144018;0;22037;FALSO;VERDADERO;315;;;
144333;144018;0;22038;FALSO;VERDADERO;315;;;
144333;144018;0;22039;FALSO;VERDADERO;315;;;
144365;144038;0;22040;FALSO;VERDADERO;327;;;
144365;144038;0;22041;FALSO;VERDADERO;327;;;
144365;144058;0;22042;FALSO;VERDADERO;307;;;
144365;144058;0;22043;FALSO;VERDADERO;307;;;
144365;144078;0;22044;FALSO;VERDADERO;287;;;
144365;144078;0;22045;FALSO;VERDADERO;287;;;
144401;144078;0;22046;FALSO;VERDADERO;323;;;
144401;144098;0;22047;FALSO;VERDADERO;303;;;
144401;144098;0;22048;FALSO;VERDADERO;303;;;
144401;144118;0;22049;FALSO;VERDADERO;283;;;
144401;144118;0;22050;FALSO;VERDADERO;283;;;
144432;144118;0;22051;FALSO;VERDADERO;314;;;
144432;144138;0;22052;FALSO;VERDADERO;294;;;
144432;144138;0;22053;FALSO;VERDADERO;294;;;
144432;144158;0;22054;FALSO;VERDADERO;274;;;
144464;144158;0;22055;FALSO;VERDADERO;306;;;
144464;144158;0;22056;FALSO;VERDADERO;306;;;
144464;144178;0;22057;FALSO;VERDADERO;286;;;
144464;144178;0;22058;FALSO;VERDADERO;286;;;
144464;144198;1;22059;FALSO;VERDADERO;266;;;
144497;144198;0;22060;FALSO;VERDADERO;299;;;
144497;144198;0;22061;FALSO;VERDADERO;299;;;
144497;144218;0;22062;FALSO;VERDADERO;279;;;
144497;144218;0;22063;FALSO;VERDADERO;279;;;
144497;144238;0;22064;FALSO;VERDADERO;259;;;
144497;144238;0;22065;FALSO;VERDADERO;259;;;
144532;144238;0;22066;FALSO;VERDADERO;294;;;
144532;144258;0;22067;FALSO;VERDADERO;274;;;
144532;144258;0;22068;FALSO;VERDADERO;274;;;
144532;144278;0;22069;FALSO;VERDADERO;254;;;
144532;144278;0;22070;FALSO;VERDADERO;254;;;
144561;144278;0;22071;FALSO;VERDADERO;283;;;
144561;144298;0;22072;FALSO;VERDADERO;263;;;
144561;144298;0;22073;FALSO;VERDADERO;263;;;
144561;144318;1;22074;FALSO;VERDADERO;243;;;
144561;144318;0;22075;FALSO;VERDADERO;243;;;
144596;144318;0;22076;FALSO;VERDADERO;278;;;
144596;144338;0;22077;FALSO;VERDADERO;258;;;
144596;144338;0;22078;FALSO;VERDADERO;258;;;
144596;144358;0;22079;FALSO;VERDADERO;238;;;
144596;144358;0;22080;FALSO;VERDADERO;238;;;
144629;144358;0;22081;FALSO;VERDADERO;271;;;
144629;144378;0;22082;FALSO;VERDADERO;251;;;
144629;144378;0;22083;FALSO;VERDADERO;251;;;
144629;144398;1;22084;FALSO;VERDADERO;231;;;
144629;144398;0;22085;FALSO;VERDADERO;231;;;
144661;144398;0;22086;FALSO;VERDADERO;263;;;
144661;144418;0;22087;FALSO;VERDADERO;243;;;
144661;144418;0;22088;FALSO;VERDADERO;243;;;
144661;144439;0;22089;FALSO;VERDADERO;222;;;
144661;144439;0;22090;FALSO;VERDADERO;222;;;
144661;144459;0;22091;FALSO;VERDADERO;202;;;
144696;144459;0;22092;FALSO;VERDADERO;237;;;
144696;144459;0;22093;FALSO;VERDADERO;237;;;
144696;144479;0;22094;FALSO;VERDADERO;217;;;
144696;144479;0;22095;FALSO;VERDADERO;217;;;
144725;144499;0;22096;FALSO;VERDADERO;226;;;
144725;144499;0;22097;FALSO;VERDADERO;226;;;
144725;144499;0;22098;FALSO;VERDADERO;226;;;
144725;144519;0;22099;FALSO;VERDADERO;206;;;
144725;144519;0;22100;FALSO;VERDADERO;206;;;
144725;144539;1;22101;FALSO;VERDADERO;186;;;
144761;144539;0;22102;FALSO;VERDADERO;222;;;
144761;144539;0;22103;FALSO;VERDADERO;222;;;
144761;144559;0;22104;FALSO;VERDADERO;202;;;
144761;144559;0;22105;FALSO;VERDADERO;202;;;
144761;144579;0;22106;FALSO;VERDADERO;182;;;
144792;144579;0;22107;FALSO;VERDADERO;213;;;
144792;144579;0;22108;FALSO;VERDADERO;213;;;
144792;144599;0;22109;FALSO;VERDADERO;193;;;
144792;144599;0;22110;FALSO;VERDADERO;193;;;
144792;144619;0;22111;FALSO;VERDADERO;173;;;
144828;144619;0;22112;FALSO;VERDADERO;209;;;
144828;144619;0;22113;FALSO;VERDADERO;209;;;
144828;144639;0;22114;FALSO;VERDADERO;189;;;
144828;144639;0;22115;FALSO;VERDADERO;189;;;
144828;144659;1;22116;FALSO;VERDADERO;169;;;
144861;144659;0;22117;FALSO;VERDADERO;202;;;
144861;144659;0;22118;FALSO;VERDADERO;202;;;
144861;144679;0;22119;FALSO;VERDADERO;182;;;
144861;144679;0;22120;FALSO;VERDADERO;182;;;
144861;144699;0;22121;FALSO;VERDADERO;162;;;
144861;144699;0;22122;FALSO;VERDADERO;162;;;
144861;144719;1;22123;FALSO;VERDADERO;142;;;
144902;144719;0;22124;FALSO;VERDADERO;183;;;
144902;144719;0;22125;FALSO;VERDADERO;183;;;
144902;144739;0;22126;FALSO;VERDADERO;163;;;
144902;144739;0;22127;FALSO;VERDADERO;163;;;
144928;144759;0;22128;FALSO;VERDADERO;169;;;
144928;144759;0;22129;FALSO;VERDADERO;169;;;
144928;144759;0;22130;FALSO;VERDADERO;169;;;
144928;144779;1;22131;FALSO;VERDADERO;149;;;
144928;144779;0;22132;FALSO;VERDADERO;149;;;
144960;144799;0;22133;FALSO;VERDADERO;161;;;
144960;144799;0;22134;FALSO;VERDADERO;161;;;
144960;144799;0;22135;FALSO;VERDADERO;161;;;
144960;144819;1;22136;FALSO;VERDADERO;141;;;
144960;144819;0;22137;FALSO;VERDADERO;141;;;
144960;144839;0;22138;FALSO;VERDADERO;121;;;
144997;144839;0;22139;FALSO;VERDADERO;158;;;
144997;144859;0;22140;FALSO;VERDADERO;138;;;
144997;144859;0;22141;FALSO;VERDADERO;138;;;
144997;144859;0;22142;FALSO;VERDADERO;138;;;
144997;144879;0;22143;FALSO;VERDADERO;118;;;
145034;144879;0;22144;FALSO;VERDADERO;155;;;
145034;144899;0;22145;FALSO;VERDADERO;135;;;
145034;144899;0;22146;FALSO;VERDADERO;135;;;
145034;144899;0;22147;FALSO;VERDADERO;135;;;
145034;144919;1;22148;FALSO;VERDADERO;115;;;
145064;144919;0;22149;FALSO;VERDADERO;145;;;
145064;144939;1;22150;FALSO;VERDADERO;125;;;
145064;144939;0;22151;FALSO;VERDADERO;125;;;
145064;144959;1;22152;FALSO;VERDADERO;105;;;
145064;144959;0;22153;FALSO;VERDADERO;105;;;
145098;144959;0;22154;FALSO;VERDADERO;139;;;
145098;144980;0;22155;FALSO;VERDADERO;118;;;
145098;144980;0;22156;FALSO;VERDADERO;118;;;
145098;145000;0;22157;FALSO;VERDADERO;98;;;
145098;145000;0;22158;FALSO;VERDADERO;98;;;
145129;145000;0;22159;FALSO;VERDADERO;129;;;
145129;145020;1;22160;FALSO;VERDADERO;109;;;
145129;145020;0;22161;FALSO;VERDADERO;109;;;
145129;145040;0;22162;FALSO;VERDADERO;89;;;
145129;145040;0;22163;FALSO;VERDADERO;89;;;
145162;145040;0;22164;FALSO;VERDADERO;122;;;
145162;145060;0;22165;FALSO;VERDADERO;102;;;
145162;145060;0;22166;FALSO;VERDADERO;102;;;
145162;145080;0;22167;FALSO;VERDADERO;82;;;
145162;145080;0;22168;FALSO;VERDADERO;82;;;
145162;145080;0;22169;FALSO;VERDADERO;82;;;
145197;145100;0;22170;FALSO;VERDADERO;97;;;
145197;145100;0;22171;FALSO;VERDADERO;97;;;
145197;145120;0;22172;FALSO;VERDADERO;77;;;
145197;145120;0;22173;FALSO;VERDADERO;77;;;
145197;145120;0;22174;FALSO;VERDADERO;77;;;
145228;145140;0;22175;FALSO;VERDADERO;88;;;
145228;145160;0;22176;FALSO;VERDADERO;68;;;
145228;145160;0;22177;FALSO;VERDADERO;68;;;
145261;145180;0;22178;FALSO;VERDADERO;81;;;
145261;145180;0;22179;FALSO;VERDADERO;81;;;
145261;145180;0;22180;FALSO;VERDADERO;81;;;
145261;145200;0;22181;FALSO;VERDADERO;61;;;
145261;145200;0;22182;FALSO;VERDADERO;61;;;
145261;145220;0;22183;VERDADERO;VERDADERO;41;;;
145298;145220;0;22184;FALSO;VERDADERO;78;;;
145298;145220;0;22185;FALSO;VERDADERO;78;;;
145298;145240;1;22186;FALSO;VERDADERO;58;;;
145298;145240;0;22187;FALSO;VERDADERO;58;;;
145324;145260;0;22188;FALSO;VERDADERO;64;;;
145324;145260;0;22189;FALSO;VERDADERO;64;;;
145324;145260;0;22190;FALSO;VERDADERO;64;;;
145324;145280;0;22191;VERDADERO;VERDADERO;44;;;
145324;145280;0;22192;VERDADERO;VERDADERO;44;;;
145324;145300;0;22193;VERDADERO;VERDADERO;24;;;
145360;145300;0;22194;FALSO;VERDADERO;60;;;
145360;145320;0;22195;VERDADERO;VERDADERO;40;;;
145360;145320;0;22196;VERDADERO;VERDADERO;40;;;
145360;145320;0;22197;VERDADERO;VERDADERO;40;;;
145360;145340;0;22198;VERDADERO;VERDADERO;20;;;
145392;145340;0;22199;FALSO;VERDADERO;52;;;
145392;145360;0;22200;VERDADERO;VERDADERO;32;;;
145392;145360;0;22201;VERDADERO;VERDADERO;32;;;
145392;145360;0;22202;VERDADERO;VERDADERO;32;;;
145392;145380;0;22203;VERDADERO;VERDADERO;12;;;
145429;145380;0;22204;VERDADERO;VERDADERO;49;;;
145429;145400;0;22205;VERDADERO;VERDADERO;29;;;
145429;145400;0;22206;VERDADERO;VERDADERO;29;;;
145429;145400;0;22207;VERDADERO;VERDADERO;29;;;
145429;145420;0;22208;VERDADERO;VERDADERO;9;;;
145429;145420;0;22209;VERDADERO;VERDADERO;9;;;
145461;145440;1;22210;VERDADERO;VERDADERO;21;;;
145461;145440;0;22211;VERDADERO;VERDADERO;21;;;
145461;145440;0;22212;VERDADERO;VERDADERO;21;;;
145461;145460;0;22213;VERDADERO;VERDADERO;1;;;
145461;145460;0;22214;VERDADERO;VERDADERO;1;;;
145497;145480;1;22215;VERDADERO;VERDADERO;17;;;
145497;145480;0;22216;VERDADERO;VERDADERO;17;;;
145497;145480;0;22217;VERDADERO;VERDADERO;17;;;
145497;145500;0;22218;VERDADERO;VERDADERO;-3;;;
145497;145500;0;22219;VERDADERO;VERDADERO;-3;;;
145528;145520;0;22220;VERDADERO;VERDADERO;8;;;
145528;145520;0;22221;VERDADERO;VERDADERO;8;;;
145528;145520;0;22222;VERDADERO;VERDADERO;8;;;
145528;145540;0;22223;VERDADERO;VERDADERO;-12;;;
145528;145540;0;22224;VERDADERO;VERDADERO;-12;;;
145528;145560;0;22225;VERDADERO;VERDADERO;-32;;;
145565;145560;0;22226;VERDADERO;VERDADERO;5;;;
145565;145560;0;22227;VERDADERO;VERDADERO;5;;;
145565;145580;0;22228;VERDADERO;VERDADERO;-15;;;
145565;145580;0;22229;VERDADERO;VERDADERO;-15;;;
145565;145600;0;22230;VERDADERO;VERDADERO;-35;;;
145565;145600;0;22231;VERDADERO;VERDADERO;-35;;;
145565;145600;0;22232;VERDADERO;VERDADERO;-35;;;
145607;145620;0;22233;VERDADERO;VERDADERO;-13;;;
145607;145620;0;22234;VERDADERO;VERDADERO;-13;;;
145607;145640;0;22235;VERDADERO;VERDADERO;-33;;;
145607;145640;0;22236;VERDADERO;VERDADERO;-33;;;
145634;145640;0;22237;VERDADERO;VERDADERO;-6;;;
145634;145640;0;22238;VERDADERO;VERDADERO;-6;;;
145634;145640;0;22239;VERDADERO;VERDADERO;-6;;;
145634;145640;0;22240;VERDADERO;VERDADERO;-6;;;
145634;145640;0;22241;VERDADERO;VERDADERO;-6;;;
145664;145660;0;22242;VERDADERO;VERDADERO;4;;;
145664;145660;0;22243;VERDADERO;VERDADERO;4;;;
145664;145680;0;22244;VERDADERO;VERDADERO;-16;;;
145664;145680;0;22245;VERDADERO;VERDADERO;-16;;;
145697;145700;0,00E+00;22246;VERDADERO;VERDADERO;-3;;;
145697;145700;0;22247;VERDADERO;VERDADERO;-3;;;
145697;145700;0;22248;VERDADERO;VERDADERO;-3;;;
145697;145720;0;22249;VERDADERO;VERDADERO;-23;;;
145697;145720;0;22250;VERDADERO;VERDADERO;-23;;;
145729;145740;0;22251;VERDADERO;VERDADERO;-11;;;
145729;145740;0;22252;VERDADERO;VERDADERO;-11;;;
145729;145740;0;22253;VERDADERO;VERDADERO;-11;;;
145729;145760;0;22254;VERDADERO;VERDADERO;-31;;;
145729;145760;0;22255;VERDADERO;VERDADERO;-31;;;
145729;145760;0;22256;VERDADERO;VERDADERO;-31;;;
145764;145780;1;22257;VERDADERO;VERDADERO;-16;;;
145764;145780;0;22258;VERDADERO;VERDADERO;-16;;;
145764;145800;0;22259;VERDADERO;VERDADERO;-36;;;
145764;145800;0;22260;VERDADERO;VERDADERO;-36;;;
145764;145800;0;22261;VERDADERO;VERDADERO;-36;;;
145797;145800;0;22262;VERDADERO;VERDADERO;-3;;;
145797;145800;0;22263;VERDADERO;VERDADERO;-3;;;
145797;145800;0;22264;VERDADERO;VERDADERO;-3;;;
145797;145820;0;22265;VERDADERO;VERDADERO;-23;;;
145797;145820;0;22266;VERDADERO;VERDADERO;-23;;;
145828;145820;0;22267;VERDADERO;VERDADERO;8;;;
145828;145840;0;22268;VERDADERO;VERDADERO;-12;;;
145828;145840;0;22269;VERDADERO;VERDADERO;-12;;;
145828;145860;0;22270;VERDADERO;VERDADERO;-32;;;
145828;145860;0;22271;VERDADERO;VERDADERO;-32;;;
145828;145860;0;22272;VERDADERO;VERDADERO;-32;;;
145866;145860;0;22273;VERDADERO;VERDADERO;6;;;
145866;145880;0;22274;VERDADERO;VERDADERO;-14;;;
145866;145880;0;22275;VERDADERO;VERDADERO;-14;;;
145866;145900;0;22276;VERDADERO;VERDADERO;-34;;;
145893;145900;0;22277;VERDADERO;VERDADERO;-7;;;
145893;145900;0;22278;VERDADERO;VERDADERO;-7;;;
145893;145900;0;22279;VERDADERO;VERDADERO;-7;;;
145893;145900;0;22280;VERDADERO;VERDADERO;-7;;;
145893;145900;0;22281;VERDADERO;VERDADERO;-7;;;
145893;145900;0;22282;VERDADERO;VERDADERO;-7;;;
145928;145900;0;22283;VERDADERO;VERDADERO;28;;;
145928;145900;0;22284;VERDADERO;VERDADERO;28;;;
145928;145900;0;22285;VERDADERO;VERDADERO;28;;;
145928;145900;0;22286;VERDADERO;VERDADERO;28;;;
145928;145900;0;22287;VERDADERO;VERDADERO;28;;;
145960;145900;0;22288;FALSO;VERDADERO;60;;;
145960;145900;0;22289;FALSO;VERDADERO;60;;;
145960;145920;0;22290;VERDADERO;VERDADERO;40;;;
145960;145920;0;22291;VERDADERO;VERDADERO;40;;;
145960;145940;0;22292;VERDADERO;VERDADERO;20;;;
145992;145940;0;22293;FALSO;VERDADERO;52;;;
145992;145940;0;22294;FALSO;VERDADERO;52;;;
145992;145960;0;22295;VERDADERO;VERDADERO;32;;;
145992;145960;0;22296;VERDADERO;VERDADERO;32;;;
145992;145980;1;22297;VERDADERO;VERDADERO;12;;;
145992;145980;0;22298;VERDADERO;VERDADERO;12;;;
146031;145980;0;22299;FALSO;VERDADERO;51;;;
146031;146000;0;22300;VERDADERO;VERDADERO;31;;;
146031;146000;0;22301;VERDADERO;VERDADERO;31;;;
146031;146020;0;22302;VERDADERO;VERDADERO;11;;;
146056;146020;0;22303;VERDADERO;VERDADERO;36;;;
146056;146020;0;22304;VERDADERO;VERDADERO;36;;;
146056;146040;0;22305;VERDADERO;VERDADERO;16;;;
146056;146040;0;22306;VERDADERO;VERDADERO;16;;;
146056;146060;0;22307;VERDADERO;VERDADERO;-4;;;
146056;146060;0;22308;VERDADERO;VERDADERO;-4;;;
146093;146060;0;22309;VERDADERO;VERDADERO;33;;;
146093;146080;0;22310;VERDADERO;VERDADERO;13;;;
146093;146080;0;22311;VERDADERO;VERDADERO;13;;;
146093;146100;0;22312;VERDADERO;VERDADERO;-7;;;
146093;146100;0;22313;VERDADERO;VERDADERO;-7;;;
146124;146120;1;22314;VERDADERO;VERDADERO;4;;;
146124;146120;0;22315;VERDADERO;VERDADERO;4;;;
146124;146120;0;22316;VERDADERO;VERDADERO;4;;;
146124;146140;0;22317;VERDADERO;VERDADERO;-16;;;
146124;146140;0;22318;VERDADERO;VERDADERO;-16;;;
146161;146140;0;22319;VERDADERO;VERDADERO;21;;;
146161;146140;0;22320;VERDADERO;VERDADERO;21;;;
146161;146160;0;22321;VERDADERO;VERDADERO;1;;;
146161;146160;0;22322;VERDADERO;VERDADERO;1;;;
146161;146160;0;22323;VERDADERO;VERDADERO;1;;;
146161;146180;1;22324;VERDADERO;VERDADERO;-19;;;
146193;146180;0;22325;VERDADERO;VERDADERO;13;;;
146193;146200;0;22326;VERDADERO;VERDADERO;-7;;;
146193;146200;0;22327;VERDADERO;VERDADERO;-7;;;
146193;146200;0;22328;VERDADERO;VERDADERO;-7;;;
146193;146220;1;22329;VERDADERO;VERDADERO;-27;;;
146229;146220;0;22330;VERDADERO;VERDADERO;9;;;
146229;146240;0;22331;VERDADERO;VERDADERO;-11;;;
146229;146240;0;22332;VERDADERO;VERDADERO;-11;;;
146229;146240;0;22333;VERDADERO;VERDADERO;-11;;;
146229;146260;0;22334;VERDADERO;VERDADERO;-31;;;
146261;146260;0;22335;VERDADERO;VERDADERO;1;;;
146261;146280;0;22336;VERDADERO;VERDADERO;-19;;;
146261;146280;0;22337;VERDADERO;VERDADERO;-19;;;
146261;146280;0;22338;VERDADERO;VERDADERO;-19;;;
146261;146300;0;22339;VERDADERO;VERDADERO;-39;;;
146293;146300;0;22340;VERDADERO;VERDADERO;-7;;;
146293;146300;0;22341;VERDADERO;VERDADERO;-7;;;
146293;146320;0;22342;VERDADERO;VERDADERO;-27;;;
146293;146320;0;22343;VERDADERO;VERDADERO;-27;;;
146293;146340;0;22344;VERDADERO;VERDADERO;-47;;;
146328;146340;0;22345;VERDADERO;VERDADERO;-12;;;
146328;146340;0;22346;VERDADERO;VERDADERO;-12;;;
146328;146340;0;22347;VERDADERO;VERDADERO;-12;;;
146328;146340;0;22348;VERDADERO;VERDADERO;-12;;;
146328;146340;0;22349;VERDADERO;VERDADERO;-12;;;
146361;146340;0;22350;VERDADERO;VERDADERO;21;;;
146361;146360;0;22351;VERDADERO;VERDADERO;1;;;
146361;146360;0;22352;VERDADERO;VERDADERO;1;;;
146361;146360;0;22353;VERDADERO;VERDADERO;1;;;
146361;146380;0;22354;VERDADERO;VERDADERO;-19;;;
146361;146380;0;22355;VERDADERO;VERDADERO;-19;;;
146392;146380;0;22356;VERDADERO;VERDADERO;12;;;
146392;146380;0;22357;VERDADERO;VERDADERO;12;;;
146392;146400;0;22358;VERDADERO;VERDADERO;-8;;;
146392;146400;0;22359;VERDADERO;VERDADERO;-8;;;
146392;146400;0;22360;VERDADERO;VERDADERO;-8;;;
146424;146420;0;22361;VERDADERO;VERDADERO;4;;;
146424;146420;0;22362;VERDADERO;VERDADERO;4;;;
146424;146440;0;22363;VERDADERO;VERDADERO;-16;;;
146424;146440;0;22364;VERDADERO;VERDADERO;-16;;;
146424;146440;0;22365;VERDADERO;VERDADERO;-16;;;
146456;146460;0;22366;VERDADERO;VERDADERO;-4;;;
146456;146460;0;22367;VERDADERO;VERDADERO;-4;;;
146456;146460;0;22368;VERDADERO;VERDADERO;-4;;;
146456;146460;0;22369;VERDADERO;VERDADERO;-4;;;
146456;146460;0;22370;VERDADERO;VERDADERO;-4;;;
146492;146460;0;22371;VERDADERO;VERDADERO;32;;;
146492;146460;0;22372;VERDADERO;VERDADERO;32;;;
146492;146460;0;22373;VERDADERO;VERDADERO;32;;;
146492;146460;0;22374;VERDADERO;VERDADERO;32;;;
146492;146480;0;22375;VERDADERO;VERDADERO;12;;;
146492;146480;0;22376;VERDADERO;VERDADERO;12;;;
146525;146480;0;22377;VERDADERO;VERDADERO;45;;;
146525;146500;0;22378;VERDADERO;VERDADERO;25;;;
146525;146500;0;22379;VERDADERO;VERDADERO;25;;;
146525;146520;0;22380;VERDADERO;VERDADERO;5;;;
146525;146520;0;22381;VERDADERO;VERDADERO;5;;;
146556;146520;0;22382;VERDADERO;VERDADERO;36;;;
146556;146540;0;22383;VERDADERO;VERDADERO;16;;;
146556;146540;0;22384;VERDADERO;VERDADERO;16;;;
146556;146560;0;22385;VERDADERO;VERDADERO;-4;;;
146556;146560;0;22386;VERDADERO;VERDADERO;-4;;;
146593;146560;0;22387;VERDADERO;VERDADERO;33;;;
146593;146560;0;22388;VERDADERO;VERDADERO;33;;;
146593;146580;0;22389;VERDADERO;VERDADERO;13;;;
146593;146580;0;22390;VERDADERO;VERDADERO;13;;;
146593;146580;0;22391;VERDADERO;VERDADERO;13;;;
146624;146600;1;22392;VERDADERO;VERDADERO;24;;;
146624;146600;0;22393;VERDADERO;VERDADERO;24;;;
146624;146600;0;22394;VERDADERO;VERDADERO;24;;;
146624;146600;0;22395;VERDADERO;VERDADERO;24;;;
146624;146600;0;22396;VERDADERO;VERDADERO;24;;;
146624;146600;0;22397;VERDADERO;VERDADERO;24;;;
146660;146600;0;22398;FALSO;VERDADERO;60;;;
146660;146620;0;22399;VERDADERO;VERDADERO;40;;;
146660;146620;0;22400;VERDADERO;VERDADERO;40;;;
146660;146620;0;22401;VERDADERO;VERDADERO;40;;;
146660;146640;0;22402;VERDADERO;VERDADERO;20;;;
146693;146640;0;22403;FALSO;VERDADERO;53;;;
146693;146660;0;22404;VERDADERO;VERDADERO;33;;;
146693;146660;0;22405;VERDADERO;VERDADERO;33;;;
146693;146680;0;22406;VERDADERO;VERDADERO;13;;;
146693;146680;0;22407;VERDADERO;VERDADERO;13;;;
146693;146680;0;22408;VERDADERO;VERDADERO;13;;;
146728;146700;0;22409;VERDADERO;VERDADERO;28;;;
146728;146700;0;22410;VERDADERO;VERDADERO;28;;;
146728;146720;0;22411;VERDADERO;VERDADERO;8;;;
146728;146720;0;22412;VERDADERO;VERDADERO;8;;;
146761;146720;0;22413;VERDADERO;VERDADERO;41;;;
146761;146740;0;22414;VERDADERO;VERDADERO;21;;;
146761;146740;0;22415;VERDADERO;VERDADERO;21;;;
146761;146760;0;22416;VERDADERO;VERDADERO;1;;;
146761;146760;0;22417;VERDADERO;VERDADERO;1;;;
146761;146760;0;22418;VERDADERO;VERDADERO;1;;;
146797;146780;0;22419;VERDADERO;VERDADERO;17;;;
146797;146780;0;22420;VERDADERO;VERDADERO;17;;;
146797;146800;0;22421;VERDADERO;VERDADERO;-3;;;
146797;146800;0;22422;VERDADERO;VERDADERO;-3;;;
146797;146800;0;22423;VERDADERO;VERDADERO;-3;;;
146830;146820;0;22424;VERDADERO;VERDADERO;10;;;
146830;146820;0;22425;VERDADERO;VERDADERO;10;;;
146830;146820;0;22426;VERDADERO;VERDADERO;10;;;
146830;146840;0;22427;VERDADERO;VERDADERO;-10;;;
146830;146840;0;22428;VERDADERO;VERDADERO;-10;;;
146830;146860;0;22429;VERDADERO;VERDADERO;-30;;;
146865;146860;0;22430;VERDADERO;VERDADERO;5;;;
146865;146860;0;22431;VERDADERO;VERDADERO;5;;;
146865;146880;0;22432;VERDADERO;VERDADERO;-15;;;
146865;146880;0;22433;VERDADERO;VERDADERO;-15;;;
146865;146900;0;22434;VERDADERO;VERDADERO;-35;;;
146896;146900;0;22435;VERDADERO;VERDADERO;-4;;;
146896;146900;0;22436;VERDADERO;VERDADERO;-4;;;
146896;146920;0;22437;VERDADERO;VERDADERO;-24;;;
146896;146920;0;22438;VERDADERO;VERDADERO;-24;;;
146896;146940;0;22439;VERDADERO;VERDADERO;-44;;;
146929;146940;0;22440;VERDADERO;VERDADERO;-11;;;
146929;146940;0;22441;VERDADERO;VERDADERO;-11;;;
146929;146960;0;22442;VERDADERO;VERDADERO;-31;;;
146929;146960;0;22443;VERDADERO;VERDADERO;-31;;;
146929;146980;0;22444;VERDADERO;FALSO;-51;;;
146967;146980;0;22445;VERDADERO;VERDADERO;-13;;;
146967;146980;0;22446;VERDADERO;VERDADERO;-13;;;
146967;146980;0;22447;VERDADERO;VERDADERO;-13;;;
146967;146980;0;22448;VERDADERO;VERDADERO;-13;;;
146992;146980;0;22449;VERDADERO;VERDADERO;12;;;
146992;147000;0;22450;VERDADERO;VERDADERO;-8;;;
146992;147000;0;22451;VERDADERO;VERDADERO;-8;;;
146992;147020;0;22452;VERDADERO;VERDADERO;-28;;;
146992;147020;0;22453;VERDADERO;VERDADERO;-28;;;
146992;147020;0;22454;VERDADERO;VERDADERO;-28;;;
147029;147040;0;22455;VERDADERO;VERDADERO;-11;;;
147029;147040;0;22456;VERDADERO;VERDADERO;-11;;;
147029;147040;0;22457;VERDADERO;VERDADERO;-11;;;
147029;147040;0;22458;VERDADERO;VERDADERO;-11;;;
147029;147040;0;22459;VERDADERO;VERDADERO;-11;;;
147060;147040;0;22460;VERDADERO;VERDADERO;20;;;
147060;147040;0;22461;VERDADERO;VERDADERO;20;;;
147060;147040;0;22462;VERDADERO;VERDADERO;20;;;
147060;147040;0;22463;VERDADERO;VERDADERO;20;;;
147060;147040;0;22464;VERDADERO;VERDADERO;20;;;
147060;147040;0;22465;VERDADERO;VERDADERO;20;;;
147060;147060;0;22466;VERDADERO;VERDADERO;0;;;
147099;147060;0;22467;VERDADERO;VERDADERO;39;;;
147099;147080;1;22468;VERDADERO;VERDADERO;19;;;
147099;147080;0;22469;VERDADERO;VERDADERO;19;;;
147099;147080;0;22470;VERDADERO;VERDADERO;19;;;
147125;147080;0;22471;VERDADERO;VERDADERO;45;;;
147125;147080;0;22472;VERDADERO;VERDADERO;45;;;
147125;147080;0;22473;VERDADERO;VERDADERO;45;;;
147125;147080;0;22474;VERDADERO;VERDADERO;45;;;
147125;147080;0;22475;VERDADERO;VERDADERO;45;;;
147157;147080;0;22476;FALSO;VERDADERO;77;;;
147157;147080;0;22477;FALSO;VERDADERO;77;;;
147157;147080;0;22478;FALSO;VERDADERO;77;;;
147157;147080;0;22479;FALSO;VERDADERO;77;;;
147157;147080;0;22480;FALSO;VERDADERO;77;;;
147189;147080;0;22481;FALSO;VERDADERO;109;;;
147189;147080;0;22482;FALSO;VERDADERO;109;;;
147189;147080;0;22483;FALSO;VERDADERO;109;;;
147189;147080;0;22484;FALSO;VERDADERO;109;;;
147189;147080;0;22485;FALSO;VERDADERO;109;;;
147189;147080;0;22486;FALSO;VERDADERO;109;;;
147221;147080;0;22487;FALSO;VERDADERO;141;;;
147221;147100;0;22488;FALSO;VERDADERO;121;;;
147221;147100;0;22489;FALSO;VERDADERO;121;;;
147221;147120;1;22490;FALSO;VERDADERO;101;;;
147221;147120;0;22491;FALSO;VERDADERO;101;;;
147257;147120;0;22492;FALSO;VERDADERO;137;;;
147257;147140;0;22493;FALSO;VERDADERO;117;;;
147257;147140;0;22494;FALSO;VERDADERO;117;;;
147257;147160;0;22495;FALSO;VERDADERO;97;;;
147257;147160;0;22496;FALSO;VERDADERO;97;;;
147257;147160;0;22497;FALSO;VERDADERO;97;;;
147288;147180;0;22498;FALSO;VERDADERO;108;;;
147288;147180;0;22499;FALSO;VERDADERO;108;;;
147288;147180;0;22500;FALSO;VERDADERO;108;;;
147288;147200;0;22501;FALSO;VERDADERO;88;;;
147288;147200;0;22502;FALSO;VERDADERO;88;;;
147322;147220;0;22503;FALSO;VERDADERO;102;;;
147322;147220;0;22504;FALSO;VERDADERO;102;;;
147322;147220;0;22505;FALSO;VERDADERO;102;;;
147322;147240;0;22506;FALSO;VERDADERO;82;;;
147322;147240;0;22507;FALSO;VERDADERO;82;;;
147357;147260;1;22508;FALSO;VERDADERO;97;;;
147357;147260;0;22509;FALSO;VERDADERO;97;;;
147357;147260;0;22510;FALSO;VERDADERO;97;;;
147357;147280;1;22511;FALSO;VERDADERO;77;;;
147357;147280;0;22512;FALSO;VERDADERO;77;;;
147389;147300;0;22513;FALSO;VERDADERO;89;;;
147389;147300;0;22514;FALSO;VERDADERO;89;;;
147389;147320;0;22515;FALSO;VERDADERO;69;;;
147389;147320;0;22516;FALSO;VERDADERO;69;;;
147389;147320;0;22517;FALSO;VERDADERO;69;;;
147389;147340;0;22518;VERDADERO;VERDADERO;49;;;
147425;147340;0;22519;FALSO;VERDADERO;85;;;
147425;147360;0;22520;FALSO;VERDADERO;65;;;
147425;147360;0;22521;FALSO;VERDADERO;65;;;
147425;147360;0;22522;FALSO;VERDADERO;65;;;
147457;147380;0;22523;FALSO;VERDADERO;77;;;
147457;147380;0;22524;FALSO;VERDADERO;77;;;
147457;147400;1;22525;FALSO;VERDADERO;57;;;
147457;147400;0;22526;FALSO;VERDADERO;57;;;
147457;147400;0;22527;FALSO;VERDADERO;57;;;
147457;147420;1;22528;VERDADERO;VERDADERO;37;;;
147493;147420;0;22529;FALSO;VERDADERO;73;;;
147493;147440;0;22530;FALSO;VERDADERO;53;;;
147493;147440;0;22531;FALSO;VERDADERO;53;;;
147493;147440;0;22532;FALSO;VERDADERO;53;;;
147493;147460;0;22533;VERDADERO;VERDADERO;33;;;
147493;147460;0;22534;VERDADERO;VERDADERO;33;;;
147530;147480;0;22535;FALSO;VERDADERO;50;;;
147530;147480;0;22536;FALSO;VERDADERO;50;;;
147530;147480;0;22537;FALSO;VERDADERO;50;;;
147530;147500;0;22538;VERDADERO;VERDADERO;30;;;
147530;147500;0;22539;VERDADERO;VERDADERO;30;;;
147561;147520;1;22540;VERDADERO;VERDADERO;41;;;
147561;147520;0;22541;VERDADERO;VERDADERO;41;;;
147561;147520;0;22542;VERDADERO;VERDADERO;41;;;
147561;147540;0;22543;VERDADERO;VERDADERO;21;;;
147561;147540;0;22544;VERDADERO;VERDADERO;21;;;
147593;147560;0;22545;VERDADERO;VERDADERO;33;;;
147593;147560;0;22546;VERDADERO;VERDADERO;33;;;
147593;147560;0;22547;VERDADERO;VERDADERO;33;;;
147593;147580;0;22548;VERDADERO;VERDADERO;13;;;
147593;147580;0;22549;VERDADERO;VERDADERO;13;;;
147629;147600;0;22550;VERDADERO;VERDADERO;29;;;
147629;147600;0;22551;VERDADERO;VERDADERO;29;;;
147629;147620;0;22552;VERDADERO;VERDADERO;9;;;
147629;147620;0;22553;VERDADERO;VERDADERO;9;;;
147629;147620;0;22554;VERDADERO;VERDADERO;9;;;
147661;147640;0;22555;VERDADERO;VERDADERO;21;;;
147661;147640;0;22556;VERDADERO;VERDADERO;21;;;
147661;147660;0;22557;VERDADERO;VERDADERO;1;;;
147661;147660;0;22558;VERDADERO;VERDADERO;1;;;
147661;147660;0;22559;VERDADERO;VERDADERO;1;;;
147661;147680;0;22560;VERDADERO;VERDADERO;-19;;;
147697;147680;0;22561;VERDADERO;VERDADERO;17;;;
147697;147700;0;22562;VERDADERO;VERDADERO;-3;;;
147697;147700;0;22563;VERDADERO;VERDADERO;-3;;;
147697;147700;0;22564;VERDADERO;VERDADERO;-3;;;
147697;147720;0;22565;VERDADERO;VERDADERO;-23;;;
147729;147720;0;22566;VERDADERO;VERDADERO;9;;;
147729;147740;0;22567;VERDADERO;VERDADERO;-11;;;
147729;147740;0;22568;VERDADERO;VERDADERO;-11;;;
147729;147740;0;22569;VERDADERO;VERDADERO;-11;;;
147729;147760;1;22570;VERDADERO;VERDADERO;-31;;;
147761;147760;0;22571;VERDADERO;VERDADERO;1;;;
147761;147780;0;22572;VERDADERO;VERDADERO;-19;;;
147761;147780;0;22573;VERDADERO;VERDADERO;-19;;;
147761;147780;0;22574;VERDADERO;VERDADERO;-19;;;
147761;147780;0;22575;VERDADERO;VERDADERO;-19;;;
147794;147800;0;22576;VERDADERO;VERDADERO;-6;;;
147794;147800;0;22577;VERDADERO;VERDADERO;-6;;;
147794;147820;0;22578;VERDADERO;VERDADERO;-26;;;
147794;147820;0;22579;VERDADERO;VERDADERO;-26;;;
147794;147820;0;22580;VERDADERO;VERDADERO;-26;;;
147824;147840;1;22581;VERDADERO;VERDADERO;-16;;;
147824;147840;0;22582;VERDADERO;VERDADERO;-16;;;
147824;147840;0;22583;VERDADERO;VERDADERO;-16;;;
147824;147840;0;22584;VERDADERO;VERDADERO;-16;;;
147824;147840;0;22585;VERDADERO;VERDADERO;-16;;;
147824;147840;0;22586;VERDADERO;VERDADERO;-16;;;
147860;147860;0;22587;VERDADERO;VERDADERO;0;;;
147860;147860;0;22588;VERDADERO;VERDADERO;0;;;
147860;147860;0;22589;VERDADERO;VERDADERO;0;;;
147860;147880;0;22590;VERDADERO;VERDADERO;-20;;;
147860;147880;0;22591;VERDADERO;VERDADERO;-20;;;
147893;147880;0;22592;VERDADERO;VERDADERO;13;;;
147893;147880;0;22593;VERDADERO;VERDADERO;13;;;
147893;147880;0;22594;VERDADERO;VERDADERO;13;;;
147893;147880;0;22595;VERDADERO;VERDADERO;13;;;
147893;147900;1;22596;VERDADERO;VERDADERO;-7;;;
147893;147900;0;22597;VERDADERO;VERDADERO;-7;;;
147928;147900;0;22598;VERDADERO;VERDADERO;28;;;
147928;147921;0;22599;VERDADERO;VERDADERO;7;;;
147928;147921;0;22600;VERDADERO;VERDADERO;7;;;
147928;147941;0;22601;VERDADERO;VERDADERO;-13;;;
147956;147941;0;22602;VERDADERO;VERDADERO;15;;;
147956;147961;0;22603;VERDADERO;VERDADERO;-5;;;
147956;147961;0;22604;VERDADERO;VERDADERO;-5;;;
147956;147961;0;22605;VERDADERO;VERDADERO;-5;;;
147956;147961;0;22606;VERDADERO;VERDADERO;-5;;;
147989;147961;0;22607;VERDADERO;VERDADERO;28;;;
147989;147961;0;22608;VERDADERO;VERDADERO;28;;;
147989;147961;0;22609;VERDADERO;VERDADERO;28;;;
147989;147961;0;22610;VERDADERO;VERDADERO;28;;;
147989;147981;0;22611;VERDADERO;VERDADERO;8;;;
148020;147981;0;22612;VERDADERO;VERDADERO;39;;;
148020;147981;0,00E+00;22613;VERDADERO;VERDADERO;39;;;
148020;148001;0;22614;VERDADERO;VERDADERO;19;;;
148020;148001;0;22615;VERDADERO;VERDADERO;19;;;
148020;148001;0;22616;VERDADERO;VERDADERO;19;;;
148052;148001;0;22617;FALSO;VERDADERO;51;;;
148052;148001;0;22618;FALSO;VERDADERO;51;;;
148052;148001;0;22619;FALSO;VERDADERO;51;;;
148052;148001;0;22620;FALSO;VERDADERO;51;;;
148052;148021;1;22621;VERDADERO;VERDADERO;31;;;
148052;148021;0;22622;VERDADERO;VERDADERO;31;;;
148088;148041;1;22623;VERDADERO;VERDADERO;47;;;
148088;148041;0;22624;VERDADERO;VERDADERO;47;;;
148088;148041;0;22625;VERDADERO;VERDADERO;47;;;
148088;148061;0;22626;VERDADERO;VERDADERO;27;;;
148088;148061;0;22627;VERDADERO;VERDADERO;27;;;
148120;148081;0;22628;VERDADERO;VERDADERO;39;;;
148120;148081;0;22629;VERDADERO;VERDADERO;39;;;
148120;148101;0;22630;VERDADERO;VERDADERO;19;;;
148120;148101;0;22631;VERDADERO;VERDADERO;19;;;
148120;148101;0;22632;VERDADERO;VERDADERO;19;;;
148154;148121;0;22633;VERDADERO;VERDADERO;33;;;
148154;148121;0;22634;VERDADERO;VERDADERO;33;;;
148154;148141;0;22635;VERDADERO;VERDADERO;13;;;
148154;148141;0;22636;VERDADERO;VERDADERO;13;;;
148154;148141;0;22637;VERDADERO;VERDADERO;13;;;
148154;148161;0;22638;VERDADERO;VERDADERO;-7;;;
148188;148161;0;22639;VERDADERO;VERDADERO;27;;;
148188;148181;0;22640;VERDADERO;VERDADERO;7;;;
148188;148181;0;22641;VERDADERO;VERDADERO;7;;;
148188;148181;0;22642;VERDADERO;VERDADERO;7;;;
148188;148201;0;22643;VERDADERO;VERDADERO;-13;;;
148220;148201;0;22644;VERDADERO;VERDADERO;19;;;
148220;148221;0;22645;VERDADERO;VERDADERO;-1;;;
148220;148221;0;22646;VERDADERO;VERDADERO;-1;;;
148220;148221;0;22647;VERDADERO;VERDADERO;-1;;;
148220;148221;0;22648;VERDADERO;VERDADERO;-1;;;
148257;148241;0;22649;VERDADERO;VERDADERO;16;;;
148257;148241;0;22650;VERDADERO;VERDADERO;16;;;
148257;148241;0;22651;VERDADERO;VERDADERO;16;;;
148257;148261;0;22652;VERDADERO;VERDADERO;-4;;;
148257;148261;0;22653;VERDADERO;VERDADERO;-4;;;
148289;148281;0;22654;VERDADERO;VERDADERO;8;;;
148289;148281;0;22655;VERDADERO;VERDADERO;8;;;
148289;148281;0;22656;VERDADERO;VERDADERO;8;;;
148289;148301;0;22657;VERDADERO;VERDADERO;-12;;;
148289;148301;0;22658;VERDADERO;VERDADERO;-12;;;
148289;148321;0;22659;VERDADERO;VERDADERO;-32;;;
148324;148321;0;22660;VERDADERO;VERDADERO;3;;;
148324;148321;0;22661;VERDADERO;VERDADERO;3;;;
148324;148341;1;22662;VERDADERO;VERDADERO;-17;;;
148324;148341;0;22663;VERDADERO;VERDADERO;-17;;;
148324;148361;0;22664;VERDADERO;VERDADERO;-37;;;
148358;148361;0;22665;VERDADERO;VERDADERO;-3;;;
148358;148361;0;22666;VERDADERO;VERDADERO;-3;;;
148358;148381;0;22667;VERDADERO;VERDADERO;-23;;;
148358;148381;0;22668;VERDADERO;VERDADERO;-23;;;
148358;148401;0;22669;VERDADERO;VERDADERO;-43;;;
148389;148401;0;22670;VERDADERO;VERDADERO;-12;;;
148389;148401;0;22671;VERDADERO;VERDADERO;-12;;;
148389;148401;0;22672;VERDADERO;VERDADERO;-12;;;
148389;148421;0;22673;VERDADERO;VERDADERO;-32;;;
148389;148421;0;22674;VERDADERO;VERDADERO;-32;;;
148424;148441;0;22675;VERDADERO;VERDADERO;-17;;;
148424;148441;0;22676;VERDADERO;VERDADERO;-17;;;
148424;148441;0;22677;VERDADERO;VERDADERO;-17;;;
148424;148441;0;22678;VERDADERO;VERDADERO;-17;;;
148424;148441;0;22679;VERDADERO;VERDADERO;-17;;;
148424;148461;0;22680;VERDADERO;VERDADERO;-37;;;
148457;148461;0;22681;VERDADERO;VERDADERO;-4;;;
148457;148461;0;22682;VERDADERO;VERDADERO;-4;;;
148457;148481;0;22683;VERDADERO;VERDADERO;-24;;;
148457;148481;0;22684;VERDADERO;VERDADERO;-24;;;
148457;148501;1;22685;VERDADERO;VERDADERO;-44;;;
148493;148501;0;22686;VERDADERO;VERDADERO;-8;;;
148493;148501;0;22687;VERDADERO;VERDADERO;-8;;;
148493;148521;0;22688;VERDADERO;VERDADERO;-28;;;
148493;148521;0;22689;VERDADERO;VERDADERO;-28;;;
148493;148521;0;22690;VERDADERO;VERDADERO;-28;;;
148493;148541;0;22691;VERDADERO;VERDADERO;-48;;;
148524;148541;0;22692;VERDADERO;VERDADERO;-17;;;
148524;148541;0;22693;VERDADERO;VERDADERO;-17;;;
148524;148541;0;22694;VERDADERO;VERDADERO;-17;;;
148524;148541;0;22695;VERDADERO;VERDADERO;-17;;;
148524;148541;0;22696;VERDADERO;VERDADERO;-17;;;
148560;148561;0;22697;VERDADERO;VERDADERO;-1;;;
148560;148561;0;22698;VERDADERO;VERDADERO;-1;;;
148560;148581;0;22699;VERDADERO;VERDADERO;-21;;;
148560;148581;0;22700;VERDADERO;VERDADERO;-21;;;
148560;148581;0;22701;VERDADERO;VERDADERO;-21;;;
148593;148601;1;22702;VERDADERO;VERDADERO;-8;;;
148593;148601;0;22703;VERDADERO;VERDADERO;-8;;;
148593;148621;1;22704;VERDADERO;VERDADERO;-28;;;
148593;148621;0;22705;VERDADERO;VERDADERO;-28;;;
148593;148621;0;22706;VERDADERO;VERDADERO;-28;;;
148625;148641;1;22707;VERDADERO;VERDADERO;-16;;;
148625;148641;0;22708;VERDADERO;VERDADERO;-16;;;
148625;148641;0;22709;VERDADERO;VERDADERO;-16;;;
148625;148641;0;22710;VERDADERO;VERDADERO;-16;;;
148625;148641;0;22711;VERDADERO;VERDADERO;-16;;;
148657;148641;0;22712;VERDADERO;VERDADERO;16;;;
148657;148661;0;22713;VERDADERO;VERDADERO;-4;;;
148657;148661;0;22714;VERDADERO;VERDADERO;-4;;;
148657;148681;0;22715;VERDADERO;VERDADERO;-24;;;
148657;148681;0;22716;VERDADERO;VERDADERO;-24;;;
148688;148681;0;22717;VERDADERO;VERDADERO;7;;;
148688;148701;0;22718;VERDADERO;VERDADERO;-13;;;
148688;148701;0;22719;VERDADERO;VERDADERO;-13;;;
148688;148701;0;22720;VERDADERO;VERDADERO;-13;;;
148688;148721;0;22721;VERDADERO;VERDADERO;-33;;;
148688;148721;0;22722;VERDADERO;VERDADERO;-33;;;
148725;148721;0;22723;VERDADERO;VERDADERO;4;;;
148725;148741;0;22724;VERDADERO;VERDADERO;-16;;;
148725;148741;0;22725;VERDADERO;VERDADERO;-16;;;
148725;148761;0;22726;VERDADERO;VERDADERO;-36;;;
148725;148761;0;22727;VERDADERO;VERDADERO;-36;;;
148756;148761;0;22728;VERDADERO;VERDADERO;-5;;;
148756;148781;0;22729;VERDADERO;VERDADERO;-25;;;
148756;148781;0;22730;VERDADERO;VERDADERO;-25;;;
148756;148781;0;22731;VERDADERO;VERDADERO;-25;;;
148756;148801;0;22732;VERDADERO;VERDADERO;-45;;;
148788;148801;0;22733;VERDADERO;VERDADERO;-13;;;
148788;148801;0;22734;VERDADERO;VERDADERO;-13;;;
148788;148801;0;22735;VERDADERO;VERDADERO;-13;;;
148788;148801;0;22736;VERDADERO;VERDADERO;-13;;;
148788;148801;0;22737;VERDADERO;VERDADERO;-13;;;
148788;148821;0;22738;VERDADERO;VERDADERO;-33;;;
148788;148821;0;22739;VERDADERO;VERDADERO;-33;;;
148830;148841;0;22740;VERDADERO;VERDADERO;-11;;;
148830;148841;0;22741;VERDADERO;VERDADERO;-11;;;
148830;148841;0;22742;VERDADERO;VERDADERO;-11;;;
148830;148861;0;22743;VERDADERO;VERDADERO;-31;;;
148856;148861;0;22744;VERDADERO;VERDADERO;-5;;;
148856;148861;0;22745;VERDADERO;VERDADERO;-5;;;
148856;148881;0;22746;VERDADERO;VERDADERO;-25;;;
148856;148881;0;22747;VERDADERO;VERDADERO;-25;;;
148856;148881;0;22748;VERDADERO;VERDADERO;-25;;;
148889;148901;0;22749;VERDADERO;VERDADERO;-12;;;
148889;148901;0;22750;VERDADERO;VERDADERO;-12;;;
148889;148921;0;22751;VERDADERO;VERDADERO;-32;;;
148889;148921;0;22752;VERDADERO;VERDADERO;-32;;;
148889;148921;0;22753;VERDADERO;VERDADERO;-32;;;
148924;148941;0;22754;VERDADERO;VERDADERO;-17;;;
148924;148941;0;22755;VERDADERO;VERDADERO;-17;;;
148924;148941;0;22756;VERDADERO;VERDADERO;-17;;;
148924;148961;0;22757;VERDADERO;VERDADERO;-37;;;
148924;148961;0;22758;VERDADERO;VERDADERO;-37;;;
148924;148961;0;22759;VERDADERO;VERDADERO;-37;;;
148960;148961;0;22760;VERDADERO;VERDADERO;-1;;;
148960;148961;0;22761;VERDADERO;VERDADERO;-1;;;
148960;148981;0;22762;VERDADERO;VERDADERO;-21;;;
148960;148981;0;22763;VERDADERO;VERDADERO;-21;;;
148960;149001;1;22764;VERDADERO;VERDADERO;-41;;;
148992;149001;0;22765;VERDADERO;VERDADERO;-9;;;
148992;149001;0;22766;VERDADERO;VERDADERO;-9;;;
148992;149021;0;22767;VERDADERO;VERDADERO;-29;;;
148992;149021;0;22768;VERDADERO;VERDADERO;-29;;;
148992;149021;0;22769;VERDADERO;VERDADERO;-29;;;
149025;149041;0;22770;VERDADERO;VERDADERO;-16;;;
149025;149041;0;22771;VERDADERO;VERDADERO;-16;;;
149025;149041;0;22772;VERDADERO;VERDADERO;-16;;;
149025;149061;0;22773;VERDADERO;VERDADERO;-36;;;
149025;149061;0;22774;VERDADERO;VERDADERO;-36;;;
149025;149061;0;22775;VERDADERO;VERDADERO;-36;;;
149061;149061;0;22776;VERDADERO;VERDADERO;0;;;
149061;149061;0;22777;VERDADERO;VERDADERO;0;;;
149061;149081;0;22778;VERDADERO;VERDADERO;-20;;;
149061;149081;0;22779;VERDADERO;VERDADERO;-20;;;
149061;149081;0;22780;VERDADERO;VERDADERO;-20;;;
149092;149101;0;22781;VERDADERO;VERDADERO;-9;;;
149092;149101;0;22782;VERDADERO;VERDADERO;-9;;;
149092;149121;0;22783;VERDADERO;VERDADERO;-29;;;
149092;149121;0;22784;VERDADERO;VERDADERO;-29;;;
149092;149121;0;22785;VERDADERO;VERDADERO;-29;;;
149125;149141;1;22786;VERDADERO;VERDADERO;-16;;;
149125;149141;0;22787;VERDADERO;VERDADERO;-16;;;
149125;149161;0;22788;VERDADERO;VERDADERO;-36;;;
149125;149161;0;22789;VERDADERO;VERDADERO;-36;;;
149125;149161;0;22790;VERDADERO;VERDADERO;-36;;;
149160;149161;0;22791;VERDADERO;VERDADERO;-1;;;
149160;149161;0;22792;VERDADERO;VERDADERO;-1;;;
149160;149181;0;22793;VERDADERO;VERDADERO;-21;;;
149160;149181;0;22794;VERDADERO;VERDADERO;-21;;;
149160;149181;0;22795;VERDADERO;VERDADERO;-21;;;
149160;149201;0;22796;VERDADERO;VERDADERO;-41;;;
149193;149201;0;22797;VERDADERO;VERDADERO;-8;;;
149193;149221;0;22798;VERDADERO;VERDADERO;-28;;;
149193;149221;0;22799;VERDADERO;VERDADERO;-28;;;
149193;149221;0;22800;VERDADERO;VERDADERO;-28;;;
149193;149221;0;22801;VERDADERO;VERDADERO;-28;;;
149225;149241;0;22802;VERDADERO;VERDADERO;-16;;;
149225;149241;0;22803;VERDADERO;VERDADERO;-16;;;
149225;149241;0;22804;VERDADERO;VERDADERO;-16;;;
149225;149261;0;22805;VERDADERO;VERDADERO;-36;;;
149225;149261;0;22806;VERDADERO;VERDADERO;-36;;;
149260;149261;0;22807;VERDADERO;VERDADERO;-1;;;
149260;149261;0;22808;VERDADERO;VERDADERO;-1;;;
149260;149281;0;22809;VERDADERO;VERDADERO;-21;;;
149260;149281;0;22810;VERDADERO;VERDADERO;-21;;;
149260;149281;0;22811;VERDADERO;VERDADERO;-21;;;
149260;149301;0;22812;VERDADERO;VERDADERO;-41;;;
149292;149301;0;22813;VERDADERO;VERDADERO;-9;;;
149292;149321;0;22814;VERDADERO;VERDADERO;-29;;;
149292;149321;0;22815;VERDADERO;VERDADERO;-29;;;
149292;149321;0;22816;VERDADERO;VERDADERO;-29;;;
149292;149321;0;22817;VERDADERO;VERDADERO;-29;;;
149329;149341;1;22818;VERDADERO;VERDADERO;-12;;;
149329;149341;0;22819;VERDADERO;VERDADERO;-12;;;
149329;149361;0;22820;VERDADERO;VERDADERO;-32;;;
149329;149361;0;22821;VERDADERO;VERDADERO;-32;;;
149329;149361;0;22822;VERDADERO;VERDADERO;-32;;;
149361;149361;0;22823;VERDADERO;VERDADERO;0;;;
149361;149361;0;22824;VERDADERO;VERDADERO;0;;;
149361;149361;0;22825;VERDADERO;VERDADERO;0;;;
149361;149381;0;22826;VERDADERO;VERDADERO;-20;;;
149361;149381;0;22827;VERDADERO;VERDADERO;-20;;;
149393;149402;0;22828;VERDADERO;VERDADERO;-9;;;
149393;149402;0;22829;VERDADERO;VERDADERO;-9;;;
149393;149402;0;22830;VERDADERO;VERDADERO;-9;;;
149393;149422;1;22831;VERDADERO;VERDADERO;-29;;;
149393;149422;0;22832;VERDADERO;VERDADERO;-29;;;
149393;149422;0;22833;VERDADERO;VERDADERO;-29;;;
149429;149422;0;22834;VERDADERO;VERDADERO;7;;;
149429;149442;0;22835;VERDADERO;VERDADERO;-13;;;
149429;149442;0;22836;VERDADERO;VERDADERO;-13;;;
149429;149462;0;22837;VERDADERO;VERDADERO;-33;;;
149429;149462;0;22838;VERDADERO;VERDADERO;-33;;;
149461;149482;0;22839;VERDADERO;VERDADERO;-21;;;
149461;149482;0;22840;VERDADERO;VERDADERO;-21;;;
149461;149482;0;22841;VERDADERO;VERDADERO;-21;;;
149461;149502;0;22842;VERDADERO;VERDADERO;-41;;;
149461;149502;0;22843;VERDADERO;VERDADERO;-41;;;
149492;149522;1;22844;VERDADERO;VERDADERO;-30;;;
149492;149522;0;22845;VERDADERO;VERDADERO;-30;;;
149492;149522;0;22846;VERDADERO;VERDADERO;-30;;;
149492;149522;0;22847;VERDADERO;VERDADERO;-30;;;
149492;149522;0;22848;VERDADERO;VERDADERO;-30;;;
149492;149522;0;22849;VERDADERO;VERDADERO;-30;;;
149528;149522;0;22850;VERDADERO;VERDADERO;6;;;
149528;149522;0;22851;VERDADERO;VERDADERO;6;;;
149528;149522;0;22852;VERDADERO;VERDADERO;6;;;
149528;149542;0;22853;VERDADERO;VERDADERO;-14;;;
149528;149542;0;22854;VERDADERO;VERDADERO;-14;;;
149561;149562;1;22855;VERDADERO;VERDADERO;-1;;;
149593;149582;0;22856;VERDADERO;VERDADERO;11;;;
149593;149582;0;22857;VERDADERO;VERDADERO;11;;;
149593;149602;0;22858;VERDADERO;VERDADERO;-9;;;
149593;149602;0;22859;VERDADERO;VERDADERO;-9;;;
149593;149602;0;22860;VERDADERO;VERDADERO;-9;;;
149629;149622;0;22861;VERDADERO;VERDADERO;7;;;
149629;149622;0;22862;VERDADERO;VERDADERO;7;;;
149629;149642;0;22863;VERDADERO;VERDADERO;-13;;;
149629;149642;0;22864;VERDADERO;VERDADERO;-13;;;
149629;149642;0;22865;VERDADERO;VERDADERO;-13;;;
149661;149662;1;22866;VERDADERO;VERDADERO;-1;;;
149661;149662;0;22867;VERDADERO;VERDADERO;-1;;;
149661;149682;0;22868;VERDADERO;VERDADERO;-21;;;
149661;149682;0;22869;VERDADERO;VERDADERO;-21;;;
149661;149682;0;22870;VERDADERO;VERDADERO;-21;;;
149692;149702;1;22871;VERDADERO;VERDADERO;-10;;;
149692;149702;0;22872;VERDADERO;VERDADERO;-10;;;
149692;149722;0;22873;VERDADERO;VERDADERO;-30;;;
149692;149722;0;22874;VERDADERO;VERDADERO;-30;;;
149692;149742;0;22875;VERDADERO;FALSO;-50;;;
149729;149742;0;22876;VERDADERO;VERDADERO;-13;;;
149729;149742;0;22877;VERDADERO;VERDADERO;-13;;;
149729;149762;0;22878;VERDADERO;VERDADERO;-33;;;
149729;149762;0;22879;VERDADERO;VERDADERO;-33;;;
149729;149762;0;22880;VERDADERO;VERDADERO;-33;;;
149761;149782;0;22881;VERDADERO;VERDADERO;-21;;;
149761;149782;0;22882;VERDADERO;VERDADERO;-21;;;
149761;149782;0;22883;VERDADERO;VERDADERO;-21;;;
149761;149782;0;22884;VERDADERO;VERDADERO;-21;;;
149761;149802;0;22885;VERDADERO;VERDADERO;-41;;;
149793;149802;0;22886;VERDADERO;VERDADERO;-9;;;
149793;149802;0;22887;VERDADERO;VERDADERO;-9;;;
149793;149822;0;22888;VERDADERO;VERDADERO;-29;;;
149793;149822;0;22889;VERDADERO;VERDADERO;-29;;;
149793;149822;0;22890;VERDADERO;VERDADERO;-29;;;
149793;149822;0;22891;VERDADERO;VERDADERO;-29;;;
149829;149822;0;22892;VERDADERO;VERDADERO;7;;;
149829;149822;0;22893;VERDADERO;VERDADERO;7;;;
149829;149842;0;22894;VERDADERO;VERDADERO;-13;;;
149829;149842;0;22895;VERDADERO;VERDADERO;-13;;;
149829;149862;0;22896;VERDADERO;VERDADERO;-33;;;
149861;149862;0;22897;VERDADERO;VERDADERO;-1;;;
149861;149862;0;22898;VERDADERO;VERDADERO;-1;;;
149861;149882;0;22899;VERDADERO;VERDADERO;-21;;;
149861;149882;0;22900;VERDADERO;VERDADERO;-21;;;
149861;149882;0;22901;VERDADERO;VERDADERO;-21;;;
149892;149902;0;22902;VERDADERO;VERDADERO;-10;;;
149892;149902;0,00E+00;22903;VERDADERO;VERDADERO;-10;;;
149892;149922;0;22904;VERDADERO;VERDADERO;-30;;;
149892;149922;0;22905;VERDADERO;VERDADERO;-30;;;
149892;149922;0;22906;VERDADERO;VERDADERO;-30;;;
149924;149942;0;22907;VERDADERO;VERDADERO;-18;;;
149924;149942;0;22908;VERDADERO;VERDADERO;-18;;;
149924;149942;0;22909;VERDADERO;VERDADERO;-18;;;
149924;149942;0;22910;VERDADERO;VERDADERO;-18;;;
149924;149962;0;22911;VERDADERO;VERDADERO;-38;;;
149956;149962;0;22912;VERDADERO;VERDADERO;-6;;;
149956;149962;0;22913;VERDADERO;VERDADERO;-6;;;
149956;149982;0;22914;VERDADERO;VERDADERO;-26;;;
149956;149982;0;22915;VERDADERO;VERDADERO;-26;;;
149956;149982;0;22916;VERDADERO;VERDADERO;-26;;;
149989;149982;0;22917;VERDADERO;VERDADERO;7;;;
149989;150002;0;22918;VERDADERO;VERDADERO;-13;;;
149989;150002;0;22919;VERDADERO;VERDADERO;-13;;;
149989;150022;0,00E+00;22920;VERDADERO;VERDADERO;-33;;;
149989;150022;0;22921;VERDADERO;VERDADERO;-33;;;
150021;150022;0;22922;VERDADERO;VERDADERO;-1;;;
150021;150042;0;22923;VERDADERO;VERDADERO;-21;;;
150021;150042;0;22924;VERDADERO;VERDADERO;-21;;;
150021;150062;0;22925;VERDADERO;VERDADERO;-41;;;
150021;150062;0;22926;VERDADERO;VERDADERO;-41;;;
150021;150062;0;22927;VERDADERO;VERDADERO;-41;;;
150021;150082;0;22928;VERDADERO;FALSO;-61;;;
150067;150082;0;22929;VERDADERO;VERDADERO;-15;;;
150067;150082;0;22930;VERDADERO;VERDADERO;-15;;;
150067;150082;0;22931;VERDADERO;VERDADERO;-15;;;
150067;150082;0;22932;VERDADERO;VERDADERO;-15;;;
150067;150082;0;22933;VERDADERO;VERDADERO;-15;;;
150092;150102;1;22934;VERDADERO;VERDADERO;-10;;;
150092;150102;0;22935;VERDADERO;VERDADERO;-10;;;
150092;150122;0;22936;VERDADERO;VERDADERO;-30;;;
150092;150122;0;22937;VERDADERO;VERDADERO;-30;;;
150121;150122;0;22938;VERDADERO;VERDADERO;-1;;;
150121;150122;0;22939;VERDADERO;VERDADERO;-1;;;
150121;150122;0;22940;VERDADERO;VERDADERO;-1;;;
150121;150122;0;22941;VERDADERO;VERDADERO;-1;;;
150121;150122;0;22942;VERDADERO;VERDADERO;-1;;;
150121;150142;0;22943;VERDADERO;VERDADERO;-21;;;
150157;150142;0;22944;VERDADERO;VERDADERO;15;;;
150157;150162;0;22945;VERDADERO;VERDADERO;-5;;;
150157;150162;0;22946;VERDADERO;VERDADERO;-5;;;
150157;150162;0;22947;VERDADERO;VERDADERO;-5;;;
150157;150182;1;22948;VERDADERO;VERDADERO;-25;;;
150192;150182;0;22949;VERDADERO;VERDADERO;10;;;
150192;150202;0;22950;VERDADERO;VERDADERO;-10;;;
150192;150202;0;22951;VERDADERO;VERDADERO;-10;;;
150192;150202;0;22952;VERDADERO;VERDADERO;-10;;;
150192;150222;0;22953;VERDADERO;VERDADERO;-30;;;
150192;150222;0;22954;VERDADERO;VERDADERO;-30;;;
150225;150242;1;22955;VERDADERO;VERDADERO;-17;;;
150225;150242;0;22956;VERDADERO;VERDADERO;-17;;;
150225;150242;0;22957;VERDADERO;VERDADERO;-17;;;
150225;150262;0;22958;VERDADERO;VERDADERO;-37;;;
150257;150262;0;22959;VERDADERO;VERDADERO;-5;;;
150257;150282;0;22960;VERDADERO;VERDADERO;-25;;;
150257;150282;0;22961;VERDADERO;VERDADERO;-25;;;
150257;150282;0;22962;VERDADERO;VERDADERO;-25;;;
150257;150282;0;22963;VERDADERO;VERDADERO;-25;;;
150257;150282;0;22964;VERDADERO;VERDADERO;-25;;;
150293;150302;0;22965;VERDADERO;VERDADERO;-9;;;
150293;150302;0;22966;VERDADERO;VERDADERO;-9;;;
150293;150322;0;22967;VERDADERO;VERDADERO;-29;;;
150293;150322;0;22968;VERDADERO;VERDADERO;-29;;;
150293;150322;0;22969;VERDADERO;VERDADERO;-29;;;
150324;150342;0;22970;VERDADERO;VERDADERO;-18;;;
150324;150342;0;22971;VERDADERO;VERDADERO;-18;;;
150324;150342;0,00E+00;22972;VERDADERO;VERDADERO;-18;;;
150324;150342;0;22973;VERDADERO;VERDADERO;-18;;;
150324;150362;0;22974;VERDADERO;VERDADERO;-38;;;
150356;150362;0;22975;VERDADERO;VERDADERO;-6;;;
150356;150382;1;22976;VERDADERO;VERDADERO;-26;;;
150356;150382;0;22977;VERDADERO;VERDADERO;-26;;;
150356;150382;0;22978;VERDADERO;VERDADERO;-26;;;
150356;150382;0;22979;VERDADERO;VERDADERO;-26;;;
150356;150382;0;22980;VERDADERO;VERDADERO;-26;;;
150392;150382;0;22981;VERDADERO;VERDADERO;10;;;
150392;150402;0;22982;VERDADERO;VERDADERO;-10;;;
150392;150402;0;22983;VERDADERO;VERDADERO;-10;;;
150392;150402;0;22984;VERDADERO;VERDADERO;-10;;;
150392;150422;0;22985;VERDADERO;VERDADERO;-30;;;
150424;150422;0;22986;VERDADERO;VERDADERO;2;;;
150424;150442;0;22987;VERDADERO;VERDADERO;-18;;;
150424;150442;0;22988;VERDADERO;VERDADERO;-18;;;
150424;150442;0;22989;VERDADERO;VERDADERO;-18;;;
150424;150442;0;22990;VERDADERO;VERDADERO;-18;;;
150456;150462;1;22991;VERDADERO;VERDADERO;-6;;;
150456;150462;0;22992;VERDADERO;VERDADERO;-6;;;
150456;150482;0;22993;VERDADERO;VERDADERO;-26;;;
150456;150482;0;22994;VERDADERO;VERDADERO;-26;;;
150456;150482;0;22995;VERDADERO;VERDADERO;-26;;;
150488;150482;0;22996;VERDADERO;VERDADERO;6;;;
150488;150482;0;22997;VERDADERO;VERDADERO;6;;;
150488;150502;0;22998;VERDADERO;VERDADERO;-14;;;
150488;150502;0;22999;VERDADERO;VERDADERO;-14;;;
150488;150502;0;23000;VERDADERO;VERDADERO;-14;;;
150521;150522;1;23001;VERDADERO;VERDADERO;-1;;;
150521;150522;0;23002;VERDADERO;VERDADERO;-1;;;
150521;150542;0;23003;VERDADERO;VERDADERO;-21;;;
150521;150542;0;23004;VERDADERO;VERDADERO;-21;;;
150521;150542;0;23005;VERDADERO;VERDADERO;-21;;;
150521;150542;0;23006;VERDADERO;VERDADERO;-21;;;
150557;150542;0;23007;VERDADERO;VERDADERO;15;;;
150557;150542;0;23008;VERDADERO;VERDADERO;15;;;
150557;150542;0;23009;VERDADERO;VERDADERO;15;;;
150557;150542;0;23010;VERDADERO;VERDADERO;15;;;
150557;150542;0;23011;VERDADERO;VERDADERO;15;;;
150589;150562;1;23012;VERDADERO;VERDADERO;27;;;
150589;150562;0;23013;VERDADERO;VERDADERO;27;;;
150589;150582;0;23014;VERDADERO;VERDADERO;7;;;
150589;150582;0;23015;VERDADERO;VERDADERO;7;;;
150589;150582;0;23016;VERDADERO;VERDADERO;7;;;
150620;150582;0;23017;VERDADERO;VERDADERO;38;;;
150620;150582;0;23018;VERDADERO;VERDADERO;38;;;
150620;150582;0;23019;VERDADERO;VERDADERO;38;;;
150620;150582;0;23020;VERDADERO;VERDADERO;38;;;
150620;150582;0;23021;VERDADERO;VERDADERO;38;;;
150620;150582;0;23022;VERDADERO;VERDADERO;38;;;
150656;150582;0;23023;FALSO;VERDADERO;74;;;
150656;150582;0;23024;FALSO;VERDADERO;74;;;
150656;150602;0;23025;FALSO;VERDADERO;54;;;
150656;150602;0;23026;FALSO;VERDADERO;54;;;
150656;150602;0;23027;FALSO;VERDADERO;54;;;
150689;150622;0;23028;FALSO;VERDADERO;67;;;
150689;150622;0;23029;FALSO;VERDADERO;67;;;
150689;150642;0;23030;VERDADERO;VERDADERO;47;;;
150689;150642;0;23031;VERDADERO;VERDADERO;47;;;
150689;150642;0;23032;VERDADERO;VERDADERO;47;;;
150720;150662;1;23033;FALSO;VERDADERO;58;;;
150720;150662;0;23034;FALSO;VERDADERO;58;;;
150720;150682;0;23035;VERDADERO;VERDADERO;38;;;
150720;150682;0;23036;VERDADERO;VERDADERO;38;;;
150720;150682;0;23037;VERDADERO;VERDADERO;38;;;
150720;150682;0;23038;VERDADERO;VERDADERO;38;;;
150756;150682;0;23039;FALSO;VERDADERO;74;;;
150756;150682;0;23040;FALSO;VERDADERO;74;;;
150756;150682;0;23041;FALSO;VERDADERO;74;;;
150756;150682;0;23042;FALSO;VERDADERO;74;;;
150756;150682;0;23043;FALSO;VERDADERO;74;;;
150788;150682;0;23044;FALSO;VERDADERO;106;;;
150788;150682;0;23045;FALSO;VERDADERO;106;;;
150788;150682;0;23046;FALSO;VERDADERO;106;;;
150788;150682;0;23047;FALSO;VERDADERO;106;;;
150788;150682;0;23048;FALSO;VERDADERO;106;;;
150788;150682;0;23049;FALSO;VERDADERO;106;;;
150820;150682;0;23050;FALSO;VERDADERO;138;;;
150820;150682;0;23051;FALSO;VERDADERO;138;;;
150820;150682;0;23052;FALSO;VERDADERO;138;;;
150820;150682;0;23053;FALSO;VERDADERO;138;;;
150820;150682;0;23054;FALSO;VERDADERO;138;;;
150852;150682;0;23055;FALSO;VERDADERO;170;;;
150852;150682;0;23056;FALSO;VERDADERO;170;;;
150852;150682;0;23057;FALSO;VERDADERO;170;;;
150852;150682;0;23058;FALSO;VERDADERO;170;;;
150852;150682;0;23059;FALSO;VERDADERO;170;;;
150885;150682;0;23060;FALSO;VERDADERO;203;;;
150885;150682;0;23061;FALSO;VERDADERO;203;;;
150885;150682;0;23062;FALSO;VERDADERO;203;;;
150885;150682;0;23063;FALSO;VERDADERO;203;;;
150885;150682;0;23064;FALSO;VERDADERO;203;;;
150885;150682;0;23065;FALSO;VERDADERO;203;;;
150920;150682;0;23066;FALSO;VERDADERO;238;;;
150920;150682;0;23067;FALSO;VERDADERO;238;;;
150920;150682;0;23068;FALSO;VERDADERO;238;;;
150920;150682;0;23069;FALSO;VERDADERO;238;;;
150920;150682;0;23070;FALSO;VERDADERO;238;;;
150952;150682;0;23071;FALSO;VERDADERO;270;;;
150952;150682;0;23072;FALSO;VERDADERO;270;;;
150952;150682;0;23073;FALSO;VERDADERO;270;;;
150952;150682;0;23074;FALSO;VERDADERO;270;;;
150952;150682;0;23075;FALSO;VERDADERO;270;;;
150952;150682;0;23076;FALSO;VERDADERO;270;;;
150988;150682;0;23077;FALSO;VERDADERO;306;;;
150988;150682;0;23078;FALSO;VERDADERO;306;;;
150988;150682;0;23079;FALSO;VERDADERO;306;;;
150988;150682;0;23080;FALSO;VERDADERO;306;;;
150988;150682;0;23081;FALSO;VERDADERO;306;;;
150988;150682;0;23082;FALSO;VERDADERO;306;;;
151024;150682;0;23083;FALSO;VERDADERO;342;;;
151024;150682;0;23084;FALSO;VERDADERO;342;;;
151024;150682;0;23085;FALSO;VERDADERO;342;;;
151024;150682;0;23086;FALSO;VERDADERO;342;;;
151024;150682;0;23087;FALSO;VERDADERO;342;;;
151057;150682;0;23088;FALSO;VERDADERO;375;;;
151057;150682;0;23089;FALSO;VERDADERO;375;;;
151057;150682;0;23090;FALSO;VERDADERO;375;;;
151057;150682;0;23091;FALSO;VERDADERO;375;;;
151057;150682;0;23092;FALSO;VERDADERO;375;;;
151057;150682;0;23093;FALSO;VERDADERO;375;;;
151089;150682;0;23094;FALSO;VERDADERO;407;;;
151089;150682;0;23095;FALSO;VERDADERO;407;;;
151089;150682;0;23096;FALSO;VERDADERO;407;;;
151089;150682;0;23097;FALSO;VERDADERO;407;;;
151089;150682;0;23098;FALSO;VERDADERO;407;;;
151089;150682;0;23099;FALSO;VERDADERO;407;;;
151125;150682;0;23100;FALSO;VERDADERO;443;;;
151125;150682;0;23101;FALSO;VERDADERO;443;;;
151125;150682;0;23102;FALSO;VERDADERO;443;;;
151125;150682;0;23103;FALSO;VERDADERO;443;;;
151125;150682;0;23104;FALSO;VERDADERO;443;;;
151156;150682;0;23105;FALSO;VERDADERO;474;;;
151156;150682;0;23106;FALSO;VERDADERO;474;;;
151156;150682;0;23107;FALSO;VERDADERO;474;;;
151156;150682;0;23108;FALSO;VERDADERO;474;;;
151156;150682;0;23109;FALSO;VERDADERO;474;;;
151189;150682;0;23110;FALSO;VERDADERO;507;;;
151189;150682;0;23111;FALSO;VERDADERO;507;;;
151189;150682;0;23112;FALSO;VERDADERO;507;;;
151189;150682;0;23113;FALSO;VERDADERO;507;;;
151189;150682;0;23114;FALSO;VERDADERO;507;;;
151189;150682;0;23115;FALSO;VERDADERO;507;;;
151225;150682;0;23116;FALSO;VERDADERO;543;;;
151225;150682;0;23117;FALSO;VERDADERO;543;;;
151225;150682;0;23118;FALSO;VERDADERO;543;;;
151225;150682;0;23119;FALSO;VERDADERO;543;;;
151225;150682;0;23120;FALSO;VERDADERO;543;;;
151225;150682;0;23121;FALSO;VERDADERO;543;;;
151256;150682;0;23122;FALSO;VERDADERO;574;;;
151256;150682;0;23123;FALSO;VERDADERO;574;;;
151256;150682;0;23124;FALSO;VERDADERO;574;;;
151256;150682;0;23125;FALSO;VERDADERO;574;;;
151256;150682;0;23126;FALSO;VERDADERO;574;;;
151288;150682;0;23127;FALSO;VERDADERO;606;;;
151288;150682;0;23128;FALSO;VERDADERO;606;;;
151288;150682;0;23129;FALSO;VERDADERO;606;;;
151288;150682;0;23130;FALSO;VERDADERO;606;;;
151288;150682;0;23131;FALSO;VERDADERO;606;;;
151288;150682;0;23132;FALSO;VERDADERO;606;;;
151324;150682;0;23133;FALSO;VERDADERO;642;;;
151324;150682;0;23134;FALSO;VERDADERO;642;;;
151324;150682;0;23135;FALSO;VERDADERO;642;;;
151324;150682;0;23136;FALSO;VERDADERO;642;;;
151324;150682;0;23137;FALSO;VERDADERO;642;;;
151357;150682;0;23138;FALSO;VERDADERO;675;;;
151357;150682;0;23139;FALSO;VERDADERO;675;;;
151357;150682;0;23140;FALSO;VERDADERO;675;;;
151357;150682;0;23141;FALSO;VERDADERO;675;;;
151357;150682;0;23142;FALSO;VERDADERO;675;;;
151388;150682;0;23143;FALSO;VERDADERO;706;;;
151388;150682;0;23144;FALSO;VERDADERO;706;;;
151388;150682;0;23145;FALSO;VERDADERO;706;;;
151388;150682;0;23146;FALSO;VERDADERO;706;;;
151388;150682;0;23147;FALSO;VERDADERO;706;;;
151420;150682;0;23148;FALSO;VERDADERO;738;;;
151420;150682;0;23149;FALSO;VERDADERO;738;;;
151420;150682;0;23150;FALSO;VERDADERO;738;;;
151420;150682;0;23151;FALSO;VERDADERO;738;;;
151420;150682;0;23152;FALSO;VERDADERO;738;;;
151420;150682;0;23153;FALSO;VERDADERO;738;;;
151452;150682;0;23154;FALSO;VERDADERO;770;;;
151452;150682;0;23155;FALSO;VERDADERO;770;;;
151452;150682;0;23156;FALSO;VERDADERO;770;;;
151452;150682;0;23157;FALSO;VERDADERO;770;;;
151452;150682;0;23158;FALSO;VERDADERO;770;;;
151452;150682;0;23159;FALSO;VERDADERO;770;;;
151488;150682;0;23160;FALSO;VERDADERO;806;;;
151488;150682;0;23161;FALSO;VERDADERO;806;;;
151488;150682;0;23162;FALSO;VERDADERO;806;;;
151488;150682;0;23163;FALSO;VERDADERO;806;;;
151488;150682;0;23164;FALSO;VERDADERO;806;;;
151520;150682;0;23165;FALSO;VERDADERO;838;;;
151520;150682;0;23166;FALSO;VERDADERO;838;;;
151520;150682;0;23167;FALSO;VERDADERO;838;;;
151520;150682;0;23168;FALSO;VERDADERO;838;;;
151520;150682;0;23169;FALSO;VERDADERO;838;;;
151553;150682;0;23170;FALSO;VERDADERO;871;;;
151553;150682;0;23171;FALSO;VERDADERO;871;;;
151553;150682;0;23172;FALSO;VERDADERO;871;;;
151553;150682;0;23173;FALSO;VERDADERO;871;;;
151553;150682;0;23174;FALSO;VERDADERO;871;;;
151553;150682;0;23175;FALSO;VERDADERO;871;;;
151553;150682;0;23176;FALSO;VERDADERO;871;;;
151593;150682;0;23177;FALSO;VERDADERO;911;;;
151593;150682;0;23178;FALSO;VERDADERO;911;;;
151593;150682;0;23179;FALSO;VERDADERO;911;;;
151593;150682;0;23180;FALSO;VERDADERO;911;;;
151617;150682;0;23181;FALSO;VERDADERO;935;;;
151617;150682;0;23182;FALSO;VERDADERO;935;;;
151617;150682;0;23183;FALSO;VERDADERO;935;;;
151617;150682;0;23184;FALSO;VERDADERO;935;;;
151617;150682;0;23185;FALSO;VERDADERO;935;;;
151617;150682;0;23186;FALSO;VERDADERO;935;;;
151653;150682;0;23187;FALSO;VERDADERO;971;;;
151653;150682;0;23188;FALSO;VERDADERO;971;;;
151653;150682;0;23189;FALSO;VERDADERO;971;;;
151653;150682;0;23190;FALSO;VERDADERO;971;;;
151653;150682;0;23191;FALSO;VERDADERO;971;;;
151685;150682;0;23192;FALSO;VERDADERO;1003;;;
151685;150682;0;23193;FALSO;VERDADERO;1003;;;
151685;150682;0;23194;FALSO;VERDADERO;1003;;;
151685;150682;0;23195;FALSO;VERDADERO;1003;;;
151685;150682;0;23196;FALSO;VERDADERO;1003;;;
151685;150682;0;23197;FALSO;VERDADERO;1003;;;
151721;150682;0;23198;FALSO;VERDADERO;1039;;;
151721;150682;0;23199;FALSO;VERDADERO;1039;;;
151721;150682;0;23200;FALSO;VERDADERO;1039;;;
151721;150682;0;23201;FALSO;VERDADERO;1039;;;
151721;150682;0;23202;FALSO;VERDADERO;1039;;;
151753;150682;0;23203;FALSO;VERDADERO;1071;;;
151753;150682;0;23204;FALSO;VERDADERO;1071;;;
151753;150682;0;23205;FALSO;VERDADERO;1071;;;
151753;150682;0;23206;FALSO;VERDADERO;1071;;;
151753;150682;0;23207;FALSO;VERDADERO;1071;;;
151753;150682;0;23208;FALSO;VERDADERO;1071;;;
151788;150682;0;23209;FALSO;VERDADERO;1106;;;
151788;150682;0;23210;FALSO;VERDADERO;1106;;;
151788;150682;0;23211;FALSO;VERDADERO;1106;;;
151788;150682;0;23212;FALSO;VERDADERO;1106;;;
151788;150682;0;23213;FALSO;VERDADERO;1106;;;
151788;150682;0;23214;FALSO;VERDADERO;1106;;;
151820;150682;0;23215;FALSO;VERDADERO;1138;;;
151820;150682;0;23216;FALSO;VERDADERO;1138;;;
151820;150682;0;23217;FALSO;VERDADERO;1138;;;
151820;150682;0;23218;FALSO;VERDADERO;1138;;;
151820;150682;0;23219;FALSO;VERDADERO;1138;;;
151820;150682;0;23220;FALSO;VERDADERO;1138;;;
151856;150682;0;23221;FALSO;VERDADERO;1174;;;
151856;150682;0;23222;FALSO;VERDADERO;1174;;;
151856;150682;0;23223;FALSO;VERDADERO;1174;;;
151856;150682;0;23224;FALSO;VERDADERO;1174;;;
151856;150682;0;23225;FALSO;VERDADERO;1174;;;
151888;150682;0;23226;FALSO;VERDADERO;1206;;;
151888;150682;0;23227;FALSO;VERDADERO;1206;;;
151888;150682;0;23228;FALSO;VERDADERO;1206;;;
151888;150682;0;23229;FALSO;VERDADERO;1206;;;
151888;150682;0;23230;FALSO;VERDADERO;1206;;;
151888;150682;0;23231;FALSO;VERDADERO;1206;;;
151924;150682;0;23232;FALSO;VERDADERO;1242;;;
151924;150702;0;23233;FALSO;VERDADERO;1222;;;
151924;150702;0;23234;FALSO;VERDADERO;1222;;;
151924;150722;0;23235;FALSO;VERDADERO;1202;;;
151924;150722;0;23236;FALSO;VERDADERO;1202;;;
151956;150722;0;23237;FALSO;VERDADERO;1234;;;
151956;150742;0;23238;FALSO;VERDADERO;1214;;;
151956;150742;0;23239;FALSO;VERDADERO;1214;;;
151956;150762;0;23240;FALSO;VERDADERO;1194;;;
151956;150762;0;23241;FALSO;VERDADERO;1194;;;
151988;150762;0;23242;FALSO;VERDADERO;1226;;;
151988;150782;0;23243;FALSO;VERDADERO;1206;;;
151988;150782;0;23244;FALSO;VERDADERO;1206;;;
151988;150802;1;23245;FALSO;VERDADERO;1186;;;
151988;150802;0;23246;FALSO;VERDADERO;1186;;;
152020;150802;0;23247;FALSO;VERDADERO;1218;;;
152020;150822;0;23248;FALSO;VERDADERO;1198;;;
152020;150822;0;23249;FALSO;VERDADERO;1198;;;
152020;150842;1;23250;FALSO;VERDADERO;1178;;;
152020;150842;0;23251;FALSO;VERDADERO;1178;;;
152052;150842;0;23252;FALSO;VERDADERO;1210;;;
152052;150862;0;23253;FALSO;VERDADERO;1190;;;
152052;150862;0;23254;FALSO;VERDADERO;1190;;;
152052;150882;0;23255;FALSO;VERDADERO;1170;;;
152052;150882;0;23256;FALSO;VERDADERO;1170;;;
152089;150902;0;23257;FALSO;VERDADERO;1187;;;
152089;150902;0;23258;FALSO;VERDADERO;1187;;;
152089;150902;0;23259;FALSO;VERDADERO;1187;;;
152089;150922;1;23260;FALSO;VERDADERO;1167;;;
152089;150922;0;23261;FALSO;VERDADERO;1167;;;
152121;150942;0;23262;FALSO;VERDADERO;1179;;;
152121;150942;0;23263;FALSO;VERDADERO;1179;;;
152121;150942;0;23264;FALSO;VERDADERO;1179;;;
152121;150962;0;23265;FALSO;VERDADERO;1159;;;
152121;150962;0;23266;FALSO;VERDADERO;1159;;;
152152;150982;0;23267;FALSO;VERDADERO;1170;;;
152152;150982;0;23268;FALSO;VERDADERO;1170;;;
152152;150982;0;23269;FALSO;VERDADERO;1170;;;
152152;151002;0;23270;FALSO;VERDADERO;1150;;;
152152;151002;0;23271;FALSO;VERDADERO;1150;;;
152152;151022;0;23272;FALSO;VERDADERO;1130;;;
152188;151022;0;23273;FALSO;VERDADERO;1166;;;
152188;151022;0;23274;FALSO;VERDADERO;1166;;;
152188;151042;0;23275;FALSO;VERDADERO;1146;;;
152188;151042;0;23276;FALSO;VERDADERO;1146;;;
152188;151062;0;23277;FALSO;VERDADERO;1126;;;
152221;151062;0;23278;FALSO;VERDADERO;1159;;;
152221;151062;0;23279;FALSO;VERDADERO;1159;;;
152221;151082;1;23280;FALSO;VERDADERO;1139;;;
152221;151082;0;23281;FALSO;VERDADERO;1139;;;
152221;151102;0;23282;FALSO;VERDADERO;1119;;;
152253;151102;0;23283;FALSO;VERDADERO;1151;;;
152253;151122;0;23284;FALSO;VERDADERO;1131;;;
152253;151122;0;23285;FALSO;VERDADERO;1131;;;
152253;151122;0;23286;FALSO;VERDADERO;1131;;;
152253;151142;0;23287;FALSO;VERDADERO;1111;;;
152284;151142;0;23288;FALSO;VERDADERO;1142;;;
152284;151162;0;23289;FALSO;VERDADERO;1122;;;
152284;151162;0;23290;FALSO;VERDADERO;1122;;;
152284;151162;0;23291;FALSO;VERDADERO;1122;;;
152284;151182;0;23292;FALSO;VERDADERO;1102;;;
152317;151182;0;23293;FALSO;VERDADERO;1135;;;
152317;151202;0;23294;FALSO;VERDADERO;1115;;;
152317;151202;0;23295;FALSO;VERDADERO;1115;;;
152317;151202;0;23296;FALSO;VERDADERO;1115;;;
152317;151222;0;23297;FALSO;VERDADERO;1095;;;
152352;151222;0;23298;FALSO;VERDADERO;1130;;;
152352;151242;0;23299;FALSO;VERDADERO;1110;;;
152352;151242;0;23300;FALSO;VERDADERO;1110;;;
152352;151242;0;23301;FALSO;VERDADERO;1110;;;
152352;151262;0;23302;FALSO;VERDADERO;1090;;;
152384;151262;0;23303;FALSO;VERDADERO;1122;;;
152384;151282;0;23304;FALSO;VERDADERO;1102;;;
152384;151282;0;23305;FALSO;VERDADERO;1102;;;
152384;151282;0;23306;FALSO;VERDADERO;1102;;;
152384;151302;0;23307;FALSO;VERDADERO;1082;;;
152384;151302;0;23308;FALSO;VERDADERO;1082;;;
152420;151322;0;23309;FALSO;VERDADERO;1098;;;
152420;151322;0;23310;FALSO;VERDADERO;1098;;;
152420;151342;0;23311;FALSO;VERDADERO;1078;;;
152420;151342;0;23312;FALSO;VERDADERO;1078;;;
152420;151342;0;23313;FALSO;VERDADERO;1078;;;
152453;151362;0;23314;FALSO;VERDADERO;1091;;;
152453;151362;0;23315;FALSO;VERDADERO;1091;;;
152453;151382;0;23316;FALSO;VERDADERO;1071;;;
152453;151382;0;23317;FALSO;VERDADERO;1071;;;
152453;151382;0;23318;FALSO;VERDADERO;1071;;;
152489;151402;0;23319;FALSO;VERDADERO;1087;;;
152489;151402;0;23320;FALSO;VERDADERO;1087;;;
152489;151422;0;23321;FALSO;VERDADERO;1067;;;
152489;151422;0;23322;FALSO;VERDADERO;1067;;;
152489;151422;0;23323;FALSO;VERDADERO;1067;;;
152520;151442;0;23324;FALSO;VERDADERO;1078;;;
152520;151442;0;23325;FALSO;VERDADERO;1078;;;
152520;151462;0;23326;FALSO;VERDADERO;1058;;;
152520;151462;0;23327;FALSO;VERDADERO;1058;;;
152520;151482;0;23328;FALSO;VERDADERO;1038;;;
152552;151482;0;23329;FALSO;VERDADERO;1070;;;
152552;151482;0;23330;FALSO;VERDADERO;1070;;;
152552;151502;0;23331;FALSO;VERDADERO;1050;;;
152552;151502;0;23332;FALSO;VERDADERO;1050;;;
152552;151522;0;23333;FALSO;VERDADERO;1030;;;
152552;151522;0;23334;FALSO;VERDADERO;1030;;;
152588;151522;0;23335;FALSO;VERDADERO;1066;;;
152588;151542;0;23336;FALSO;VERDADERO;1046;;;
152588;151542;0;23337;FALSO;VERDADERO;1046;;;
152588;151562;0;23338;FALSO;VERDADERO;1026;;;
152588;151562;0;23339;FALSO;VERDADERO;1026;;;
152621;151562;0;23340;FALSO;VERDADERO;1059;;;
152621;151582;0;23341;FALSO;VERDADERO;1039;;;
152621;151582;0;23342;FALSO;VERDADERO;1039;;;
152621;152011;0;23343;FALSO;VERDADERO;610;;;
152621;152011;0;23344;FALSO;VERDADERO;610;;;
152653;152011;0;23345;FALSO;VERDADERO;642;;;
152653;152031;0;23346;FALSO;VERDADERO;622;;;
152653;152031;0;23347;FALSO;VERDADERO;622;;;
152653;152051;0;23348;FALSO;VERDADERO;602;;;
152653;152051;0;23349;FALSO;VERDADERO;602;;;
152684;152071;0;23350;FALSO;VERDADERO;613;;;
152684;152071;0;23351;FALSO;VERDADERO;613;;;
152684;152071;0;23352;FALSO;VERDADERO;613;;;
152684;152091;0;23353;FALSO;VERDADERO;593;;;
152716;152091;0;23354;FALSO;VERDADERO;625;;;
152716;152111;0;23355;FALSO;VERDADERO;605;;;
152716;152111;0;23356;FALSO;VERDADERO;605;;;
152716;152111;0;23357;FALSO;VERDADERO;605;;;
152716;152131;0;23358;FALSO;VERDADERO;585;;;
152716;152131;0;23359;FALSO;VERDADERO;585;;;
152716;152151;0;23360;FALSO;VERDADERO;565;;;
152757;152151;0;23361;FALSO;VERDADERO;606;;;
152757;152151;0;23362;FALSO;VERDADERO;606;;;
152757;152171;0;23363;FALSO;VERDADERO;586;;;
152757;152171;0;23364;FALSO;VERDADERO;586;;;
152785;152191;0;23365;FALSO;VERDADERO;594;;;
152785;152191;0;23366;FALSO;VERDADERO;594;;;
152785;152191;0;23367;FALSO;VERDADERO;594;;;
152785;152211;0;23368;FALSO;VERDADERO;574;;;
152785;152211;0;23369;FALSO;VERDADERO;574;;;
152817;152231;0;23370;FALSO;VERDADERO;586;;;
152817;152231;0;23371;FALSO;VERDADERO;586;;;
152817;152231;0;23372;FALSO;VERDADERO;586;;;
152817;152251;0;23373;FALSO;VERDADERO;566;;;
152817;152251;0;23374;FALSO;VERDADERO;566;;;
152817;152271;0;23375;FALSO;VERDADERO;546;;;
152852;152271;0;23376;FALSO;VERDADERO;581;;;
152852;152291;0;23377;FALSO;VERDADERO;561;;;
152852;152291;0;23378;FALSO;VERDADERO;561;;;
152852;152291;0;23379;FALSO;VERDADERO;561;;;
152852;152311;0;23380;FALSO;VERDADERO;541;;;
152889;152311;0;23381;FALSO;VERDADERO;578;;;
152889;152331;1;23382;FALSO;VERDADERO;558;;;
152889;152331;0;23383;FALSO;VERDADERO;558;;;
152889;152331;0;23384;FALSO;VERDADERO;558;;;
152889;152351;0;23385;FALSO;VERDADERO;538;;;
152921;152351;0;23386;FALSO;VERDADERO;570;;;
152921;152371;0;23387;FALSO;VERDADERO;550;;;
152921;152371;0;23388;FALSO;VERDADERO;550;;;
152921;152371;0;23389;FALSO;VERDADERO;550;;;
152921;152391;1;23390;FALSO;VERDADERO;530;;;
152921;152391;0;23391;FALSO;VERDADERO;530;;;
152957;152411;0;23392;FALSO;VERDADERO;546;;;
152957;152411;0;23393;FALSO;VERDADERO;546;;;
152957;152411;0;23394;FALSO;VERDADERO;546;;;
152957;152431;0;23395;FALSO;VERDADERO;526;;;
152957;152431;0;23396;FALSO;VERDADERO;526;;;
152988;152451;0;23397;FALSO;VERDADERO;537;;;
152988;152451;0;23398;FALSO;VERDADERO;537;;;
152988;152471;0;23399;FALSO;VERDADERO;517;;;
152988;152471;0;23400;FALSO;VERDADERO;517;;;
152988;152471;0;23401;FALSO;VERDADERO;517;;;
153024;152491;0;23402;FALSO;VERDADERO;533;;;
153024;152491;0;23403;FALSO;VERDADERO;533;;;
153024;152511;0;23404;FALSO;VERDADERO;513;;;
153024;152511;0;23405;FALSO;VERDADERO;513;;;
153024;152511;0;23406;FALSO;VERDADERO;513;;;
153024;152531;0;23407;FALSO;VERDADERO;493;;;
153061;152531;0;23408;FALSO;VERDADERO;530;;;
153061;152551;0;23409;FALSO;VERDADERO;510;;;
153061;152551;0;23410;FALSO;VERDADERO;510;;;
153061;152551;0;23411;FALSO;VERDADERO;510;;;
153061;152571;0;23412;FALSO;VERDADERO;490;;;
153092;152571;0;23413;FALSO;VERDADERO;521;;;
153092;152591;0;23414;FALSO;VERDADERO;501;;;
153092;152591;0;23415;FALSO;VERDADERO;501;;;
153092;152591;0;23416;FALSO;VERDADERO;501;;;
153092;152611;1;23417;FALSO;VERDADERO;481;;;
153124;152611;0;23418;FALSO;VERDADERO;513;;;
153124;152631;0;23419;FALSO;VERDADERO;493;;;
153124;152631;0;23420;FALSO;VERDADERO;493;;;
153124;152651;0;23421;FALSO;VERDADERO;473;;;
153124;152651;0;23422;FALSO;VERDADERO;473;;;
153157;152651;0;23423;FALSO;VERDADERO;506;;;
153157;152671;0;23424;FALSO;VERDADERO;486;;;
153157;152671;0;23425;FALSO;VERDADERO;486;;;
153157;152691;0;23426;FALSO;VERDADERO;466;;;
153157;152691;0;23427;FALSO;VERDADERO;466;;;
153157;152691;0;23428;FALSO;VERDADERO;466;;;
153192;152711;0;23429;FALSO;VERDADERO;481;;;
153192;152711;0;23430;FALSO;VERDADERO;481;;;
153192;152731;1;23431;FALSO;VERDADERO;461;;;
153192;152731;0;23432;FALSO;VERDADERO;461;;;
153220;152731;0;23433;FALSO;VERDADERO;489;;;
153220;152751;1;23434;FALSO;VERDADERO;469;;;
153220;152751;0;23435;FALSO;VERDADERO;469;;;
153220;152771;1;23436;FALSO;VERDADERO;449;;;
153220;152771;0;23437;FALSO;VERDADERO;449;;;
153220;152791;1;23438;FALSO;VERDADERO;429;;;
153257;152791;0;23439;FALSO;VERDADERO;466;;;
153257;152791;0;23440;FALSO;VERDADERO;466;;;
153257;152811;0;23441;FALSO;VERDADERO;446;;;
153257;152811;0;23442;FALSO;VERDADERO;446;;;
153289;152831;0;23443;FALSO;VERDADERO;458;;;
153289;152831;0;23444;FALSO;VERDADERO;458;;;
153289;152831;0;23445;FALSO;VERDADERO;458;;;
153289;152851;1;23446;FALSO;VERDADERO;438;;;
153289;152851;0;23447;FALSO;VERDADERO;438;;;
153289;152871;0;23448;FALSO;VERDADERO;418;;;
153324;152871;0;23449;FALSO;VERDADERO;453;;;
153324;152871;0;23450;FALSO;VERDADERO;453;;;
153324;152891;0;23451;FALSO;VERDADERO;433;;;
153324;152891;0;23452;FALSO;VERDADERO;433;;;
153352;152911;0;23453;FALSO;VERDADERO;441;;;
153352;152911;0;23454;FALSO;VERDADERO;441;;;
153352;152911;0;23455;FALSO;VERDADERO;441;;;
153352;152931;0;23456;FALSO;VERDADERO;421;;;
153352;152931;0;23457;FALSO;VERDADERO;421;;;
153384;152951;0;23458;FALSO;VERDADERO;433;;;
153384;152951;0;23459;FALSO;VERDADERO;433;;;
153384;152951;0;23460;FALSO;VERDADERO;433;;;
153384;152971;0;23461;FALSO;VERDADERO;413;;;
153384;152971;0;23462;FALSO;VERDADERO;413;;;
153417;152991;0;23463;FALSO;VERDADERO;426;;;
153417;152991;0;23464;FALSO;VERDADERO;426;;;
153417;152991;0;23465;FALSO;VERDADERO;426;;;
153417;153011;1;23466;FALSO;VERDADERO;406;;;
153417;153011;0;23467;FALSO;VERDADERO;406;;;
153449;153031;0;23468;FALSO;VERDADERO;418;;;
153449;153031;0;23469;FALSO;VERDADERO;418;;;
153449;153031;0;23470;FALSO;VERDADERO;418;;;
153449;153051;0;23471;FALSO;VERDADERO;398;;;
153449;153051;0;23472;FALSO;VERDADERO;398;;;
153449;153071;0;23473;FALSO;VERDADERO;378;;;
153490;153071;0;23474;FALSO;VERDADERO;419;;;
153490;153071;0;23475;FALSO;VERDADERO;419;;;
153490;153091;0;23476;FALSO;VERDADERO;399;;;
153490;153091;0;23477;FALSO;VERDADERO;399;;;
153490;153111;1;23478;FALSO;VERDADERO;379;;;
153516;153111;0;23479;FALSO;VERDADERO;405;;;
153516;153111;0;23480;FALSO;VERDADERO;405;;;
153516;153131;0;23481;FALSO;VERDADERO;385;;;
153516;153131;0;23482;FALSO;VERDADERO;385;;;
153516;153151;0;23483;FALSO;VERDADERO;365;;;
153548;153151;0;23484;FALSO;VERDADERO;397;;;
153548;153151;0;23485;FALSO;VERDADERO;397;;;
153548;153171;0;23486;FALSO;VERDADERO;377;;;
153548;153171;0;23487;FALSO;VERDADERO;377;;;
153548;153191;0;23488;FALSO;VERDADERO;357;;;
153584;153191;0;23489;FALSO;VERDADERO;393;;;
153584;153191;0;23490;FALSO;VERDADERO;393;;;
153584;153211;0;23491;FALSO;VERDADERO;373;;;
153584;153211;0;23492;FALSO;VERDADERO;373;;;
153584;153231;0;23493;FALSO;VERDADERO;353;;;
153584;153231;0;23494;FALSO;VERDADERO;353;;;
153620;153251;0;23495;FALSO;VERDADERO;369;;;
153620;153251;0;23496;FALSO;VERDADERO;369;;;
153620;153251;0;23497;FALSO;VERDADERO;369;;;
153620;153271;0;23498;FALSO;VERDADERO;349;;;
153620;153271;0;23499;FALSO;VERDADERO;349;;;
153656;153291;0;23500;FALSO;VERDADERO;365;;;
153656;153291;0;23501;FALSO;VERDADERO;365;;;
153656;153311;0;23502;FALSO;VERDADERO;345;;;
153656;153311;0;23503;FALSO;VERDADERO;345;;;
153684;153331;0;23504;FALSO;VERDADERO;353;;;
153684;153331;0;23505;FALSO;VERDADERO;353;;;
153684;153331;0;23506;FALSO;VERDADERO;353;;;
153684;153351;0;23507;FALSO;VERDADERO;333;;;
153684;153351;0;23508;FALSO;VERDADERO;333;;;
153684;153371;1;23509;FALSO;VERDADERO;313;;;
153720;153371;0;23510;FALSO;VERDADERO;349;;;
153720;153371;0;23511;FALSO;VERDADERO;349;;;
153720;153391;0;23512;FALSO;VERDADERO;329;;;
153720;153391;0;23513;FALSO;VERDADERO;329;;;
153720;153411;0;23514;FALSO;VERDADERO;309;;;
153753;153411;0;23515;FALSO;VERDADERO;342;;;
153753;153411;0;23516;FALSO;VERDADERO;342;;;
153753;153431;0;23517;FALSO;VERDADERO;322;;;
153753;153431;0;23518;FALSO;VERDADERO;322;;;
153753;153451;0;23519;FALSO;VERDADERO;302;;;
153791;153451;0;23520;FALSO;VERDADERO;340;;;
153791;153471;0;23521;FALSO;VERDADERO;320;;;
153791;153471;0;23522;FALSO;VERDADERO;320;;;
153791;153471;0;23523;FALSO;VERDADERO;320;;;
153791;153491;0;23524;FALSO;VERDADERO;300;;;
153821;153491;0;23525;FALSO;VERDADERO;330;;;
153821;153511;0;23526;FALSO;VERDADERO;310;;;
153821;153511;0;23527;FALSO;VERDADERO;310;;;
153821;153511;0;23528;FALSO;VERDADERO;310;;;
153821;153531;0;23529;FALSO;VERDADERO;290;;;
153821;153531;0;23530;FALSO;VERDADERO;290;;;
153857;153551;0;23531;FALSO;VERDADERO;306;;;
153857;153551;0;23532;FALSO;VERDADERO;306;;;
153857;153551;0;23533;FALSO;VERDADERO;306;;;
153857;153571;0;23534;FALSO;VERDADERO;286;;;
153857;153571;0;23535;FALSO;VERDADERO;286;;;
153888;153591;0;23536;FALSO;VERDADERO;297;;;
153888;153591;0;23537;FALSO;VERDADERO;297;;;
153888;153591;0;23538;FALSO;VERDADERO;297;;;
153888;153611;0;23539;FALSO;VERDADERO;277;;;
153888;153611;0;23540;FALSO;VERDADERO;277;;;
153923;153631;0;23541;FALSO;VERDADERO;292;;;
153923;153631;0;23542;FALSO;VERDADERO;292;;;
153923;153631;0;23543;FALSO;VERDADERO;292;;;
153923;153651;0;23544;FALSO;VERDADERO;272;;;
153923;153651;0;23545;FALSO;VERDADERO;272;;;
153953;153671;0;23546;FALSO;VERDADERO;282;;;
153953;153671;0;23547;FALSO;VERDADERO;282;;;
153953;153691;0;23548;FALSO;VERDADERO;262;;;
153953;153691;0;23549;FALSO;VERDADERO;262;;;
153953;153691;0;23550;FALSO;VERDADERO;262;;;
153984;153711;0;23551;FALSO;VERDADERO;273;;;
153984;153711;0;23552;FALSO;VERDADERO;273;;;
153984;153731;0;23553;FALSO;VERDADERO;253;;;
153984;153731;0;23554;FALSO;VERDADERO;253;;;
153984;153731;0;23555;FALSO;VERDADERO;253;;;
154017;153751;0;23556;FALSO;VERDADERO;266;;;
154017;153751;0;23557;FALSO;VERDADERO;266;;;
154017;153771;0;23558;FALSO;VERDADERO;246;;;
154017;153771;0;23559;FALSO;VERDADERO;246;;;
154017;153771;0;23560;FALSO;VERDADERO;246;;;
154050;153791;0;23561;FALSO;VERDADERO;259;;;
154050;153791;0;23562;FALSO;VERDADERO;259;;;
154050;153811;0;23563;FALSO;VERDADERO;239;;;
154050;153811;0;23564;FALSO;VERDADERO;239;;;
154050;153811;0;23565;FALSO;VERDADERO;239;;;
154084;153831;0;23566;FALSO;VERDADERO;253;;;
154084;153831;0;23567;FALSO;VERDADERO;253;;;
154084;153851;0;23568;FALSO;VERDADERO;233;;;
154084;153851;0;23569;FALSO;VERDADERO;233;;;
154084;153851;0;23570;FALSO;VERDADERO;233;;;
154116;153871;0;23571;FALSO;VERDADERO;245;;;
154116;153871;0;23572;FALSO;VERDADERO;245;;;
154116;153891;0;23573;FALSO;VERDADERO;225;;;
154116;153891;0;23574;FALSO;VERDADERO;225;;;
154116;153891;0;23575;FALSO;VERDADERO;225;;;
154116;153911;0;23576;FALSO;VERDADERO;205;;;
154152;153911;0;23577;FALSO;VERDADERO;241;;;
154152;153931;0;23578;FALSO;VERDADERO;221;;;
154152;153931;0;23579;FALSO;VERDADERO;221;;;
154152;153931;0;23580;FALSO;VERDADERO;221;;;
154152;153951;0;23581;FALSO;VERDADERO;201;;;
154152;153951;0;23582;FALSO;VERDADERO;201;;;
154188;153971;0;23583;FALSO;VERDADERO;217;;;
154188;153971;0;23584;FALSO;VERDADERO;217;;;
154188;153971;0;23585;FALSO;VERDADERO;217;;;
154188;153991;0;23586;FALSO;VERDADERO;197;;;
154188;153991;0;23587;FALSO;VERDADERO;197;;;
154220;154012;0;23588;FALSO;VERDADERO;208;;;
154220;154012;0;23589;FALSO;VERDADERO;208;;;
154220;154012;0;23590;FALSO;VERDADERO;208;;;
154220;154032;0;23591;FALSO;VERDADERO;188;;;
154220;154032;0;23592;FALSO;VERDADERO;188;;;
154253;154052;0;23593;FALSO;VERDADERO;201;;;
154253;154052;0;23594;FALSO;VERDADERO;201;;;
154253;154072;0;23595;FALSO;VERDADERO;181;;;
154253;154072;0;23596;FALSO;VERDADERO;181;;;
154253;154072;0;23597;FALSO;VERDADERO;181;;;
154284;154092;0;23598;FALSO;VERDADERO;192;;;
154284;154092;0;23599;FALSO;VERDADERO;192;;;
154284;154112;1;23600;FALSO;VERDADERO;172;;;
154284;154112;0;23601;FALSO;VERDADERO;172;;;
154284;154112;0;23602;FALSO;VERDADERO;172;;;
154320;154132;0;23603;FALSO;VERDADERO;188;;;
154320;154132;0,00E+00;23604;FALSO;VERDADERO;188;;;
154320;154152;0;23605;FALSO;VERDADERO;168;;;
154320;154152;0;23606;FALSO;VERDADERO;168;;;
154348;154152;0;23607;FALSO;VERDADERO;196;;;
154348;154172;0;23608;FALSO;VERDADERO;176;;;
154348;154172;0;23609;FALSO;VERDADERO;176;;;
154348;154192;0;23610;FALSO;VERDADERO;156;;;
154348;154192;0;23611;FALSO;VERDADERO;156;;;
154348;154192;0,00E+00;23612;FALSO;VERDADERO;156;;;
154385;154212;0;23613;FALSO;VERDADERO;173;;;
154385;154212;0;23614;FALSO;VERDADERO;173;;;
154385;154232;1;23615;FALSO;VERDADERO;153;;;
154385;154232;0;23616;FALSO;VERDADERO;153;;;
154385;154252;1;23617;FALSO;VERDADERO;133;;;
154417;154252;0;23618;FALSO;VERDADERO;165;;;
154417;154252;0;23619;FALSO;VERDADERO;165;;;
154417;154272;0;23620;FALSO;VERDADERO;145;;;
154417;154272;0;23621;FALSO;VERDADERO;145;;;
154417;154292;0;23622;FALSO;VERDADERO;125;;;
154449;154292;0;23623;FALSO;VERDADERO;157;;;
154449;154292;0;23624;FALSO;VERDADERO;157;;;
154449;154312;0;23625;FALSO;VERDADERO;137;;;
154449;154312;0;23626;FALSO;VERDADERO;137;;;
154449;154332;0;23627;FALSO;VERDADERO;117;;;
154449;154332;0;23628;FALSO;VERDADERO;117;;;
154486;154332;0;23629;FALSO;VERDADERO;154;;;
154486;154352;1;23630;FALSO;VERDADERO;134;;;
154486;154352;0;23631;FALSO;VERDADERO;134;;;
154486;154372;1;23632;FALSO;VERDADERO;114;;;
154513;154372;0;23633;FALSO;VERDADERO;141;;;
154513;154372;0;23634;FALSO;VERDADERO;141;;;
154513;154392;0;23635;FALSO;VERDADERO;121;;;
154513;154392;0;23636;FALSO;VERDADERO;121;;;
154513;154412;0;23637;FALSO;VERDADERO;101;;;
154513;154412;0;23638;FALSO;VERDADERO;101;;;
154548;154412;0;23639;FALSO;VERDADERO;136;;;
154548;154432;0;23640;FALSO;VERDADERO;116;;;
154548;154432;0;23641;FALSO;VERDADERO;116;;;
154548;154452;0;23642;FALSO;VERDADERO;96;;;
154580;154452;0;23643;FALSO;VERDADERO;128;;;
154580;154452;0;23644;FALSO;VERDADERO;128;;;
154580;154472;0;23645;FALSO;VERDADERO;108;;;
154580;154472;0;23646;FALSO;VERDADERO;108;;;
154580;154492;1;23647;FALSO;VERDADERO;88;;;
154580;154492;0;23648;FALSO;VERDADERO;88;;;
154617;154492;0;23649;FALSO;VERDADERO;125;;;
154617;154512;0;23650;FALSO;VERDADERO;105;;;
154617;154512;0;23651;FALSO;VERDADERO;105;;;
154617;154532;1;23652;FALSO;VERDADERO;85;;;
154617;154532;0;23653;FALSO;VERDADERO;85;;;
154649;154552;0;23654;FALSO;VERDADERO;97;;;
154649;154552;0;23655;FALSO;VERDADERO;97;;;
154649;154552;0;23656;FALSO;VERDADERO;97;;;
154649;154572;0;23657;FALSO;VERDADERO;77;;;
154649;154572;0;23658;FALSO;VERDADERO;77;;;
154649;154592;0;23659;FALSO;VERDADERO;57;;;
154686;154592;0;23660;FALSO;VERDADERO;94;;;
154686;154592;0;23661;FALSO;VERDADERO;94;;;
154686;154612;0;23662;FALSO;VERDADERO;74;;;
154686;154612;0;23663;FALSO;VERDADERO;74;;;
154686;154632;0;23664;FALSO;VERDADERO;54;;;
154716;154632;0;23665;FALSO;VERDADERO;84;;;
154716;154652;0;23666;FALSO;VERDADERO;64;;;
154716;154652;0;23667;FALSO;VERDADERO;64;;;
154716;154652;0;23668;FALSO;VERDADERO;64;;;
154716;154672;1;23669;VERDADERO;VERDADERO;44;;;
154749;154672;0;23670;FALSO;VERDADERO;77;;;
154749;154692;0;23671;FALSO;VERDADERO;57;;;
154749;154692;0;23672;FALSO;VERDADERO;57;;;
154749;154692;0;23673;FALSO;VERDADERO;57;;;
154749;154712;0;23674;VERDADERO;VERDADERO;37;;;
154784;154712;0;23675;FALSO;VERDADERO;72;;;
154784;154732;0;23676;FALSO;VERDADERO;52;;;
154784;154732;0;23677;FALSO;VERDADERO;52;;;
154784;154752;0;23678;VERDADERO;VERDADERO;32;;;
154784;154752;0;23679;VERDADERO;VERDADERO;32;;;
154784;154752;0;23680;VERDADERO;VERDADERO;32;;;
154820;154772;0;23681;VERDADERO;VERDADERO;48;;;
154820;154772;0;23682;VERDADERO;VERDADERO;48;;;
154820;154792;0;23683;VERDADERO;VERDADERO;28;;;
154820;154792;0;23684;VERDADERO;VERDADERO;28;;;
154820;154792;0;23685;VERDADERO;VERDADERO;28;;;
154853;154812;0;23686;VERDADERO;VERDADERO;41;;;
154853;154812;0;23687;VERDADERO;VERDADERO;41;;;
154853;154832;0;23688;VERDADERO;VERDADERO;21;;;
154853;154832;0;23689;VERDADERO;VERDADERO;21;;;
154853;154832;0;23690;VERDADERO;VERDADERO;21;;;
154885;154852;1;23691;VERDADERO;VERDADERO;33;;;
154885;154852;0;23692;VERDADERO;VERDADERO;33;;;
154885;154872;0;23693;VERDADERO;VERDADERO;13;;;
154885;154872;0;23694;VERDADERO;VERDADERO;13;;;
154885;154872;0;23695;VERDADERO;VERDADERO;13;;;
154921;154892;1;23696;VERDADERO;VERDADERO;29;;;
154921;154892;0;23697;VERDADERO;VERDADERO;29;;;
154921;154912;0;23698;VERDADERO;VERDADERO;9;;;
154921;154912;0;23699;VERDADERO;VERDADERO;9;;;
154921;154912;0;23700;VERDADERO;VERDADERO;9;;;
154952;154932;1;23701;VERDADERO;VERDADERO;20;;;
154952;154932;0;23702;VERDADERO;VERDADERO;20;;;
154952;154952;0;23703;VERDADERO;VERDADERO;0;;;
154952;154952;0;23704;VERDADERO;VERDADERO;0;;;
154952;154972;0;23705;VERDADERO;VERDADERO;-20;;;
154952;154972;0;23706;VERDADERO;VERDADERO;-20;;;
154989;154972;0;23707;VERDADERO;VERDADERO;17;;;
154989;154992;0;23708;VERDADERO;VERDADERO;-3;;;
154989;154992;0;23709;VERDADERO;VERDADERO;-3;;;
154989;155012;1;23710;VERDADERO;VERDADERO;-23;;;
154989;155012;0;23711;VERDADERO;VERDADERO;-23;;;
155020;155012;0;23712;VERDADERO;VERDADERO;8;;;
155020;155032;0;23713;VERDADERO;VERDADERO;-12;;;
155020;155032;0;23714;VERDADERO;VERDADERO;-12;;;
155020;155052;0;23715;VERDADERO;VERDADERO;-32;;;
155020;155052;0;23716;VERDADERO;VERDADERO;-32;;;
155052;155052;0;23717;VERDADERO;VERDADERO;0;;;
155052;155052;0;23718;VERDADERO;VERDADERO;0;;;
155052;155072;0;23719;VERDADERO;VERDADERO;-20;;;
155052;155072;0;23720;VERDADERO;VERDADERO;-20;;;
155052;155093;0;23721;VERDADERO;VERDADERO;-41;;;
155085;155093;0;23722;VERDADERO;VERDADERO;-8;;;
155085;155093;0;23723;VERDADERO;VERDADERO;-8;;;
155085;155113;0;23724;VERDADERO;VERDADERO;-28;;;
155085;155113;0;23725;VERDADERO;VERDADERO;-28;;;
155085;155133;0;23726;VERDADERO;VERDADERO;-48;;;
155117;155133;0;23727;VERDADERO;VERDADERO;-16;;;
155117;155133;0;23728;VERDADERO;VERDADERO;-16;;;
155117;155153;0;23729;VERDADERO;VERDADERO;-36;;;
155117;155153;0;23730;VERDADERO;VERDADERO;-36;;;
155117;155153;0;23731;VERDADERO;VERDADERO;-36;;;
155153;155153;0;23732;VERDADERO;VERDADERO;0;;;
155153;155153;0;23733;VERDADERO;VERDADERO;0;;;
155153;155173;0;23734;VERDADERO;VERDADERO;-20;;;
155153;155173;0;23735;VERDADERO;VERDADERO;-20;;;
155153;155173;0;23736;VERDADERO;VERDADERO;-20;;;
155184;155193;0;23737;VERDADERO;VERDADERO;-9;;;
155184;155193;0;23738;VERDADERO;VERDADERO;-9;;;
155184;155213;0;23739;VERDADERO;VERDADERO;-29;;;
155184;155213;0;23740;VERDADERO;VERDADERO;-29;;;
155184;155213;0;23741;VERDADERO;VERDADERO;-29;;;
155216;155233;0;23742;VERDADERO;VERDADERO;-17;;;
155216;155233;0;23743;VERDADERO;VERDADERO;-17;;;
155216;155233;0;23744;VERDADERO;VERDADERO;-17;;;
155216;155253;0;23745;VERDADERO;VERDADERO;-37;;;
155216;155253;0;23746;VERDADERO;VERDADERO;-37;;;
155216;155253;0;23747;VERDADERO;VERDADERO;-37;;;
155252;155253;0;23748;VERDADERO;VERDADERO;-1;;;
155252;155253;0;23749;VERDADERO;VERDADERO;-1;;;
155252;155273;0;23750;VERDADERO;VERDADERO;-21;;;
155252;155273;0;23751;VERDADERO;VERDADERO;-21;;;
155252;155273;0;23752;VERDADERO;VERDADERO;-21;;;
155285;155293;0;23753;VERDADERO;VERDADERO;-8;;;
155285;155293;0;23754;VERDADERO;VERDADERO;-8;;;
155285;155313;0;23755;VERDADERO;VERDADERO;-28;;;
155285;155313;0;23756;VERDADERO;VERDADERO;-28;;;
155285;155313;0;23757;VERDADERO;VERDADERO;-28;;;
155317;155313;0;23758;VERDADERO;VERDADERO;4;;;
155317;155313;0;23759;VERDADERO;VERDADERO;4;;;
155317;155333;0;23760;VERDADERO;VERDADERO;-16;;;
155317;155333;0;23761;VERDADERO;VERDADERO;-16;;;
155317;155353;0;23762;VERDADERO;VERDADERO;-36;;;
155317;155353;0;23763;VERDADERO;VERDADERO;-36;;;
155352;155353;0;23764;VERDADERO;VERDADERO;-1;;;
155352;155353;0;23765;VERDADERO;VERDADERO;-1;;;
155352;155353;0;23766;VERDADERO;VERDADERO;-1;;;
155352;155353;0;23767;VERDADERO;VERDADERO;-1;;;
155352;155353;0;23768;VERDADERO;VERDADERO;-1;;;
155384;155373;1;23769;VERDADERO;VERDADERO;11;;;
155384;155373;0;23770;VERDADERO;VERDADERO;11;;;
155384;155373;0;23771;VERDADERO;VERDADERO;11;;;
155384;155393;0;23772;VERDADERO;VERDADERO;-9;;;
155384;155393;0;23773;VERDADERO;VERDADERO;-9;;;
155416;155413;1;23774;VERDADERO;VERDADERO;3;;;
155416;155413;0;23775;VERDADERO;VERDADERO;3;;;
155416;155413;0;23776;VERDADERO;VERDADERO;3;;;
155416;155433;0;23777;VERDADERO;VERDADERO;-17;;;
155416;155433;0;23778;VERDADERO;VERDADERO;-17;;;
155416;155453;0;23779;VERDADERO;VERDADERO;-37;;;
155453;155453;0;23780;VERDADERO;VERDADERO;0;;;
155453;155453;0;23781;VERDADERO;VERDADERO;0;;;
155453;155473;0;23782;VERDADERO;VERDADERO;-20;;;
155453;155473;0;23783;VERDADERO;VERDADERO;-20;;;
155453;155473;0;23784;VERDADERO;VERDADERO;-20;;;
155485;155493;0;23785;VERDADERO;VERDADERO;-8;;;
155485;155493;0;23786;VERDADERO;VERDADERO;-8;;;
155485;155493;0;23787;VERDADERO;VERDADERO;-8;;;
155485;155513;0;23788;VERDADERO;VERDADERO;-28;;;
155485;155513;0;23789;VERDADERO;VERDADERO;-28;;;
155516;155533;0;23790;VERDADERO;VERDADERO;-17;;;
155516;155533;0;23791;VERDADERO;VERDADERO;-17;;;
155516;155533;0;23792;VERDADERO;VERDADERO;-17;;;
155516;155533;0;23793;VERDADERO;VERDADERO;-17;;;
155516;155553;0;23794;VERDADERO;VERDADERO;-37;;;
155552;155553;0;23795;VERDADERO;VERDADERO;-1;;;
155552;155573;1;23796;VERDADERO;VERDADERO;-21;;;
155552;155573;0;23797;VERDADERO;VERDADERO;-21;;;
155552;155573;0;23798;VERDADERO;VERDADERO;-21;;;
155552;155573;0;23799;VERDADERO;VERDADERO;-21;;;
155552;155573;0;23800;VERDADERO;VERDADERO;-21;;;
155585;155593;0;23801;VERDADERO;VERDADERO;-8;;;
155585;155593;0;23802;VERDADERO;VERDADERO;-8;;;
155585;155614;0;23803;VERDADERO;VERDADERO;-29;;;
155585;155614;0;23804;VERDADERO;VERDADERO;-29;;;
155585;155614;0;23805;VERDADERO;VERDADERO;-29;;;
155617;155634;0;23806;VERDADERO;VERDADERO;-17;;;
155617;155634;0;23807;VERDADERO;VERDADERO;-17;;;
155617;155634;0;23808;VERDADERO;VERDADERO;-17;;;
155617;155634;0;23809;VERDADERO;VERDADERO;-17;;;
155617;155654;0;23810;VERDADERO;VERDADERO;-37;;;
155648;155654;0;23811;VERDADERO;VERDADERO;-6;;;
155648;155674;1;23812;VERDADERO;VERDADERO;-26;;;
155648;155674;0;23813;VERDADERO;VERDADERO;-26;;;
155648;155694;0;23814;VERDADERO;VERDADERO;-46;;;
155648;155694;0;23815;VERDADERO;VERDADERO;-46;;;
155680;155694;0;23816;VERDADERO;VERDADERO;-14;;;
155680;155694;0;23817;VERDADERO;VERDADERO;-14;;;
155680;155714;1;23818;VERDADERO;VERDADERO;-34;;;
155680;155714;0;23819;VERDADERO;VERDADERO;-34;;;
155680;155734;0;23820;VERDADERO;FALSO;-54;;;
155717;155734;0;23821;VERDADERO;VERDADERO;-17;;;
155717;155734;0;23822;VERDADERO;VERDADERO;-17;;;
155717;155734;0;23823;VERDADERO;VERDADERO;-17;;;
155717;155734;0;23824;VERDADERO;VERDADERO;-17;;;
155717;155754;0;23825;VERDADERO;VERDADERO;-37;;;
155748;155754;0;23826;VERDADERO;VERDADERO;-6;;;
155748;155774;0;23827;VERDADERO;VERDADERO;-26;;;
155748;155774;0;23828;VERDADERO;VERDADERO;-26;;;
155748;155774;0;23829;VERDADERO;VERDADERO;-26;;;
155748;155774;0;23830;VERDADERO;VERDADERO;-26;;;
155780;155774;0;23831;VERDADERO;VERDADERO;6;;;
155780;155774;0;23832;VERDADERO;VERDADERO;6;;;
155780;155774;0;23833;VERDADERO;VERDADERO;6;;;
155780;155774;0;23834;VERDADERO;VERDADERO;6;;;
155780;155794;0;23835;VERDADERO;VERDADERO;-14;;;
155780;155794;0;23836;VERDADERO;VERDADERO;-14;;;
155780;155814;0;23837;VERDADERO;VERDADERO;-34;;;
155822;155814;0;23838;VERDADERO;VERDADERO;8;;;
155822;155814;0;23839;VERDADERO;VERDADERO;8;;;
155822;155834;0;23840;VERDADERO;VERDADERO;-12;;;
155822;155834;0;23841;VERDADERO;VERDADERO;-12;;;
155849;155854;0;23842;VERDADERO;VERDADERO;-5;;;
155849;155854;0;23843;VERDADERO;VERDADERO;-5;;;
155849;155874;0;23844;VERDADERO;VERDADERO;-25;;;
155849;155874;0;23845;VERDADERO;VERDADERO;-25;;;
155849;155874;0;23846;VERDADERO;VERDADERO;-25;;;
155881;155894;0;23847;VERDADERO;VERDADERO;-13;;;
155881;155894;0;23848;VERDADERO;VERDADERO;-13;;;
155881;155894;0;23849;VERDADERO;VERDADERO;-13;;;
155881;155914;0;23850;VERDADERO;VERDADERO;-33;;;
155881;155914;0;23851;VERDADERO;VERDADERO;-33;;;
155881;155914;0;23852;VERDADERO;VERDADERO;-33;;;
155916;155934;0;23853;VERDADERO;VERDADERO;-18;;;
155916;155934;0;23854;VERDADERO;VERDADERO;-18;;;
155916;155934;0;23855;VERDADERO;VERDADERO;-18;;;
155916;155934;0;23856;VERDADERO;VERDADERO;-18;;;
155916;155934;0;23857;VERDADERO;VERDADERO;-18;;;
155916;155954;0;23858;VERDADERO;VERDADERO;-38;;;
155958;155954;0;23859;VERDADERO;VERDADERO;4;;;
155958;155974;0;23860;VERDADERO;VERDADERO;-16;;;
155958;155974;0;23861;VERDADERO;VERDADERO;-16;;;
155958;155974;0;23862;VERDADERO;VERDADERO;-16;;;
155958;155994;0;23863;VERDADERO;VERDADERO;-36;;;
155984;155994;0;23864;VERDADERO;VERDADERO;-10;;;
155984;156014;0;23865;VERDADERO;VERDADERO;-30;;;
155984;156014;0;23866;VERDADERO;VERDADERO;-30;;;
155984;156014;0;23867;VERDADERO;VERDADERO;-30;;;
155984;156034;0;23868;VERDADERO;FALSO;-50;;;
156017;156034;0;23869;VERDADERO;VERDADERO;-17;;;
156017;156034;0;23870;VERDADERO;VERDADERO;-17;;;
156017;156034;0;23871;VERDADERO;VERDADERO;-17;;;
156017;156034;0;23872;VERDADERO;VERDADERO;-17;;;
156017;156054;0;23873;VERDADERO;VERDADERO;-37;;;
156048;156054;0;23874;VERDADERO;VERDADERO;-6;;;
156048;156054;0;23875;VERDADERO;VERDADERO;-6;;;
156048;156074;0;23876;VERDADERO;VERDADERO;-26;;;
156048;156074;0;23877;VERDADERO;VERDADERO;-26;;;
156048;156094;0;23878;VERDADERO;VERDADERO;-46;;;
156083;156094;0;23879;VERDADERO;VERDADERO;-11;;;
156083;156094;0;23880;VERDADERO;VERDADERO;-11;;;
156083;156114;0;23881;VERDADERO;VERDADERO;-31;;;
156083;156114;0;23882;VERDADERO;VERDADERO;-31;;;
156083;156134;0;23883;VERDADERO;FALSO;-51;;;
156116;156134;0;23884;VERDADERO;VERDADERO;-18;;;
156116;156134;0;23885;VERDADERO;VERDADERO;-18;;;
156116;156134;0;23886;VERDADERO;VERDADERO;-18;;;
156116;156134;0;23887;VERDADERO;VERDADERO;-18;;;
156116;156134;0;23888;VERDADERO;VERDADERO;-18;;;
156116;156154;0;23889;VERDADERO;VERDADERO;-38;;;
156148;156154;0;23890;VERDADERO;VERDADERO;-6;;;
156148;156154;0;23891;VERDADERO;VERDADERO;-6;;;
156148;156174;0;23892;VERDADERO;VERDADERO;-26;;;
156148;156174;0;23893;VERDADERO;VERDADERO;-26;;;
156181;156194;0;23894;VERDADERO;VERDADERO;-13;;;
156181;156194;0;23895;VERDADERO;VERDADERO;-13;;;
156181;156194;0;23896;VERDADERO;VERDADERO;-13;;;
156181;156194;0;23897;VERDADERO;VERDADERO;-13;;;
156181;156214;0;23898;VERDADERO;VERDADERO;-33;;;
156213;156214;0;23899;VERDADERO;VERDADERO;-1;;;
156213;156214;0;23900;VERDADERO;VERDADERO;-1;;;
156213;156234;0;23901;VERDADERO;VERDADERO;-21;;;
156213;156234;0;23902;VERDADERO;VERDADERO;-21;;;
156213;156234;0,00E+00;23903;VERDADERO;VERDADERO;-21;;;
156213;156234;0;23904;VERDADERO;VERDADERO;-21;;;
156245;156234;0;23905;VERDADERO;VERDADERO;11;;;
156245;156254;0;23906;VERDADERO;VERDADERO;-9;;;
156245;156254;0;23907;VERDADERO;VERDADERO;-9;;;
156245;156274;0;23908;VERDADERO;VERDADERO;-29;;;
156245;156274;0;23909;VERDADERO;VERDADERO;-29;;;
156280;156274;0;23910;VERDADERO;VERDADERO;6;;;
156280;156294;0;23911;VERDADERO;VERDADERO;-14;;;
156280;156294;0;23912;VERDADERO;VERDADERO;-14;;;
156280;156314;0;23913;VERDADERO;VERDADERO;-34;;;
156280;156314;0;23914;VERDADERO;VERDADERO;-34;;;
156312;156314;0;23915;VERDADERO;VERDADERO;-2;;;
156312;156334;0;23916;VERDADERO;VERDADERO;-22;;;
156312;156334;0;23917;VERDADERO;VERDADERO;-22;;;
156312;156334;0;23918;VERDADERO;VERDADERO;-22;;;
156312;156334;0;23919;VERDADERO;VERDADERO;-22;;;
156312;156354;0;23920;VERDADERO;VERDADERO;-42;;;
156349;156354;0;23921;VERDADERO;VERDADERO;-5;;;
156349;156354;0;23922;VERDADERO;VERDADERO;-5;;;
156349;156375;0;23923;VERDADERO;VERDADERO;-26;;;
156349;156375;0;23924;VERDADERO;VERDADERO;-26;;;
156349;156395;0;23925;VERDADERO;VERDADERO;-46;;;
156380;156395;0;23926;VERDADERO;VERDADERO;-15;;;
156380;156395;0;23927;VERDADERO;VERDADERO;-15;;;
156380;156415;0;23928;VERDADERO;VERDADERO;-35;;;
156380;156415;0;23929;VERDADERO;VERDADERO;-35;;;
156380;156435;0;23930;VERDADERO;FALSO;-55;;;
156380;156435;0;23931;VERDADERO;FALSO;-55;;;
156417;156435;0;23932;VERDADERO;VERDADERO;-18;;;
156417;156435;0;23933;VERDADERO;VERDADERO;-18;;;
156417;156435;0;23934;VERDADERO;VERDADERO;-18;;;
156417;156435;0;23935;VERDADERO;VERDADERO;-18;;;
156417;156455;0;23936;VERDADERO;VERDADERO;-38;;;
156449;156455;0;23937;VERDADERO;VERDADERO;-6;;;
156449;156455;0;23938;VERDADERO;VERDADERO;-6;;;
156449;156475;0;23939;VERDADERO;VERDADERO;-26;;;
156449;156475;0;23940;VERDADERO;VERDADERO;-26;;;
156449;156495;1;23941;VERDADERO;VERDADERO;-46;;;
156481;156495;0;23942;VERDADERO;VERDADERO;-14;;;
156481;156495;0;23943;VERDADERO;VERDADERO;-14;;;
156481;156495;0;23944;VERDADERO;VERDADERO;-14;;;
156481;156515;0;23945;VERDADERO;VERDADERO;-34;;;
156481;156515;0;23946;VERDADERO;VERDADERO;-34;;;
156516;156535;0;23947;VERDADERO;VERDADERO;-19;;;
156516;156535;0;23948;VERDADERO;VERDADERO;-19;;;
156516;156535;0;23949;VERDADERO;VERDADERO;-19;;;
156516;156535;0;23950;VERDADERO;VERDADERO;-19;;;
156516;156535;0;23951;VERDADERO;VERDADERO;-19;;;
156516;156555;0;23952;VERDADERO;VERDADERO;-39;;;
156552;156555;0;23953;VERDADERO;VERDADERO;-3;;;
156552;156575;0;23954;VERDADERO;VERDADERO;-23;;;
156552;156575;0;23955;VERDADERO;VERDADERO;-23;;;
156552;156575;0;23956;VERDADERO;VERDADERO;-23;;;
156552;156595;0;23957;VERDADERO;VERDADERO;-43;;;
156585;156595;0;23958;VERDADERO;VERDADERO;-10;;;
156585;156595;0;23959;VERDADERO;VERDADERO;-10;;;
156585;156615;0;23960;VERDADERO;VERDADERO;-30;;;
156585;156615;0;23961;VERDADERO;VERDADERO;-30;;;
156585;156635;1;23962;VERDADERO;FALSO;-50;;;
156616;156635;0;23963;VERDADERO;VERDADERO;-19;;;
156616;156635;0;23964;VERDADERO;VERDADERO;-19;;;
156616;156635;0;23965;VERDADERO;VERDADERO;-19;;;
156616;156635;0;23966;VERDADERO;VERDADERO;-19;;;
156616;156635;0;23967;VERDADERO;VERDADERO;-19;;;
156616;156635;0;23968;VERDADERO;VERDADERO;-19;;;
156652;156655;0;23969;VERDADERO;VERDADERO;-3;;;
156652;156655;0;23970;VERDADERO;VERDADERO;-3;;;
156652;156675;1;23971;VERDADERO;VERDADERO;-23;;;
156652;156675;0;23972;VERDADERO;VERDADERO;-23;;;
156652;156675;0;23973;VERDADERO;VERDADERO;-23;;;
156685;156695;0;23974;VERDADERO;VERDADERO;-10;;;
156685;156695;0;23975;VERDADERO;VERDADERO;-10;;;
156685;156695;0;23976;VERDADERO;VERDADERO;-10;;;
156685;156695;0;23977;VERDADERO;VERDADERO;-10;;;
156685;156695;0;23978;VERDADERO;VERDADERO;-10;;;
156685;156695;0;23979;VERDADERO;VERDADERO;-10;;;
156720;156695;0;23980;VERDADERO;VERDADERO;25;;;
156720;156715;0;23981;VERDADERO;VERDADERO;5;;;
156720;156715;0;23982;VERDADERO;VERDADERO;5;;;
156720;156715;0;23983;VERDADERO;VERDADERO;5;;;
156720;156735;0;23984;VERDADERO;VERDADERO;-15;;;
156752;156735;0;23985;VERDADERO;VERDADERO;17;;;
156752;156755;0;23986;VERDADERO;VERDADERO;-3;;;
156752;156755;0;23987;VERDADERO;VERDADERO;-3;;;
156752;156755;0;23988;VERDADERO;VERDADERO;-3;;;
156752;156755;0;23989;VERDADERO;VERDADERO;-3;;;
156784;156755;0;23990;VERDADERO;VERDADERO;29;;;
156784;156755;0;23991;VERDADERO;VERDADERO;29;;;
156784;156755;0;23992;VERDADERO;VERDADERO;29;;;
156784;156775;0;23993;VERDADERO;VERDADERO;9;;;
156784;156775;0;23994;VERDADERO;VERDADERO;9;;;
156816;156775;0;23995;VERDADERO;VERDADERO;41;;;
156816;156795;0;23996;VERDADERO;VERDADERO;21;;;
156816;156795;0;23997;VERDADERO;VERDADERO;21;;;
156816;156815;0;23998;VERDADERO;VERDADERO;1;;;
156816;156815;0;23999;VERDADERO;VERDADERO;1;;;
156849;156815;0;24000;VERDADERO;VERDADERO;34;;;
156849;156815;0;24001;VERDADERO;VERDADERO;34;;;
156849;156815;0;24002;VERDADERO;VERDADERO;34;;;
156849;156815;0;24003;VERDADERO;VERDADERO;34;;;
156849;156815;0;24004;VERDADERO;VERDADERO;34;;;
156881;156815;0;24005;FALSO;VERDADERO;66;;;
156881;156815;0;24006;FALSO;VERDADERO;66;;;
156881;156815;0;24007;FALSO;VERDADERO;66;;;
156881;156815;0;24008;FALSO;VERDADERO;66;;;
156881;156835;1;24009;VERDADERO;VERDADERO;46;;;
156881;156835;0;24010;VERDADERO;VERDADERO;46;;;
156913;156835;0;24011;FALSO;VERDADERO;78;;;
156913;156855;0;24012;FALSO;VERDADERO;58;;;
156913;156855;0;24013;FALSO;VERDADERO;58;;;
156913;156875;0;24014;VERDADERO;VERDADERO;38;;;
156913;156875;0;24015;VERDADERO;VERDADERO;38;;;
156913;156895;0;24016;VERDADERO;VERDADERO;18;;;
156956;156895;0;24017;FALSO;VERDADERO;61;;;
156956;156895;0;24018;FALSO;VERDADERO;61;;;
156956;156915;0;24019;VERDADERO;VERDADERO;41;;;
156956;156915;0;24020;VERDADERO;VERDADERO;41;;;
156981;156935;1;24021;VERDADERO;VERDADERO;46;;;
156981;156935;0;24022;VERDADERO;VERDADERO;46;;;
156981;156935;0;24023;VERDADERO;VERDADERO;46;;;
156981;156955;0;24024;VERDADERO;VERDADERO;26;;;
156981;156955;0;24025;VERDADERO;VERDADERO;26;;;
157013;156975;0;24026;VERDADERO;VERDADERO;38;;;
157013;156975;0;24027;VERDADERO;VERDADERO;38;;;
157013;156975;0;24028;VERDADERO;VERDADERO;38;;;
157013;156995;0;24029;VERDADERO;VERDADERO;18;;;
157013;156995;0;24030;VERDADERO;VERDADERO;18;;;
157013;157015;0;24031;VERDADERO;VERDADERO;-2;;;
157049;157015;0;24032;VERDADERO;VERDADERO;34;;;
157049;157035;0;24033;VERDADERO;VERDADERO;14;;;
157049;157035;0;24034;VERDADERO;VERDADERO;14;;;
157049;157035;0;24035;VERDADERO;VERDADERO;14;;;
157049;157055;0;24036;VERDADERO;VERDADERO;-6;;;
157087;157055;0;24037;VERDADERO;VERDADERO;32;;;
157087;157075;0;24038;VERDADERO;VERDADERO;12;;;
157087;157075;0;24039;VERDADERO;VERDADERO;12;;;
157087;157075;0;24040;VERDADERO;VERDADERO;12;;;
157087;157095;0;24041;VERDADERO;VERDADERO;-8;;;
157116;157095;0;24042;VERDADERO;VERDADERO;21;;;
157116;157115;0;24043;VERDADERO;VERDADERO;1;;;
157116;157115;0;24044;VERDADERO;VERDADERO;1;;;
157116;157115;0;24045;VERDADERO;VERDADERO;1;;;
157116;157135;1;24046;VERDADERO;VERDADERO;-19;;;
157148;157135;0;24047;VERDADERO;VERDADERO;13;;;
157148;157155;0;24048;VERDADERO;VERDADERO;-7;;;
157148;157155;0;24049;VERDADERO;VERDADERO;-7;;;
157148;157175;0;24050;VERDADERO;VERDADERO;-27;;;
157148;157175;0;24051;VERDADERO;VERDADERO;-27;;;
157180;157175;0;24052;VERDADERO;VERDADERO;5;;;
157180;157195;1;24053;VERDADERO;VERDADERO;-15;;;
157180;157195;0;24054;VERDADERO;VERDADERO;-15;;;
157180;157215;0;24055;VERDADERO;VERDADERO;-35;;;
157180;157215;0;24056;VERDADERO;VERDADERO;-35;;;
157213;157215;0;24057;VERDADERO;VERDADERO;-2;;;
157213;157235;0;24058;VERDADERO;VERDADERO;-22;;;
157213;157235;0;24059;VERDADERO;VERDADERO;-22;;;
157213;157255;0;24060;VERDADERO;VERDADERO;-42;;;
157213;157255;0;24061;VERDADERO;VERDADERO;-42;;;
157213;157255;0;24062;VERDADERO;VERDADERO;-42;;;
157249;157255;0;24063;VERDADERO;VERDADERO;-6;;;
157249;157275;0;24064;VERDADERO;VERDADERO;-26;;;
157249;157275;0;24065;VERDADERO;VERDADERO;-26;;;
157249;157275;0;24066;VERDADERO;VERDADERO;-26;;;
157249;157295;1;24067;VERDADERO;VERDADERO;-46;;;
157280;157295;0;24068;VERDADERO;VERDADERO;-15;;;
157280;157295;0;24069;VERDADERO;VERDADERO;-15;;;
157280;157295;0;24070;VERDADERO;VERDADERO;-15;;;
157280;157295;0;24071;VERDADERO;VERDADERO;-15;;;
157280;157295;0;24072;VERDADERO;VERDADERO;-15;;;
157312;157315;0;24073;VERDADERO;VERDADERO;-3;;;
157312;157315;0;24074;VERDADERO;VERDADERO;-3;;;
157312;157335;0;24075;VERDADERO;VERDADERO;-23;;;
157312;157335;0;24076;VERDADERO;VERDADERO;-23;;;
157312;157335;0;24077;VERDADERO;VERDADERO;-23;;;
157345;157355;0;24078;VERDADERO;VERDADERO;-10;;;
157345;157355;0;24079;VERDADERO;VERDADERO;-10;;;
157345;157375;0;24080;VERDADERO;VERDADERO;-30;;;
157345;157375;0;24081;VERDADERO;VERDADERO;-30;;;
157345;157375;0;24082;VERDADERO;VERDADERO;-30;;;
157376;157395;0;24083;VERDADERO;VERDADERO;-19;;;
157376;157395;0;24084;VERDADERO;VERDADERO;-19;;;
157376;157415;0;24085;VERDADERO;VERDADERO;-39;;;
157376;157415;0;24086;VERDADERO;VERDADERO;-39;;;
157376;157415;0;24087;VERDADERO;VERDADERO;-39;;;
157413;157435;0;24088;VERDADERO;VERDADERO;-22;;;
157413;157435;0;24089;VERDADERO;VERDADERO;-22;;;
157413;157455;0;24090;VERDADERO;VERDADERO;-42;;;
157413;157455;0;24091;VERDADERO;VERDADERO;-42;;;
157413;157455;0;24092;VERDADERO;VERDADERO;-42;;;
157444;157455;0;24093;VERDADERO;VERDADERO;-11;;;
157444;157455;0;24094;VERDADERO;VERDADERO;-11;;;
157444;157455;0;24095;VERDADERO;VERDADERO;-11;;;
157444;157455;0;24096;VERDADERO;VERDADERO;-11;;;
157444;157455;0;24097;VERDADERO;VERDADERO;-11;;;
157444;157455;0;24098;VERDADERO;VERDADERO;-11;;;
157481;157455;0;24099;VERDADERO;VERDADERO;26;;;
157481;157475;0;24100;VERDADERO;VERDADERO;6;;;
157481;157475;0;24101;VERDADERO;VERDADERO;6;;;
157481;157475;0;24102;VERDADERO;VERDADERO;6;;;
157481;157495;0;24103;VERDADERO;VERDADERO;-14;;;
157513;157495;0;24104;VERDADERO;VERDADERO;18;;;
157513;157495;0;24105;VERDADERO;VERDADERO;18;;;
157513;157495;0;24106;VERDADERO;VERDADERO;18;;;
157513;157495;0;24107;VERDADERO;VERDADERO;18;;;
157513;157515;1;24108;VERDADERO;VERDADERO;-2;;;
157513;157515;0;24109;VERDADERO;VERDADERO;-2;;;
157548;157515;0;24110;VERDADERO;VERDADERO;33;;;
157548;157535;0;24111;VERDADERO;VERDADERO;13;;;
157548;157535;0;24112;VERDADERO;VERDADERO;13;;;
157548;157555;0;24113;VERDADERO;VERDADERO;-7;;;
157548;157555;0;24114;VERDADERO;VERDADERO;-7;;;
157581;157555;0;24115;VERDADERO;VERDADERO;26;;;
157581;157575;0;24116;VERDADERO;VERDADERO;6;;;
157581;157575;0;24117;VERDADERO;VERDADERO;6;;;
157581;157595;0;24118;VERDADERO;VERDADERO;-14;;;
157581;157595;0;24119;VERDADERO;VERDADERO;-14;;;
157581;157595;0;24120;VERDADERO;VERDADERO;-14;;;
157616;157615;0;24121;VERDADERO;VERDADERO;1;;;
157616;157615;0;24122;VERDADERO;VERDADERO;1;;;
157616;157635;0;24123;VERDADERO;VERDADERO;-19;;;
157616;157635;0;24124;VERDADERO;VERDADERO;-19;;;
157616;157635;0;24125;VERDADERO;VERDADERO;-19;;;
157649;157655;1;24126;VERDADERO;VERDADERO;-6;;;
157649;157655;0;24127;VERDADERO;VERDADERO;-6;;;
157649;157675;0;24128;VERDADERO;VERDADERO;-26;;;
157649;157675;0;24129;VERDADERO;VERDADERO;-26;;;
157649;157675;0;24130;VERDADERO;VERDADERO;-26;;;
157684;157695;0;24131;VERDADERO;VERDADERO;-11;;;
157684;157695;0;24132;VERDADERO;VERDADERO;-11;;;
157684;157715;0;24133;VERDADERO;VERDADERO;-31;;;
157684;157715;0;24134;VERDADERO;VERDADERO;-31;;;
157684;157715;0;24135;VERDADERO;VERDADERO;-31;;;
157716;157715;0;24136;VERDADERO;VERDADERO;1;;;
157716;157715;0;24137;VERDADERO;VERDADERO;1;;;
157716;157735;0;24138;VERDADERO;VERDADERO;-19;;;
157716;157735;0;24139;VERDADERO;VERDADERO;-19;;;
157716;157755;0;24140;VERDADERO;VERDADERO;-39;;;
157749;157755;0;24141;VERDADERO;VERDADERO;-6;;;
157749;157755;0;24142;VERDADERO;VERDADERO;-6;;;
157749;157775;1;24143;VERDADERO;VERDADERO;-26;;;
157749;157775;0;24144;VERDADERO;VERDADERO;-26;;;
157749;157775;0;24145;VERDADERO;VERDADERO;-26;;;
157782;157795;0;24146;VERDADERO;VERDADERO;-13;;;
157782;157795;0;24147;VERDADERO;VERDADERO;-13;;;
157782;157815;0;24148;VERDADERO;VERDADERO;-33;;;
157782;157815;0;24149;VERDADERO;VERDADERO;-33;;;
157782;157815;0;24150;VERDADERO;VERDADERO;-33;;;
157813;157815;0;24151;VERDADERO;VERDADERO;-2;;;
157813;157815;0;24152;VERDADERO;VERDADERO;-2;;;
157813;157835;1;24153;VERDADERO;VERDADERO;-22;;;
157813;157835;0;24154;VERDADERO;VERDADERO;-22;;;
157813;157835;0;24155;VERDADERO;VERDADERO;-22;;;
157813;157855;0;24156;VERDADERO;VERDADERO;-42;;;
157849;157855;0;24157;VERDADERO;VERDADERO;-6;;;
157849;157875;0;24158;VERDADERO;VERDADERO;-26;;;
157849;157875;0;24159;VERDADERO;VERDADERO;-26;;;
157849;157875;0;24160;VERDADERO;VERDADERO;-26;;;
157849;157895;0;24161;VERDADERO;VERDADERO;-46;;;
157881;157895;0;24162;VERDADERO;VERDADERO;-14;;;
157881;157895;0;24163;VERDADERO;VERDADERO;-14;;;
157881;157915;0;24164;VERDADERO;VERDADERO;-34;;;
157881;157915;0;24165;VERDADERO;VERDADERO;-34;;;
157881;157915;0;24166;VERDADERO;VERDADERO;-34;;;
157881;157915;0;24167;VERDADERO;VERDADERO;-34;;;
157919;157915;0;24168;VERDADERO;VERDADERO;4;;;
157919;157935;0;24169;VERDADERO;VERDADERO;-16;;;
157919;157935;0;24170;VERDADERO;VERDADERO;-16;;;
157919;157955;0;24171;VERDADERO;VERDADERO;-36;;;
157945;157955;0;24172;VERDADERO;VERDADERO;-10;;;
157945;157975;0;24173;VERDADERO;VERDADERO;-30;;;
157945;157975;0;24174;VERDADERO;VERDADERO;-30;;;
157945;157975;0;24175;VERDADERO;VERDADERO;-30;;;
157945;157975;0;24176;VERDADERO;VERDADERO;-30;;;
157977;157995;0;24177;VERDADERO;VERDADERO;-18;;;
157977;157995;0;24178;VERDADERO;VERDADERO;-18;;;
157977;158015;0;24179;VERDADERO;VERDADERO;-38;;;
157977;158015;0;24180;VERDADERO;VERDADERO;-38;;;
157977;158015;0;24181;VERDADERO;VERDADERO;-38;;;
158009;158015;0;24182;VERDADERO;VERDADERO;-6;;;
158009;158015;0;24183;VERDADERO;VERDADERO;-6;;;
158009;158015;0;24184;VERDADERO;VERDADERO;-6;;;
158009;158015;0;24185;VERDADERO;VERDADERO;-6;;;
158009;158035;0;24186;VERDADERO;VERDADERO;-26;;;
158041;158035;0;24187;VERDADERO;VERDADERO;6;;;
158041;158035;0;24188;VERDADERO;VERDADERO;6;;;
158041;158055;0;24189;VERDADERO;VERDADERO;-14;;;
158041;158055;0;24190;VERDADERO;VERDADERO;-14;;;
158041;158075;0;24191;VERDADERO;VERDADERO;-34;;;
158041;158075;0;24192;VERDADERO;VERDADERO;-34;;;
158077;158075;0;24193;VERDADERO;VERDADERO;2;;;
158077;158095;0;24194;VERDADERO;VERDADERO;-18;;;
158077;158095;0;24195;VERDADERO;VERDADERO;-18;;;
158077;158095;0;24196;VERDADERO;VERDADERO;-18;;;
158077;158115;0;24197;VERDADERO;VERDADERO;-38;;;
158108;158115;0;24198;VERDADERO;VERDADERO;-7;;;
158108;158135;0;24199;VERDADERO;VERDADERO;-27;;;
158108;158135;0;24200;VERDADERO;VERDADERO;-27;;;
158108;158135;0;24201;VERDADERO;VERDADERO;-27;;;
158108;158135;0;24202;VERDADERO;VERDADERO;-27;;;
158141;158155;1;24203;VERDADERO;VERDADERO;-14;;;
158141;158155;0;24204;VERDADERO;VERDADERO;-14;;;
158141;158175;1;24205;VERDADERO;VERDADERO;-34;;;
158141;158175;0;24206;VERDADERO;VERDADERO;-34;;;
158141;158175;0;24207;VERDADERO;VERDADERO;-34;;;
158177;158175;0;24208;VERDADERO;VERDADERO;2;;;
158177;158175;0;24209;VERDADERO;VERDADERO;2;;;
158177;158175;0,00E+00;24210;VERDADERO;VERDADERO;2;;;
158177;158195;0;24211;VERDADERO;VERDADERO;-18;;;
158177;158195;0;24212;VERDADERO;VERDADERO;-18;;;
158177;158215;0;24213;VERDADERO;VERDADERO;-38;;;
158209;158215;0;24214;VERDADERO;VERDADERO;-6;;;
158209;158215;0;24215;VERDADERO;VERDADERO;-6;;;
158209;158235;0;24216;VERDADERO;VERDADERO;-26;;;
158209;158235;0;24217;VERDADERO;VERDADERO;-26;;;
158209;158235;0;24218;VERDADERO;VERDADERO;-26;;;
158244;158235;0;24219;VERDADERO;VERDADERO;9;;;
158244;158235;0;24220;VERDADERO;VERDADERO;9;;;
158244;158235;0;24221;VERDADERO;VERDADERO;9;;;
158244;158235;0;24222;VERDADERO;VERDADERO;9;;;
158244;158235;0;24223;VERDADERO;VERDADERO;9;;;
158244;158235;0;24224;VERDADERO;VERDADERO;9;;;
158276;158235;0;24225;VERDADERO;VERDADERO;41;;;
158276;158255;1;24226;VERDADERO;VERDADERO;21;;;
158276;158255;0;24227;VERDADERO;VERDADERO;21;;;
158276;158255;0;24228;VERDADERO;VERDADERO;21;;;
158276;158275;1;24229;VERDADERO;VERDADERO;1;;;
158313;158275;0;24230;VERDADERO;VERDADERO;38;;;
158313;158275;0;24231;VERDADERO;VERDADERO;38;;;
158313;158295;0;24232;VERDADERO;VERDADERO;18;;;
158313;158295;0;24233;VERDADERO;VERDADERO;18;;;
158313;158295;0;24234;VERDADERO;VERDADERO;18;;;
158313;158315;0;24235;VERDADERO;VERDADERO;-2;;;
158351;158315;0;24236;VERDADERO;VERDADERO;36;;;
158351;158335;0;24237;VERDADERO;VERDADERO;16;;;
158351;158335;0;24238;VERDADERO;VERDADERO;16;;;
158351;158335;0;24239;VERDADERO;VERDADERO;16;;;
158377;158355;1;24240;VERDADERO;VERDADERO;22;;;
158377;158355;0;24241;VERDADERO;VERDADERO;22;;;
158377;158375;1;24242;VERDADERO;VERDADERO;2;;;
158377;158375;0;24243;VERDADERO;VERDADERO;2;;;
158377;158375;0;24244;VERDADERO;VERDADERO;2;;;
158377;158395;0;24245;VERDADERO;VERDADERO;-18;;;
158412;158395;0;24246;VERDADERO;VERDADERO;17;;;
158412;158415;0;24247;VERDADERO;VERDADERO;-3;;;
158412;158415;0;24248;VERDADERO;VERDADERO;-3;;;
158412;158415;0;24249;VERDADERO;VERDADERO;-3;;;
158412;158435;0;24250;VERDADERO;VERDADERO;-23;;;
158445;158435;0;24251;VERDADERO;VERDADERO;10;;;
158445;158455;0;24252;VERDADERO;VERDADERO;-10;;;
158445;158455;0;24253;VERDADERO;VERDADERO;-10;;;
158445;158475;0;24254;VERDADERO;VERDADERO;-30;;;
158445;158475;0;24255;VERDADERO;VERDADERO;-30;;;
158445;158475;0;24256;VERDADERO;VERDADERO;-30;;;
158480;158475;0;24257;VERDADERO;VERDADERO;5;;;
158480;158495;0;24258;VERDADERO;VERDADERO;-15;;;
158480;158495;0;24259;VERDADERO;VERDADERO;-15;;;
158480;158515;0;24260;VERDADERO;VERDADERO;-35;;;
158480;158515;0;24261;VERDADERO;VERDADERO;-35;;;
158513;158515;0;24262;VERDADERO;VERDADERO;-2;;;
158513;158535;0;24263;VERDADERO;VERDADERO;-22;;;
158513;158535;0;24264;VERDADERO;VERDADERO;-22;;;
158513;158535;0;24265;VERDADERO;VERDADERO;-22;;;
158513;158555;0;24266;VERDADERO;VERDADERO;-42;;;
158548;158555;0;24267;VERDADERO;VERDADERO;-7;;;
158548;158575;0;24268;VERDADERO;VERDADERO;-27;;;
158548;158575;0;24269;VERDADERO;VERDADERO;-27;;;
158548;158575;0;24270;VERDADERO;VERDADERO;-27;;;
158548;158575;0;24271;VERDADERO;VERDADERO;-27;;;
158548;158575;0;24272;VERDADERO;VERDADERO;-27;;;
158580;158575;0;24273;VERDADERO;VERDADERO;5;;;
158580;158595;0;24274;VERDADERO;VERDADERO;-15;;;
158580;158595;0;24275;VERDADERO;VERDADERO;-15;;;
158580;158595;0;24276;VERDADERO;VERDADERO;-15;;;
158580;158615;0;24277;VERDADERO;VERDADERO;-35;;;
158613;158615;0;24278;VERDADERO;VERDADERO;-2;;;
158613;158635;0;24279;VERDADERO;VERDADERO;-22;;;
158613;158635;0;24280;VERDADERO;VERDADERO;-22;;;
158613;158635;0;24281;VERDADERO;VERDADERO;-22;;;
158613;158635;0;24282;VERDADERO;VERDADERO;-22;;;
158645;158655;1;24283;VERDADERO;VERDADERO;-10;;;
158645;158655;0;24284;VERDADERO;VERDADERO;-10;;;
158645;158675;0;24285;VERDADERO;VERDADERO;-30;;;
158645;158675;0;24286;VERDADERO;VERDADERO;-30;;;
158645;158675;0;24287;VERDADERO;VERDADERO;-30;;;
158677;158695;0;24288;VERDADERO;VERDADERO;-18;;;
158677;158695;0;24289;VERDADERO;VERDADERO;-18;;;
158677;158695;0;24290;VERDADERO;VERDADERO;-18;;;
158677;158715;0;24291;VERDADERO;VERDADERO;-38;;;
158677;158715;0;24292;VERDADERO;VERDADERO;-38;;;
158708;158715;0;24293;VERDADERO;VERDADERO;-7;;;
158708;158735;1;24294;VERDADERO;VERDADERO;-27;;;
158708;158735;0;24295;VERDADERO;VERDADERO;-27;;;
158708;158735;0;24296;VERDADERO;VERDADERO;-27;;;
158708;158735;0;24297;VERDADERO;VERDADERO;-27;;;
158740;158735;0;24298;VERDADERO;VERDADERO;5;;;
158740;158755;0;24299;VERDADERO;VERDADERO;-15;;;
158740;158755;0;24300;VERDADERO;VERDADERO;-15;;;
158740;158775;0;24301;VERDADERO;VERDADERO;-35;;;
158740;158775;0;24302;VERDADERO;VERDADERO;-35;;;
158740;158775;0;24303;VERDADERO;VERDADERO;-35;;;
158777;158795;0;24304;VERDADERO;VERDADERO;-18;;;
158777;158795;0;24305;VERDADERO;VERDADERO;-18;;;
158777;158795;0;24306;VERDADERO;VERDADERO;-18;;;
158777;158815;0;24307;VERDADERO;VERDADERO;-38;;;
158777;158815;0;24308;VERDADERO;VERDADERO;-38;;;
